File,SubFile,Score,Bias,EValue(C),EValue(I),HMM-From,HMM-To,Ali-From,Ali-To,Env-From,Env-To,Accuracy,HMM-Length,Ali-Length,Env-Length
OceanDNA-b17611,2100,34.8,0.0,1.2e-12,1.9e-09,89,156,45,112,43,120,0.96,67,67,77
OceanDNA-b33308,1563,78.6,3.3,5.1e-26,8.3e-23,8,71,83,146,77,146,0.96,63,63,69
OceanDNA-b20505,46,26.1,0.0,2.7e-10,7.5e-08,88,156,205,273,196,283,0.96,68,68,87
OceanDNA-b41030,1870,277.0,0.1,2.2e-86,1.9e-83,2,261,71,333,70,333,0.95,259,262,263
OceanDNA-b13263,277,9.1,0.0,0.00012,0.039,119,156,150,187,137,191,0.94,37,37,54
OceanDNA-b24086,404,26.1,0.0,5.3e-10,1.6e-07,116,163,133,180,119,191,0.93,47,47,72
OceanDNA-b38376,1463,295.9,0.1,3.8e-92,3.2e-89,2,261,89,353,88,353,0.93,259,264,265
OceanDNA-b22917,1245,8.1,0.0,0.00024,0.23,42,84,67,109,64,118,0.93,42,42,54
OceanDNA-b38936,521,302.2,1.2,3.1e-94,9.9e-92,4,261,51,313,49,313,0.93,257,262,264
OceanDNA-b39170,558,296.2,1.5,1e-92,2.1e-89,4,261,65,327,63,327,0.93,257,262,264
OceanDNA-b22507,886,13.7,0.0,3.2e-06,0.0048,118,152,204,238,196,245,0.92,34,34,49
OceanDNA-a4078,317,8.3,0.0,7e-05,0.024,117,164,150,197,146,198,0.92,47,47,52
OceanDNA-b16480,1016,10.1,0.0,2e-05,0.022,163,211,320,368,308,374,0.92,48,48,66
OceanDNA-b15979,255,16.4,0.0,4.9e-07,0.00025,117,163,169,215,152,229,0.92,46,46,77
OceanDNA-b22864,2687,11.8,0.0,6e-06,0.021,116,161,237,282,227,288,0.92,45,45,61
OceanDNA-b29,2122,11.1,0.1,4.1e-05,0.052,35,70,212,247,205,257,0.92,35,35,52
OceanDNA-b11554,590,10.3,0.0,1.8e-05,0.014,157,195,137,174,79,185,0.92,38,37,106
OceanDNA-b17160,71,12.4,0.0,4.1e-06,0.00075,46,85,188,227,178,235,0.92,39,39,57
OceanDNA-b10504,90,24.3,0.0,9.3e-10,2.6e-07,104,157,123,177,86,238,0.91,53,54,152
OceanDNA-b24230,372,16.3,0.0,2.6e-07,0.00011,24,82,67,124,59,139,0.91,58,57,80
OceanDNA-b47086,269,9.5,0.0,9.2e-05,0.13,114,160,268,314,247,364,0.91,46,46,117
OceanDNA-b45526,124,11.5,0.0,7.3e-06,0.0024,118,153,236,271,227,280,0.91,35,35,53
OceanDNA-b40641,971,2.2,0.0,0.021,6.9,166,228,221,283,208,285,0.91,62,62,77
OceanDNA-b13585,772,20.6,0.0,5.1e-08,1.9e-05,94,156,114,176,109,190,0.91,62,62,81
OceanDNA-b45838,706,129.3,0.0,8.4e-42,1e-38,12,245,105,346,95,353,0.91,233,241,258
OceanDNA-b46725,1949,12.3,0.0,8.8e-06,0.0093,118,152,199,233,192,242,0.91,34,34,50
OceanDNA-b22509,2558,14.2,0.0,1.1e-06,0.0032,118,152,204,238,196,246,0.91,34,34,50
OceanDNA-b24045,1891,14.2,0.0,2.3e-06,0.003,117,157,109,149,90,210,0.91,40,40,120
OceanDNA-b19817,245,23.3,0.0,1.8e-09,7e-07,183,246,268,331,261,340,0.91,63,63,79
OceanDNA-b31076,1192,6.3,0.0,0.00085,0.84,115,154,264,303,255,310,0.91,39,39,55
OceanDNA-b23017,1958,13.8,0.0,1.5e-06,0.0074,118,147,207,236,188,301,0.91,29,29,113
OceanDNA-b15137,1468,16.5,0.0,4.5e-07,0.00047,118,154,115,151,94,212,0.91,36,36,118
OceanDNA-b45095,586,-0.5,0.0,0.034,27.0,149,168,53,72,45,74,0.91,19,19,29
OceanDNA-b23725,689,11.8,0.0,5.9e-06,0.013,32,53,193,214,172,224,0.91,21,21,52
OceanDNA-b33388,1370,15.7,0.0,2e-06,0.0015,120,150,327,357,316,365,0.91,30,30,49
OceanDNA-b14104,281,17.0,0.0,4.9e-07,7.7e-05,116,151,160,195,155,202,0.91,35,35,47
OceanDNA-b27448,73,11.2,0.0,9.5e-06,0.0025,118,156,224,262,211,273,0.91,38,38,62
OceanDNA-b7262,306,124.6,0.0,2.4e-40,9e-38,38,247,65,280,44,292,0.91,209,215,248
OceanDNA-a2373,193,-3.5,0.0,0.28,110.0,161,177,266,282,264,284,0.9,16,16,20
OceanDNA-b46812,1104,13.0,0.1,1e-05,0.0063,118,152,231,265,218,270,0.9,34,34,52
OceanDNA-b45536,507,12.9,0.0,2.8e-06,0.0017,118,154,250,286,242,301,0.9,36,36,59
OceanDNA-b22978,1591,11.0,0.0,1.1e-05,0.024,117,152,217,252,208,259,0.9,35,35,51
OceanDNA-b22995,1641,13.3,0.0,6.6e-06,0.0046,118,146,216,244,197,256,0.9,28,28,59
OceanDNA-b29510,2029,11.8,0.0,1.8e-05,0.015,151,196,13,57,9,62,0.9,45,44,53
OceanDNA-b12582,169,15.5,0.0,4.4e-07,0.00016,119,151,121,153,116,163,0.9,32,32,47
OceanDNA-b31245,1431,19.4,0.0,2.9e-08,5.5e-05,121,150,147,176,135,190,0.9,29,29,55
OceanDNA-b14283,358,12.6,0.1,3.6e-06,0.0017,116,151,161,196,153,203,0.9,35,35,50
OceanDNA-b19147,46,9.2,0.0,7.6e-05,0.014,54,85,209,240,200,263,0.9,31,31,63
OceanDNA-b24136,3117,12.2,0.1,9.1e-06,0.016,117,155,138,176,120,186,0.9,38,38,66
OceanDNA-b22385,1572,15.4,0.1,9.5e-07,0.0018,118,152,265,299,250,305,0.9,34,34,55
OceanDNA-b50,2159,10.0,0.0,2.2e-05,0.057,115,154,232,271,221,285,0.9,39,39,64
OceanDNA-b20097,206,10.1,0.0,5.9e-05,0.0059,119,158,2,41,1,50,0.9,39,39,49
OceanDNA-b44039,31,18.4,0.0,1.2e-07,1.8e-05,119,147,136,164,123,176,0.9,28,28,53
OceanDNA-b13088,539,18.5,0.0,1.1e-07,0.0002,163,229,608,676,600,681,0.9,66,68,81
OceanDNA-b46265,1268,13.3,0.1,2.2e-06,0.0039,118,153,239,274,228,286,0.9,35,35,58
OceanDNA-b23345,103,-2.1,0.0,0.11,220.0,162,177,784,799,762,804,0.9,15,15,42
OceanDNA-b20588,136,7.7,0.0,0.00011,0.027,44,85,119,160,108,167,0.9,41,41,59
OceanDNA-b2796,1858,10.1,0.0,4.2e-05,0.042,124,151,215,242,197,268,0.9,27,27,71
OceanDNA-b13585,772,5.4,0.0,0.0022,0.81,48,84,38,74,31,78,0.9,36,36,47
OceanDNA-b22512,912,12.0,0.0,1e-05,0.013,118,152,206,240,199,248,0.9,34,34,49
OceanDNA-b22118,1516,18.2,0.0,6.6e-08,0.00014,99,157,513,569,509,574,0.9,58,56,65
OceanDNA-b6218,393,10.3,0.0,1.7e-05,0.0093,152,184,282,314,271,352,0.9,32,32,81
OceanDNA-b45438,1698,13.9,0.0,1.4e-06,0.0028,119,152,203,236,195,242,0.9,33,33,47
OceanDNA-b23843,2041,15.6,0.0,4.3e-07,0.00098,119,150,159,190,149,197,0.9,31,31,48
OceanDNA-b15465,725,10.1,0.1,6.1e-05,0.021,116,155,218,257,206,267,0.9,39,39,61
OceanDNA-b22131,703,18.6,0.0,1e-07,4.5e-05,118,186,409,477,394,512,0.9,68,68,118
OceanDNA-b32969,132,12.7,0.0,3.3e-06,0.0017,120,149,157,186,154,220,0.9,29,29,66
OceanDNA-b10475,234,10.7,0.0,1.3e-05,0.0064,151,181,286,316,277,327,0.9,30,30,50
OceanDNA-b10017,7,12.5,0.0,3.7e-06,0.0027,99,154,104,157,27,168,0.9,55,53,141
OceanDNA-b5654,190,19.9,0.0,2e-08,5.5e-06,115,197,119,199,105,220,0.9,82,80,115
OceanDNA-b11496,91,9.4,0.0,3.3e-05,0.013,159,231,249,321,238,322,0.9,72,72,84
OceanDNA-b23340,1830,16.9,0.0,1.7e-07,0.00034,122,150,140,168,130,182,0.9,28,28,52
OceanDNA-b17273,142,189.4,0.1,7.9e-60,9.9e-57,33,242,78,296,43,310,0.9,209,218,267
OceanDNA-b45381,2554,15.4,0.0,5e-07,0.0014,117,152,360,395,278,408,0.9,35,35,130
OceanDNA-b11455,288,12.1,0.0,4.9e-06,0.0038,115,154,236,275,147,280,0.9,39,39,133
OceanDNA-b1751,2372,20.0,0.1,1.9e-08,5.4e-05,115,150,73,108,54,126,0.9,35,35,72
OceanDNA-b19928,527,3.0,0.0,0.0029,1.7,49,85,198,234,185,245,0.9,36,36,60
OceanDNA-b45222,860,14.2,0.0,1.1e-06,0.0029,117,175,179,238,111,248,0.9,58,59,137
OceanDNA-b31172,1603,5.8,0.0,0.00042,0.68,115,154,209,248,200,258,0.9,39,39,58
OceanDNA-b29080,323,15.6,0.0,4.3e-07,0.00068,118,141,134,157,127,196,0.9,23,23,69
OceanDNA-b22656,602,15.6,0.0,4.3e-07,0.00035,103,154,247,298,236,305,0.9,51,51,69
OceanDNA-b28232,217,14.5,0.0,9.3e-07,0.0023,119,141,139,161,134,176,0.9,22,22,42
OceanDNA-b27568,1749,10.7,0.0,1.3e-05,0.033,160,192,9,40,5,46,0.9,32,31,41
OceanDNA-b58,793,10.8,0.0,1.2e-05,0.016,115,150,235,270,223,279,0.9,35,35,56
OceanDNA-b20925,3379,11.2,0.4,9e-06,0.076,92,147,237,292,229,295,0.9,55,55,66
OceanDNA-b27518,1644,14.0,0.0,1.3e-06,0.0024,119,141,145,167,130,183,0.9,22,22,53
OceanDNA-b15876,457,12.5,0.1,7.6e-06,0.005,114,148,152,186,106,197,0.9,34,34,91
OceanDNA-b22615,804,168.5,0.0,1.9e-53,5.7e-50,7,244,81,325,77,335,0.9,237,244,258
OceanDNA-b22393,660,13.7,0.0,3.2e-06,0.0025,114,155,195,236,184,247,0.9,41,41,63
OceanDNA-b42531,121,12.7,0.0,3.3e-06,0.00079,118,153,155,190,141,251,0.9,35,35,110
OceanDNA-b46823,158,12.8,0.1,6e-06,0.0054,117,153,238,274,227,285,0.89,36,36,58
OceanDNA-b23364,1374,10.5,0.2,3.1e-05,0.036,123,148,140,165,133,224,0.89,25,25,91
OceanDNA-b7184,341,13.2,0.0,4.7e-06,0.0012,148,180,272,304,263,315,0.89,32,32,52
OceanDNA-b3704,1601,15.2,0.0,5.4e-07,0.0015,119,145,142,168,128,180,0.89,26,26,52
OceanDNA-b42477,163,12.4,0.0,3.9e-06,0.0011,118,153,167,202,146,237,0.89,35,35,91
OceanDNA-b24798,1913,12.3,0.0,4.4e-06,0.014,97,145,129,177,120,220,0.89,48,48,100
OceanDNA-b46558,120,10.4,0.0,3.2e-05,0.0099,118,153,197,232,190,244,0.89,35,35,54
OceanDNA-b36755,2942,12.7,0.1,3.3e-06,0.012,121,152,99,130,74,140,0.89,31,31,66
OceanDNA-b39392,712,20.2,0.0,1.7e-08,1.4e-05,119,145,142,168,124,187,0.89,26,26,63
OceanDNA-b32650,1081,16.3,0.0,2.6e-07,0.0005,119,146,163,190,150,202,0.89,27,27,52
OceanDNA-b28083,995,17.4,0.0,2.3e-07,0.0002,119,144,140,165,135,182,0.89,25,25,47
OceanDNA-b45854,1983,1.2,0.0,0.021,22.0,118,160,66,108,61,113,0.89,42,42,52
OceanDNA-b6503,557,9.2,0.1,7.8e-05,0.025,138,185,195,242,190,252,0.89,47,47,62
OceanDNA-b9937,387,11.8,0.0,6.2e-06,0.0026,99,154,99,152,91,158,0.89,55,53,67
OceanDNA-b15517,600,19.0,0.0,3.8e-08,4.4e-05,84,167,83,159,28,166,0.89,83,76,138
OceanDNA-b23327,1031,10.5,0.1,1.5e-05,0.024,122,145,78,101,70,110,0.89,23,23,40
OceanDNA-b17074,178,10.4,0.0,1.6e-05,0.026,113,151,254,292,242,303,0.89,38,38,61
OceanDNA-b30499,1061,11.8,0.1,6e-06,0.0078,124,147,82,105,69,150,0.89,23,23,81
OceanDNA-b4004,464,11.7,0.0,2e-05,0.0076,74,140,87,153,54,157,0.89,66,66,103
OceanDNA-b32790,63,15.7,0.1,4e-07,0.00011,110,163,155,208,143,218,0.89,53,53,75
OceanDNA-b44623,1895,10.7,0.0,2.6e-05,0.028,163,230,648,717,636,721,0.89,67,69,85
OceanDNA-b46704,1023,16.0,0.1,9.7e-07,0.00062,117,153,294,330,279,342,0.89,36,36,63
OceanDNA-b30022,2137,15.2,0.0,1.1e-06,0.0018,119,142,170,193,164,213,0.89,23,23,49
OceanDNA-b33318,3389,16.7,0.0,1.9e-07,0.00089,119,147,144,172,133,185,0.89,28,28,52
OceanDNA-b45626,73,11.6,0.0,7.1e-06,0.0051,118,153,261,296,237,306,0.89,35,35,69
OceanDNA-b13299,1029,13.7,0.0,3.1e-06,0.0017,115,150,217,252,158,260,0.89,35,35,102
OceanDNA-b32911,528,10.7,0.0,1.4e-05,0.018,140,185,189,234,183,278,0.89,45,45,95
OceanDNA-b11500,110,8.1,0.0,8e-05,0.031,160,231,248,319,232,320,0.89,71,71,88
OceanDNA-b17187,892,12.4,0.0,3.9e-06,0.0039,117,152,62,97,50,105,0.89,35,35,55
OceanDNA-b22760,2709,15.0,0.0,6.2e-07,0.0022,103,154,235,286,225,295,0.89,51,51,70
OceanDNA-b46702,1106,13.2,0.0,4.7e-06,0.0042,114,151,157,194,143,203,0.89,37,37,60
OceanDNA-b27579,1754,11.5,0.0,1.5e-05,0.022,124,147,180,203,170,211,0.89,23,23,41
OceanDNA-b37342,417,15.0,0.0,6.6e-07,0.00087,119,145,182,208,170,222,0.89,26,26,52
OceanDNA-b17441,966,190.1,0.0,2.5e-60,2.5e-57,35,241,75,290,47,306,0.89,206,215,259
OceanDNA-b45578,722,14.7,0.0,8.2e-07,0.00087,118,152,243,277,221,287,0.89,34,34,66
OceanDNA-b45859,1146,13.0,0.0,2.7e-06,0.0097,117,150,146,179,133,186,0.89,33,33,53
OceanDNA-b30085,1277,12.5,0.1,3.6e-06,0.0079,119,141,162,184,157,205,0.89,22,22,48
OceanDNA-b7374,41,111.7,0.0,2.1e-36,6.5e-34,19,240,44,273,34,284,0.89,221,229,250
OceanDNA-b34551,215,22.9,0.0,7.3e-09,2.1e-06,163,233,617,689,605,694,0.89,70,72,89
OceanDNA-b44357,392,13.5,0.0,3.8e-06,0.0011,115,149,97,131,74,139,0.89,34,34,65
OceanDNA-b35127,740,20.9,0.0,1e-08,1e-05,163,229,622,690,600,693,0.89,66,68,93
OceanDNA-b23819,1194,16.7,0.0,1.9e-07,0.00033,120,148,149,177,136,261,0.89,28,28,125
OceanDNA-b42818,121,11.7,0.0,6.7e-06,0.0057,118,151,493,526,481,534,0.89,33,33,53
OceanDNA-b41521,1520,13.2,0.0,2.3e-06,0.0042,119,145,149,175,134,186,0.89,26,26,52
OceanDNA-b46656,3169,12.7,0.1,1.3e-05,0.011,117,153,241,277,226,290,0.89,36,36,64
OceanDNA-b19896,68,2.3,0.0,0.0048,1.9,53,86,207,240,197,248,0.89,33,33,51
OceanDNA-b34663,609,10.9,0.0,3.5e-05,0.0096,44,117,180,254,176,267,0.89,73,74,91
OceanDNA-b23054,1548,11.5,0.0,7.4e-06,0.019,70,105,53,88,41,95,0.89,35,35,54
OceanDNA-b37666,564,14.9,0.0,7.1e-07,0.00052,119,145,150,176,141,192,0.89,26,26,51
OceanDNA-b27590,926,14.8,0.0,1.4e-06,0.0017,120,150,174,204,165,272,0.89,30,30,107
OceanDNA-b45508,965,10.5,0.1,1.6e-05,0.018,116,160,126,170,112,176,0.89,44,44,64
OceanDNA-b6781,378,12.8,0.0,3.1e-06,0.0016,152,184,268,300,260,324,0.89,32,32,64
OceanDNA-b32763,337,10.4,0.0,3.2e-05,0.025,115,154,209,248,198,263,0.89,39,39,65
OceanDNA-b23655,661,5.2,0.0,0.00065,1.2,163,194,269,299,251,327,0.89,31,30,76
OceanDNA-b15497,403,11.5,0.0,7.3e-06,0.0036,116,151,170,205,160,212,0.89,35,35,52
OceanDNA-b46229,1046,11.1,0.1,1.9e-05,0.014,118,153,246,281,238,293,0.89,35,35,55
OceanDNA-b10366,399,13.9,0.1,1.4e-06,0.0022,138,194,247,303,244,311,0.89,56,56,67
OceanDNA-b32011,1221,11.7,0.0,6.4e-06,0.014,115,150,113,148,106,155,0.89,35,35,49
OceanDNA-b32645,804,10.7,0.0,1.4e-05,0.011,26,82,19,75,4,84,0.89,56,56,80
OceanDNA-b29498,644,12.7,0.0,3.2e-06,0.007,119,141,163,185,152,202,0.89,22,22,50
OceanDNA-b46326,1026,18.6,0.2,1e-07,0.00014,116,153,286,323,275,329,0.89,37,37,54
OceanDNA-b23199,586,11.9,0.0,5.8e-06,0.011,118,152,201,235,189,244,0.89,34,34,55
OceanDNA-b46722,1228,13.2,0.0,7e-06,0.0038,114,151,157,194,143,203,0.89,37,37,60
OceanDNA-b20708,83,3.3,0.0,0.0023,0.51,45,86,156,197,138,201,0.89,41,41,63
OceanDNA-b31592,1648,12.6,0.1,3.4e-06,0.0086,119,150,161,192,154,200,0.89,31,31,46
OceanDNA-b30970,144,11.6,0.1,2.2e-05,0.018,118,155,116,153,88,167,0.89,37,37,79
OceanDNA-b45131,359,12.3,0.0,4.2e-06,0.0054,116,153,178,215,167,223,0.89,37,37,56
OceanDNA-b44435,2563,17.3,0.0,2.6e-07,0.00033,163,229,475,543,464,546,0.89,66,68,82
OceanDNA-b26613,119,9.3,0.1,3.4e-05,0.019,122,154,90,122,83,131,0.89,32,32,48
OceanDNA-b15515,1817,10.9,0.0,2.2e-05,0.023,118,163,125,170,42,177,0.89,45,45,135
OceanDNA-b41583,245,3.6,0.0,0.0019,1.2,163,200,260,297,245,305,0.89,37,37,60
OceanDNA-b46728,421,16.1,0.1,1.2e-06,0.0005,117,153,273,309,258,321,0.89,36,36,63
OceanDNA-b6173,392,121.3,0.2,2.4e-39,1.3e-36,37,246,53,273,31,283,0.89,209,220,252
OceanDNA-b6582,313,14.2,0.1,1.1e-06,0.00069,138,188,196,246,191,257,0.89,50,50,66
OceanDNA-b45576,1161,12.4,0.0,4e-06,0.0052,118,153,194,229,175,239,0.89,35,35,64
OceanDNA-b28567,65,16.0,0.1,3.3e-07,0.00024,118,141,185,208,178,223,0.89,23,23,45
OceanDNA-b32861,660,16.7,0.0,3.9e-07,0.00024,118,145,154,181,142,197,0.89,27,27,55
OceanDNA-b46349,97,18.7,0.2,4.6e-08,0.00012,116,153,247,284,236,290,0.89,37,37,54
OceanDNA-b24005,575,19.4,0.0,3e-08,5.3e-05,163,234,585,658,572,662,0.89,71,73,90
OceanDNA-b20404,296,14.4,0.0,1e-06,0.00042,119,157,248,286,222,309,0.89,38,38,87
OceanDNA-b21028,240,13.4,0.0,1.9e-06,0.005,118,150,189,221,182,230,0.89,32,32,48
OceanDNA-b12537,160,13.8,0.0,1.5e-06,0.00035,119,151,36,68,26,76,0.89,32,32,50
OceanDNA-b3621,155,3.2,0.0,0.0026,2.3,48,85,174,211,166,217,0.89,37,37,51
OceanDNA-b3414,1223,10.0,0.1,2.2e-05,0.032,124,152,80,108,71,115,0.88,28,28,44
OceanDNA-b46812,1757,11.8,0.0,2.4e-05,0.014,119,147,122,150,104,159,0.88,28,28,55
OceanDNA-b20982,1046,5.4,0.0,0.00055,1.7,119,145,138,164,130,183,0.88,26,26,53
OceanDNA-b37349,143,16.4,0.0,2.5e-07,0.00016,89,157,207,277,204,285,0.88,68,70,81
OceanDNA-b36076,862,10.7,0.0,2.6e-05,0.034,54,87,117,150,101,156,0.88,33,33,55
OceanDNA-b39489,22,15.9,0.0,3.4e-07,0.00023,163,229,657,725,638,729,0.88,66,68,91
OceanDNA-b13256,790,-3.5,0.0,1.9,550.0,57,78,826,847,820,848,0.88,21,21,28
OceanDNA-b22607,586,13.2,0.2,4.5e-06,0.002,117,152,226,261,210,265,0.88,35,35,55
OceanDNA-b39796,352,15.7,0.0,4e-07,0.00028,119,145,142,168,115,185,0.88,26,26,70
OceanDNA-b46952,658,14.1,0.1,1.2e-06,0.00098,117,153,107,143,92,156,0.88,36,36,64
OceanDNA-b35009,27,17.0,0.0,1.5e-07,0.00013,163,229,620,688,583,690,0.88,66,68,107
OceanDNA-b4488,2233,11.0,0.1,3.3e-05,0.03,117,151,259,293,250,304,0.88,34,34,54
OceanDNA-b23850,1393,6.6,0.0,0.00068,0.33,120,147,141,168,130,176,0.88,27,27,46
OceanDNA-b37839,408,18.4,0.0,5.7e-08,5.3e-05,117,146,174,203,157,226,0.88,29,29,69
OceanDNA-b37895,508,14.3,0.0,1.1e-06,0.00084,163,231,601,671,590,674,0.88,68,70,84
OceanDNA-b36890,852,0.7,0.0,0.015,24.0,106,125,20,39,16,46,0.88,19,19,30
OceanDNA-b27612,1540,11.5,0.1,7.4e-06,0.018,119,141,153,175,145,200,0.88,22,22,55
OceanDNA-b34938,31,10.1,0.0,4.1e-05,0.025,125,150,167,192,162,205,0.88,25,25,43
OceanDNA-b7010,154,125.2,0.0,3.2e-40,6.7e-38,20,240,59,287,48,295,0.88,220,228,247
OceanDNA-b43,3730,16.1,0.0,5.9e-07,0.002,163,231,650,720,641,722,0.88,68,70,81
OceanDNA-b7450,617,20.2,0.0,3.2e-08,2.1e-05,157,233,184,258,174,269,0.88,76,74,95
OceanDNA-b46255,2822,14.1,0.2,3.6e-06,0.0039,117,153,243,279,226,292,0.88,36,36,66
OceanDNA-b29592,1803,12.0,0.1,5.2e-06,0.013,118,139,531,552,522,578,0.88,21,21,56
OceanDNA-b28045,26,14.1,0.0,1.2e-06,0.0015,118,145,170,197,161,216,0.88,27,27,55
OceanDNA-b20908,8483,3.1,0.0,0.0027,27.0,217,248,282,313,268,319,0.88,31,31,51
OceanDNA-b46625,550,10.6,0.0,4.3e-05,0.013,118,154,197,233,190,245,0.88,36,36,55
OceanDNA-b45166,151,13.9,0.3,1.4e-06,0.0021,122,152,319,349,313,354,0.88,30,30,41
OceanDNA-b37527,1146,21.6,0.0,1.2e-08,1.4e-05,101,155,123,176,114,184,0.88,54,53,70
OceanDNA-b16133,307,12.8,0.0,9.3e-06,0.0035,117,149,142,174,131,184,0.88,32,32,53
OceanDNA-b27600,381,11.1,0.1,1e-05,0.016,119,142,147,170,143,184,0.88,23,23,41
OceanDNA-b30136,297,17.6,0.0,1.1e-07,0.00023,118,144,167,193,161,213,0.88,26,26,52
OceanDNA-b37750,321,21.9,0.0,5.2e-09,4.1e-06,118,149,150,181,133,205,0.88,31,31,72
OceanDNA-b30447,350,6.9,0.0,0.0002,0.51,125,152,177,204,166,219,0.88,27,27,53
OceanDNA-b22212,22,11.4,0.1,8.2e-06,0.007,115,145,200,230,190,324,0.88,30,30,134
OceanDNA-b15902,887,11.1,0.1,1e-05,0.01,121,152,95,126,57,142,0.88,31,31,85
OceanDNA-b42446,268,12.7,0.0,3.3e-06,0.00094,118,153,149,184,135,193,0.88,35,35,58
OceanDNA-b19934,261,3.6,0.0,0.002,0.72,47,85,196,234,181,242,0.88,38,38,61
OceanDNA-b19574,99,1.6,0.0,0.0081,3.1,53,85,242,274,233,286,0.88,32,32,53
OceanDNA-b27570,926,16.0,0.0,6.2e-07,0.00086,119,144,150,175,144,195,0.88,25,25,51
OceanDNA-b6778,256,8.9,0.0,4.8e-05,0.029,151,180,273,302,264,314,0.88,29,29,50
OceanDNA-b44440,1094,16.2,0.0,2.8e-07,0.00066,163,229,633,701,622,704,0.88,66,68,82
OceanDNA-b21047,1280,10.4,0.0,1.7e-05,0.023,76,153,5,84,1,89,0.88,77,79,88
OceanDNA-b20918,1824,12.1,0.0,9.8e-06,0.016,72,122,64,117,54,145,0.88,50,53,91
OceanDNA-b22234,1808,11.7,0.0,6.3e-06,0.012,104,173,268,339,223,352,0.88,69,71,129
OceanDNA-b22112,1138,118.7,0.0,1.5e-38,3.5e-35,35,244,90,305,58,317,0.88,209,215,259
OceanDNA-b33303,944,17.8,0.0,8.7e-08,0.00037,119,148,155,184,140,197,0.88,29,29,57
OceanDNA-b40624,141,17.0,0.0,3.2e-07,0.00016,119,146,143,170,132,188,0.88,27,27,56
OceanDNA-b32911,528,5.9,0.0,0.00039,0.52,115,145,88,118,69,127,0.88,30,30,58
OceanDNA-b24230,372,7.3,0.0,0.00015,0.062,117,151,181,216,158,271,0.88,34,35,113
OceanDNA-b10708,286,128.2,0.0,1.9e-41,8.1e-39,34,240,59,271,30,280,0.88,206,212,250
OceanDNA-b17623,1212,10.9,0.2,2.3e-05,0.035,105,155,151,200,57,208,0.88,50,49,151
OceanDNA-b33388,2817,14.7,0.0,4e-06,0.0031,119,147,414,442,400,456,0.88,28,28,56
OceanDNA-b7584,366,11.2,0.0,9.3e-06,0.0036,152,184,287,319,280,337,0.88,32,32,57
OceanDNA-b15784,572,12.6,0.0,3.4e-06,0.0036,116,162,110,156,93,162,0.88,46,46,69
OceanDNA-b22324,2077,13.3,0.0,1e-05,0.0086,117,150,232,265,219,280,0.88,33,33,61
OceanDNA-b15777,892,3.4,0.0,0.0067,3.9,124,143,140,159,83,172,0.88,19,19,89
OceanDNA-b6509,444,6.4,0.0,0.00026,0.27,194,237,250,291,238,310,0.88,43,41,72
OceanDNA-b7279,223,11.9,0.0,5.7e-06,0.0021,147,182,78,113,68,126,0.88,35,35,58
OceanDNA-b31456,54,16.3,0.0,2.6e-07,0.00049,119,148,148,177,143,187,0.88,29,29,44
OceanDNA-b32277,1368,16.7,0.0,1.9e-07,0.0004,119,145,153,179,141,193,0.88,26,26,52
OceanDNA-b37582,1724,13.1,0.0,5e-06,0.0061,102,154,162,216,126,234,0.88,52,54,108
OceanDNA-b30086,99,14.2,0.0,1.1e-06,0.0025,118,142,134,158,124,173,0.88,24,24,49
OceanDNA-b13674,206,12.0,0.0,5.1e-06,0.0012,118,155,178,215,160,226,0.88,37,37,66
OceanDNA-b15551,376,9.6,0.0,5.8e-05,0.061,116,155,164,203,149,211,0.88,39,39,62
OceanDNA-b2592,2047,18.7,0.0,4.6e-08,0.00012,117,155,185,223,170,230,0.88,38,38,60
OceanDNA-b32913,1254,14.0,0.2,2.6e-06,0.0025,96,150,233,284,228,291,0.88,54,51,63
OceanDNA-b40613,167,16.5,0.0,6.5e-07,0.00017,120,145,141,166,126,185,0.88,25,25,59
OceanDNA-b18519,79,10.9,0.0,3.4e-05,0.0036,163,229,615,683,603,685,0.88,66,68,82
OceanDNA-b18519,306,11.1,0.0,3.1e-05,0.0032,118,143,148,173,129,181,0.88,25,25,52
OceanDNA-b22397,2422,16.0,0.0,1.2e-06,0.00082,117,146,245,274,235,281,0.88,29,29,46
OceanDNA-b40629,357,6.5,0.0,0.00026,0.16,125,152,89,116,76,124,0.88,27,27,48
OceanDNA-b32108,133,27.4,0.0,2.1e-10,2.8e-07,101,197,132,227,62,242,0.88,96,95,180
OceanDNA-b29993,55,14.3,0.0,1.1e-06,0.0016,119,142,146,169,138,192,0.88,23,23,54
OceanDNA-b6426,302,130.0,0.0,5.2e-42,3.8e-39,19,240,39,268,25,275,0.88,221,229,250
OceanDNA-b38049,473,15.0,0.0,6.6e-07,0.00053,163,229,624,692,615,695,0.88,66,68,80
OceanDNA-b20708,83,11.5,0.0,7.5e-06,0.0016,115,156,259,300,238,312,0.88,41,41,74
OceanDNA-b40618,151,15.5,0.0,1.3e-06,0.00026,119,146,150,177,142,191,0.88,27,27,49
OceanDNA-b40618,49,181.3,0.0,3.5e-57,7e-55,35,240,53,275,33,290,0.88,205,222,257
OceanDNA-b23584,548,11.5,0.0,1.5e-05,0.018,31,53,95,117,75,138,0.88,22,22,63
OceanDNA-b35016,214,14.4,0.0,9.7e-07,0.00086,163,229,620,688,582,690,0.88,66,68,108
OceanDNA-b4726,421,10.6,0.0,1.5e-05,0.012,123,145,114,136,107,145,0.88,22,22,38
OceanDNA-b30031,2225,16.5,0.0,4.5e-07,0.0005,118,144,26,52,19,68,0.88,26,26,49
OceanDNA-b22610,773,9.6,0.0,2.8e-05,0.027,163,229,206,274,201,275,0.88,66,68,74
OceanDNA-b46216,450,13.1,0.0,2.4e-06,0.0032,117,152,232,267,202,271,0.88,35,35,69
OceanDNA-b22394,801,4.5,0.0,0.0021,2.0,116,138,464,486,409,495,0.88,22,22,86
OceanDNA-b15447,354,10.0,0.0,2.2e-05,0.008,115,155,146,186,109,200,0.88,40,40,91
OceanDNA-b41581,30,22.2,0.1,4.2e-09,2.5e-06,98,154,123,178,117,184,0.88,56,55,67
OceanDNA-b40232,395,11.8,0.6,1.8e-05,0.014,88,129,132,174,113,185,0.88,41,42,72
OceanDNA-b4858,199,109.2,0.0,1.2e-35,2.4e-33,33,247,50,273,25,283,0.88,214,223,258
OceanDNA-b26884,1682,10.7,0.0,1.3e-05,0.037,118,145,172,199,161,211,0.88,27,27,50
OceanDNA-b31694,127,17.4,0.0,1.2e-07,0.00016,119,146,124,151,108,161,0.88,27,27,53
OceanDNA-b22478,1038,13.5,0.0,3.7e-06,0.0044,115,161,136,182,119,188,0.88,46,46,69
OceanDNA-b44357,128,9.8,0.1,5.1e-05,0.014,118,152,169,203,154,209,0.88,34,34,55
OceanDNA-b42,3294,14.2,0.0,1.1e-06,0.0062,163,229,449,517,440,523,0.88,66,68,83
OceanDNA-b32757,170,13.9,0.0,1.4e-06,0.00068,116,156,210,250,198,264,0.88,40,40,66
OceanDNA-b15080,267,12.6,0.0,3.5e-06,0.0036,122,147,126,151,120,191,0.88,25,25,71
OceanDNA-b24973,397,10.6,0.0,1.4e-05,0.0064,114,154,180,220,164,237,0.88,40,40,73
OceanDNA-b32661,1278,15.9,0.0,3.3e-07,0.00082,119,147,150,178,135,188,0.88,28,28,53
OceanDNA-b35167,467,29.6,0.1,4.5e-11,1.8e-08,99,153,34,85,27,98,0.88,54,51,71
OceanDNA-b37298,235,17.0,0.0,1.6e-07,0.00015,119,145,159,185,148,204,0.88,26,26,56
OceanDNA-b3934,51,-0.0,0.0,0.049,17.0,219,247,363,391,356,400,0.88,28,28,44
OceanDNA-b6423,306,136.1,0.0,7.3e-44,3.6e-41,19,240,43,272,30,280,0.88,221,229,250
OceanDNA-b38596,380,12.8,0.0,3.1e-06,0.0015,122,150,33,61,15,108,0.88,28,28,93
OceanDNA-b37833,607,16.6,0.0,4.2e-07,0.00022,118,145,148,175,135,223,0.88,27,27,88
OceanDNA-b5215,68,15.7,0.0,3.9e-07,0.00011,104,149,97,142,91,153,0.88,45,45,62
OceanDNA-b20511,29,15.2,0.0,5.7e-07,0.00016,89,155,208,276,199,296,0.88,66,68,97
OceanDNA-b45383,5853,12.2,0.0,4.7e-06,0.043,123,187,13,77,6,91,0.88,64,64,85
OceanDNA-b38572,538,3.6,0.0,0.0019,1.1,164,193,236,265,224,272,0.88,29,29,48
OceanDNA-b34735,66,18.3,0.0,1.9e-07,4.1e-05,163,233,621,693,609,697,0.88,70,72,88
OceanDNA-b20588,136,14.3,0.0,1.1e-06,0.00026,89,157,201,270,199,276,0.88,68,69,77
OceanDNA-b22220,1345,15.0,0.0,1.3e-06,0.0011,104,155,12,64,9,70,0.88,51,52,61
OceanDNA-b9687,398,19.4,0.0,6e-08,2.7e-05,162,231,620,691,616,693,0.88,69,71,77
OceanDNA-b5623,189,15.1,0.0,6e-07,0.00019,117,197,146,225,132,250,0.88,80,79,118
OceanDNA-b45370,3,12.5,0.0,7.6e-06,0.0048,116,153,240,277,223,286,0.88,37,37,63
OceanDNA-b22848,1547,12.3,0.0,8.4e-06,0.017,114,143,152,181,135,191,0.88,29,29,56
OceanDNA-b31459,42,16.3,0.0,2.5e-07,0.00049,119,148,148,177,142,187,0.88,29,29,45
OceanDNA-b45487,190,10.8,0.0,1.3e-05,0.029,117,152,235,270,213,279,0.88,35,35,66
OceanDNA-b37747,985,14.8,0.0,7.4e-07,0.00074,118,149,150,181,138,193,0.88,31,31,55
OceanDNA-b40681,438,16.9,0.0,1.7e-07,8.7e-05,119,146,143,170,133,184,0.88,27,27,51
OceanDNA-b13585,820,12.5,0.0,1.5e-05,0.0057,118,155,93,130,80,139,0.88,37,37,59
OceanDNA-b8264,535,9.9,0.0,4.8e-05,0.017,148,181,288,321,278,329,0.88,33,33,51
OceanDNA-b45520,1064,19.0,0.0,7.7e-08,5.4e-05,96,151,177,233,168,240,0.88,55,56,72
OceanDNA-b37856,208,7.3,0.0,0.00014,0.11,15,85,59,128,50,154,0.88,70,69,104
OceanDNA-b40527,138,5.4,0.0,0.0011,0.42,167,229,233,295,227,298,0.88,62,62,71
OceanDNA-b32281,1901,18.0,0.0,7.8e-08,0.00015,119,147,26,54,18,66,0.88,28,28,48
OceanDNA-b46594,693,10.1,0.0,2e-05,0.03,117,153,217,253,208,272,0.88,36,36,64
OceanDNA-b31076,1999,14.2,0.1,3.5e-06,0.0034,115,158,182,225,170,243,0.88,43,43,73
OceanDNA-b46684,332,12.5,0.0,3.7e-06,0.0028,118,153,239,274,197,284,0.88,35,35,87
OceanDNA-b22387,366,12.1,0.0,9.8e-06,0.011,114,155,236,277,225,289,0.88,41,41,64
OceanDNA-b24820,498,16.3,0.0,2.6e-07,0.00018,119,146,143,170,135,184,0.88,27,27,49
OceanDNA-b45287,2349,11.3,0.1,8.6e-06,0.023,116,161,245,291,240,296,0.88,45,46,56
OceanDNA-b17334,201,11.6,0.0,6.8e-06,0.0057,194,252,59,117,40,126,0.88,58,58,86
OceanDNA-b29579,235,12.8,0.0,3e-06,0.0021,118,142,138,162,132,182,0.88,24,24,50
OceanDNA-b44053,587,14.9,0.0,6.8e-07,0.00092,163,232,644,715,636,722,0.88,69,71,86
OceanDNA-b44662,2521,-1.1,0.0,0.1,140.0,144,176,216,248,199,254,0.88,32,32,55
OceanDNA-b35110,138,17.9,0.0,1.6e-07,6.4e-05,163,235,423,497,411,500,0.88,72,74,89
OceanDNA-b15711,143,22.1,0.0,8.6e-09,4.9e-06,86,167,81,155,23,162,0.88,81,74,139
OceanDNA-b28125,933,16.9,0.0,1.7e-07,0.00047,118,144,180,206,174,235,0.88,26,26,61
OceanDNA-b7401,137,11.2,0.0,9.6e-06,0.0027,148,181,155,188,145,199,0.88,33,33,54
OceanDNA-b13076,1906,16.1,0.4,2.9e-07,0.00077,17,74,65,123,58,130,0.88,57,58,72
OceanDNA-b12531,133,29.5,0.0,2.3e-11,8.6e-09,178,249,2,76,1,89,0.88,71,74,88
OceanDNA-b15078,251,13.7,0.1,1.6e-06,0.0016,123,149,19,45,13,83,0.87,26,26,70
OceanDNA-b37345,174,14.7,0.0,2.4e-06,0.0011,119,145,155,181,147,195,0.87,26,26,48
OceanDNA-b12544,188,128.0,0.1,2.2e-41,7.2e-39,36,243,77,295,49,307,0.87,207,218,258
OceanDNA-b29386,848,13.8,0.0,3.1e-06,0.0029,119,144,477,502,466,518,0.87,25,25,52
OceanDNA-b34630,690,12.7,0.0,6.4e-06,0.003,163,231,725,795,715,802,0.87,68,70,87
OceanDNA-a3473,410,12.8,0.0,2.9e-06,0.0012,114,171,45,102,31,119,0.87,57,57,88
OceanDNA-b45382,4338,11.1,0.0,1e-05,0.05,122,158,237,273,211,280,0.87,36,36,69
OceanDNA-b28578,509,12.6,0.0,3.4e-06,0.0021,119,141,143,165,138,189,0.87,22,22,51
OceanDNA-b15136,655,20.5,0.0,1.4e-08,9.3e-06,163,231,616,686,595,688,0.87,68,70,93
OceanDNA-b36886,1428,14.3,0.0,1e-06,0.0019,119,144,138,163,113,181,0.87,25,25,68
OceanDNA-b19665,86,0.3,0.0,0.039,9.4,55,85,226,256,215,261,0.87,30,30,46
OceanDNA-b44623,260,7.9,0.0,0.00019,0.21,119,147,537,565,530,577,0.87,28,28,47
OceanDNA-b36072,497,12.4,0.0,4e-06,0.0039,119,144,13,38,5,59,0.87,25,25,54
OceanDNA-b23139,799,23.6,0.0,3.1e-09,3.7e-06,118,151,164,198,148,259,0.87,33,34,111
OceanDNA-b37846,1121,10.4,0.0,1.6e-05,0.018,163,229,425,493,417,499,0.87,66,68,82
OceanDNA-b31121,180,11.1,0.0,9.8e-06,0.0065,118,162,13,57,6,73,0.87,44,44,67
OceanDNA-b34219,1020,12.0,0.0,5.2e-06,0.013,114,162,224,273,211,295,0.87,48,49,84
OceanDNA-b36913,743,11.2,0.0,9.6e-06,0.018,196,250,30,84,16,93,0.87,54,54,77
OceanDNA-b46695,283,13.9,0.0,7.2e-06,0.0031,114,151,159,196,147,205,0.87,37,37,58
OceanDNA-b23634,1508,17.2,0.1,4.1e-07,0.00034,116,153,276,313,252,323,0.87,37,37,71
OceanDNA-b32925,605,5.7,0.0,0.00043,0.97,115,145,90,120,70,128,0.87,30,30,58
OceanDNA-b15465,1021,10.8,0.0,3.8e-05,0.013,115,158,6,49,3,62,0.87,43,43,59
OceanDNA-b35898,1605,19.2,0.0,3.3e-08,6.3e-05,115,169,149,202,94,211,0.87,54,53,117
OceanDNA-b15465,725,5.1,0.0,0.002,0.7,161,216,296,351,275,356,0.87,55,55,81
OceanDNA-b31130,128,5.2,0.0,0.00063,0.36,115,153,118,154,105,166,0.87,38,36,61
OceanDNA-b22386,1518,18.5,0.0,1.6e-07,0.00011,102,154,74,126,63,135,0.87,52,52,72
OceanDNA-b22306,1201,11.2,0.0,9.1e-06,0.015,115,155,245,285,231,297,0.87,40,40,66
OceanDNA-b7440,29,123.7,0.0,4.3e-40,1.5e-37,18,240,39,269,27,280,0.87,222,230,253
OceanDNA-b3696,1147,10.8,0.0,1.2e-05,0.03,151,180,324,353,310,378,0.87,29,29,68
OceanDNA-b23364,1970,4.8,0.0,0.0017,2.0,136,189,297,351,288,358,0.87,53,54,70
OceanDNA-b40086,698,14.7,0.0,7.7e-07,0.00074,119,145,179,205,171,221,0.87,26,26,50
OceanDNA-b5721,663,10.1,0.0,2e-05,0.021,151,182,290,321,283,334,0.87,31,31,51
OceanDNA-b30718,465,13.7,0.1,1.6e-06,0.0031,122,150,152,180,146,205,0.87,28,28,59
OceanDNA-b38033,431,12.5,0.0,3.8e-06,0.0035,119,144,24,49,8,63,0.87,25,25,55
OceanDNA-b22387,1226,18.4,0.0,1.2e-07,0.00013,102,154,252,304,241,312,0.87,52,52,71
OceanDNA-b31567,588,12.6,0.1,3.5e-06,0.0059,120,150,5,35,3,42,0.87,30,30,39
OceanDNA-b36663,634,13.1,0.0,2.5e-06,0.0032,122,151,154,183,137,206,0.87,29,29,69
OceanDNA-b30011,1745,13.1,0.0,2.5e-06,0.0049,50,118,201,268,194,284,0.87,68,67,90
OceanDNA-b27549,938,15.6,0.2,8.7e-07,0.00093,118,142,340,364,334,379,0.87,24,24,45
OceanDNA-b40777,1138,189.4,0.0,4e-60,4.5e-57,18,240,40,278,28,291,0.87,222,238,263
OceanDNA-b15541,126,11.6,0.0,1.4e-05,0.013,115,155,150,190,129,198,0.87,40,40,69
OceanDNA-b37709,491,13.0,0.0,2.5e-06,0.0013,118,145,150,177,134,178,0.87,27,27,44
OceanDNA-b30127,816,14.4,0.1,9.7e-07,0.0023,123,152,150,179,135,210,0.87,29,29,75
OceanDNA-b46728,883,12.2,0.0,1.8e-05,0.0074,114,151,175,212,163,224,0.87,37,37,61
OceanDNA-b40713,68,11.8,0.0,1.2e-05,0.005,118,151,132,165,117,213,0.87,33,33,96
OceanDNA-b14831,96,11.5,0.1,7.7e-06,0.0021,32,76,140,184,125,201,0.87,44,44,76
OceanDNA-b33243,962,17.2,0.1,1.4e-07,0.00039,116,151,182,217,159,240,0.87,35,35,81
OceanDNA-b38157,181,7.7,0.0,0.00021,0.076,17,85,40,107,31,115,0.87,68,67,84
OceanDNA-b27416,97,10.9,0.0,1.2e-05,0.0031,116,157,221,262,211,277,0.87,41,41,66
OceanDNA-b28259,95,17.1,0.0,1.5e-07,6.2e-05,119,150,139,170,132,179,0.87,31,31,47
OceanDNA-b40444,469,13.9,0.0,5.7e-06,0.0026,121,148,145,172,130,183,0.87,27,27,53
OceanDNA-b10020,85,11.2,0.0,1.9e-05,0.0047,162,231,198,265,186,281,0.87,69,67,95
OceanDNA-b1825,2392,-1.7,0.0,0.16,290.0,217,243,720,746,713,751,0.87,26,26,38
OceanDNA-b35935,2229,10.6,0.1,2.9e-05,0.039,97,145,221,269,209,279,0.87,48,48,70
OceanDNA-b45370,996,11.0,0.0,2.1e-05,0.013,118,150,212,244,195,250,0.87,32,32,55
OceanDNA-b30025,2079,14.6,0.0,8.8e-07,0.0022,119,142,147,170,130,191,0.87,23,23,61
OceanDNA-b19314,92,13.7,0.0,1.6e-06,0.00052,106,137,122,153,104,209,0.87,31,31,105
OceanDNA-b19915,337,10.4,0.0,1.7e-05,0.0063,118,158,599,642,593,652,0.87,40,43,59
OceanDNA-b27491,217,16.1,0.0,3e-07,8.4e-05,115,158,216,259,184,283,0.87,43,43,99
OceanDNA-b45615,28,11.2,0.0,9.2e-06,0.0044,161,228,180,244,172,248,0.87,67,64,76
OceanDNA-b46536,1384,13.9,0.0,1.3e-06,0.0019,106,158,165,215,156,221,0.87,52,50,65
OceanDNA-b9390,184,13.2,0.0,2.3e-06,0.00069,163,229,609,677,595,679,0.87,66,68,84
OceanDNA-b34784,453,12.7,0.0,3.1e-06,0.0017,163,230,618,687,608,690,0.87,67,69,82
OceanDNA-b20967,119,-0.1,0.0,0.026,38.0,37,59,271,293,246,299,0.87,22,22,53
OceanDNA-b22997,133,57.3,0.0,1.6e-19,8.2e-17,4,211,24,237,21,255,0.87,207,213,234
OceanDNA-b22996,905,18.9,0.0,4.1e-08,6.4e-05,116,151,121,156,63,166,0.87,35,35,103
OceanDNA-b24637,144,12.5,0.1,3.8e-06,0.0026,35,79,160,204,155,216,0.87,44,44,61
OceanDNA-b19767,37,3.6,0.0,0.002,0.63,49,85,34,70,25,82,0.87,36,36,57
OceanDNA-b32695,807,13.7,0.0,1.6e-06,0.0015,154,227,211,280,191,281,0.87,73,69,90
OceanDNA-b45663,108,18.5,0.0,1.1e-07,4.6e-05,116,153,166,204,149,207,0.87,37,38,58
OceanDNA-b22492,710,5.0,0.0,0.00071,1.2,201,232,259,292,245,294,0.87,31,33,49
OceanDNA-b47035,354,11.8,0.0,1.2e-05,0.0039,118,151,164,197,148,211,0.87,33,33,63
OceanDNA-b47035,211,11.5,0.1,1.5e-05,0.0046,116,153,252,289,237,301,0.87,37,37,64
OceanDNA-b22842,1272,18.1,0.0,1.5e-07,0.00034,49,150,222,324,207,332,0.87,101,102,125
OceanDNA-b46697,1101,11.8,0.0,1.3e-05,0.013,118,150,200,232,180,241,0.87,32,32,61
OceanDNA-b4525,440,11.0,0.0,1.1e-05,0.0059,94,144,113,163,59,186,0.87,50,50,127
OceanDNA-b22178,122,0.7,0.0,0.015,5.2,47,68,262,283,255,290,0.87,21,21,35
OceanDNA-b26699,34,16.0,0.0,3.1e-07,0.0008,114,154,188,228,174,236,0.87,40,40,62
OceanDNA-b32144,436,21.1,0.1,1.8e-08,2.4e-05,40,152,52,162,29,176,0.87,112,110,147
OceanDNA-b31542,1510,13.4,0.1,2e-06,0.0035,119,144,9,34,4,47,0.87,25,25,43
OceanDNA-b11613,391,10.3,0.0,1.7e-05,0.014,152,184,343,375,319,384,0.87,32,32,65
OceanDNA-b14467,90,15.6,0.0,4.1e-07,0.0001,74,150,113,189,102,199,0.87,76,76,97
OceanDNA-b45437,549,8.7,0.1,5.2e-05,0.065,115,160,91,136,77,143,0.87,45,45,66
OceanDNA-b61,724,15.7,0.0,3.9e-07,0.00045,91,150,159,218,156,226,0.87,59,59,70
OceanDNA-b32692,259,-1.5,0.0,0.067,160.0,19,37,121,139,101,143,0.87,18,18,42
OceanDNA-b1738,534,9.7,0.0,2.6e-05,0.094,116,139,129,152,19,167,0.87,23,23,148
OceanDNA-b27597,1121,12.0,0.0,5.2e-06,0.0092,119,149,161,191,155,208,0.87,30,30,53
OceanDNA-b16778,1295,15.6,0.0,1.2e-06,0.00066,111,154,256,299,223,307,0.87,43,43,84
OceanDNA-b38093,297,17.2,0.0,1.4e-07,0.00012,163,229,143,211,135,219,0.87,66,68,84
OceanDNA-b39325,137,36.8,0.0,1.4e-13,3.8e-11,118,215,160,261,143,270,0.87,97,101,127
OceanDNA-b32974,2789,3.8,0.0,0.0034,5.2,125,154,138,167,119,172,0.87,29,29,53
OceanDNA-b16138,515,9.6,0.0,2.8e-05,0.022,49,108,270,323,259,398,0.87,59,53,139
OceanDNA-b26921,523,13.9,0.4,1.4e-06,0.0025,107,151,21,65,10,71,0.87,44,44,61
OceanDNA-b43875,440,14.9,0.2,7e-07,0.0004,119,150,114,145,108,153,0.87,31,31,45
OceanDNA-b47085,104,12.8,0.1,6.1e-06,0.0028,117,153,271,307,251,319,0.87,36,36,68
OceanDNA-b29503,212,14.5,0.1,9.4e-07,0.0038,119,142,146,169,136,209,0.87,23,23,73
OceanDNA-b36408,291,5.1,0.1,0.00066,1.5,162,187,280,305,240,314,0.87,25,25,74
OceanDNA-b8217,164,15.9,0.0,3.4e-07,8.3e-05,99,153,108,160,101,173,0.87,54,52,72
OceanDNA-b40853,487,129.1,0.0,9.9e-42,7.6e-39,34,242,69,293,59,305,0.87,208,224,246
OceanDNA-b19686,210,11.0,0.0,2.1e-05,0.0048,116,158,597,642,585,652,0.87,42,45,67
OceanDNA-b23400,399,6.6,0.0,0.00023,0.51,122,145,178,201,161,209,0.87,23,23,48
OceanDNA-b31716,2338,11.9,0.0,5.8e-06,0.014,120,146,171,197,165,209,0.87,26,26,44
OceanDNA-b28646,761,11.9,0.0,5.8e-06,0.0068,119,141,146,168,141,196,0.87,22,22,55
OceanDNA-b21040,1032,15.0,0.0,1.3e-06,0.003,111,162,395,447,372,453,0.87,51,52,81
OceanDNA-b6501,215,21.5,0.0,2e-08,3.5e-06,163,228,611,678,606,680,0.87,65,67,74
OceanDNA-b24680,406,11.6,0.0,6.9e-06,0.0059,41,83,44,88,31,96,0.87,42,44,65
OceanDNA-b16139,352,9.8,0.0,5e-05,0.02,96,145,307,355,231,361,0.87,49,48,130
OceanDNA-b13844,27,14.8,0.0,7.5e-07,0.00022,117,155,179,217,160,228,0.87,38,38,68
OceanDNA-b42824,223,-3.5,0.1,0.29,570.0,166,181,531,546,516,550,0.87,15,15,34
OceanDNA-b20991,1065,12.1,0.0,9.6e-06,0.0091,118,152,295,329,280,346,0.87,34,34,66
OceanDNA-b282,778,34.5,0.0,1.4e-12,1e-09,115,211,133,231,91,245,0.87,96,98,154
OceanDNA-b34610,361,14.9,0.0,1.4e-06,0.00092,163,229,432,500,420,503,0.87,66,68,83
OceanDNA-b15921,218,12.9,0.0,2.7e-06,0.00092,122,147,100,125,83,133,0.87,25,25,50
OceanDNA-b37094,887,19.8,0.0,2.2e-08,2.1e-05,163,229,646,714,610,717,0.87,66,68,107
OceanDNA-b40640,1386,15.7,0.0,3.9e-07,0.00057,119,145,150,176,133,192,0.87,26,26,59
OceanDNA-b9009,59,14.3,0.0,2.1e-06,0.00024,163,229,615,683,597,689,0.87,66,68,92
OceanDNA-b23813,1139,9.0,0.0,4.4e-05,0.064,41,82,64,106,56,118,0.87,41,42,62
OceanDNA-b32108,317,15.5,0.1,9e-07,0.0012,120,150,141,171,133,179,0.87,30,30,46
OceanDNA-b35111,5,11.0,0.0,1e-05,0.0054,122,147,142,167,123,215,0.87,25,25,92
OceanDNA-b4157,45,16.9,0.0,1.7e-07,6.6e-05,118,156,232,271,218,283,0.87,38,39,65
OceanDNA-b40685,345,192.2,0.1,1.1e-60,6.3e-58,10,239,26,270,22,280,0.87,229,244,258
OceanDNA-b17591,1464,14.1,0.0,1.2e-06,0.002,104,156,175,227,157,239,0.87,52,52,82
OceanDNA-b34924,841,13.6,0.0,3.3e-06,0.0017,121,147,173,199,156,228,0.87,26,26,72
OceanDNA-b13615,335,14.4,0.0,9.7e-07,0.00035,113,149,107,143,67,152,0.87,36,36,85
OceanDNA-b5857,282,10.4,0.0,1.7e-05,0.0072,151,185,270,304,262,313,0.87,34,34,51
OceanDNA-b15876,464,10.1,0.0,4.1e-05,0.027,116,151,168,203,156,210,0.87,35,35,54
OceanDNA-b46252,2090,1.1,0.0,0.043,25.0,145,164,124,143,102,147,0.87,19,19,45
OceanDNA-b26660,3743,12.0,0.0,5.2e-06,0.02,118,186,171,242,113,253,0.87,68,71,140
OceanDNA-b34938,785,18.0,0.0,1.6e-07,9.6e-05,163,227,629,695,617,699,0.87,64,66,82
OceanDNA-b42824,223,13.0,0.0,2.6e-06,0.005,118,153,231,267,215,274,0.87,35,36,59
OceanDNA-b41272,1357,2.8,0.0,0.0033,7.6,125,150,113,138,95,171,0.87,25,25,76
OceanDNA-b6345,278,129.9,0.0,5.7e-42,1.6e-39,36,245,65,285,37,297,0.87,209,220,260
OceanDNA-b23484,1131,10.3,0.0,3.5e-05,0.03,119,145,143,169,135,182,0.87,26,26,47
OceanDNA-b44627,813,12.7,0.0,9.7e-06,0.0029,114,148,154,188,142,234,0.87,34,34,92
OceanDNA-b22498,2720,8.5,0.0,0.00012,0.19,115,161,229,275,215,281,0.87,46,46,66
OceanDNA-b6846,218,18.8,0.0,4.4e-08,2.6e-05,151,228,268,340,251,340,0.87,77,72,89
OceanDNA-b40617,14,16.1,0.0,5.8e-07,0.00012,119,146,147,174,133,193,0.87,27,27,60
OceanDNA-b33284,2828,13.1,0.0,2.4e-06,0.012,120,144,155,179,138,196,0.87,24,24,58
OceanDNA-b13263,277,-3.9,0.0,1.1,370.0,6,22,535,551,534,554,0.87,16,16,20
OceanDNA-b7003,11,125.3,0.0,1.4e-40,6.2e-38,20,240,54,282,43,289,0.87,220,228,246
OceanDNA-b31152,642,15.1,0.0,1.2e-06,0.00048,116,161,244,290,237,294,0.87,45,46,57
OceanDNA-b46124,102,12.3,0.0,4.2e-06,0.0012,116,161,138,183,126,217,0.87,45,45,91
OceanDNA-b38880,867,13.9,0.0,2.8e-06,0.0013,123,153,107,137,74,146,0.87,30,30,72
OceanDNA-b21004,1525,17.4,0.0,3.5e-07,0.00023,144,226,186,264,179,267,0.87,82,78,88
OceanDNA-b38938,372,13.8,0.2,1.5e-06,0.0011,123,150,148,175,144,183,0.87,27,27,39
OceanDNA-b32271,1556,15.8,0.0,3.7e-07,0.00066,120,146,145,171,135,184,0.87,26,26,49
OceanDNA-b30051,355,14.7,0.0,8.2e-07,0.0019,116,144,167,195,145,213,0.87,28,28,68
OceanDNA-b30408,1806,10.8,0.0,2.4e-05,0.028,18,75,400,461,394,465,0.87,57,61,71
OceanDNA-b24625,397,11.6,0.0,1.4e-05,0.0037,119,150,139,170,122,180,0.87,31,31,58
OceanDNA-b32,392,6.6,0.0,0.00048,0.15,115,153,226,264,214,279,0.87,38,38,65
OceanDNA-b13229,111,15.3,0.0,5.3e-07,0.00035,104,148,126,170,115,180,0.87,44,44,65
OceanDNA-b8547,29,10.6,0.0,1.4e-05,0.0031,163,229,601,669,596,671,0.87,66,68,75
OceanDNA-b31131,342,18.2,0.0,1.4e-07,4.5e-05,118,146,139,167,122,178,0.87,28,28,56
OceanDNA-b262,3012,18.4,0.0,5.7e-08,0.00021,113,152,170,211,149,282,0.87,39,41,133
OceanDNA-b2508,837,3.4,0.0,0.0022,2.3,164,212,410,458,404,483,0.87,48,48,79
OceanDNA-b11661,726,12.3,0.0,4.2e-06,0.0043,151,185,333,367,322,376,0.87,34,34,54
OceanDNA-b28166,2674,4.0,0.0,0.0015,4.1,125,151,140,166,115,175,0.87,26,26,60
OceanDNA-b38062,924,20.9,0.0,1e-08,9.5e-06,163,229,177,245,142,252,0.87,66,68,110
OceanDNA-b37442,373,21.4,0.0,7.1e-09,7e-06,89,156,204,273,199,281,0.87,67,69,82
OceanDNA-b17223,289,10.6,0.0,4.3e-05,0.039,121,163,263,305,253,312,0.87,42,42,59
OceanDNA-b9010,182,11.6,0.0,6.9e-06,0.0017,163,229,189,257,176,263,0.87,66,68,87
OceanDNA-b34288,84,13.8,0.0,3e-06,0.0019,123,149,155,181,134,205,0.87,26,26,71
OceanDNA-b29385,284,9.3,0.1,0.00011,0.12,47,142,93,190,88,215,0.87,95,97,127
OceanDNA-b46648,1274,12.5,0.0,3.8e-06,0.0092,103,157,357,409,350,423,0.87,54,52,73
OceanDNA-b496,923,12.7,0.0,6.6e-06,0.0086,119,148,105,134,94,142,0.87,29,29,48
OceanDNA-b18473,63,18.8,0.0,4.5e-08,2.1e-05,107,156,304,353,278,361,0.87,49,49,83
OceanDNA-b44609,332,7.5,0.0,0.00012,0.23,119,146,546,573,529,582,0.87,27,27,53
OceanDNA-b12867,392,16.5,0.0,2.2e-07,9.2e-05,157,221,63,127,48,137,0.87,64,64,89
OceanDNA-b44464,77,15.3,0.0,5.1e-07,0.00018,119,150,140,171,124,185,0.87,31,31,61
OceanDNA-b37742,52,21.9,0.0,5e-09,4e-06,118,149,120,151,102,160,0.87,31,31,58
OceanDNA-b17034,171,15.3,0.0,1e-06,0.00048,118,187,175,244,155,270,0.87,69,69,115
OceanDNA-b20491,67,14.7,0.0,1.5e-06,0.00026,106,157,228,280,210,299,0.87,51,52,89
OceanDNA-b34653,194,4.3,0.0,0.0011,0.89,162,222,571,631,557,640,0.87,60,60,83
OceanDNA-b9808,317,20.4,0.0,4.2e-08,8e-06,98,147,95,143,83,158,0.87,49,48,75
OceanDNA-b20491,67,4.4,0.1,0.0021,0.36,45,86,134,175,121,196,0.87,41,41,75
OceanDNA-b31685,2065,10.8,0.0,1.3e-05,0.029,24,85,67,128,48,141,0.86,61,61,93
OceanDNA-b46224,597,12.1,0.0,9.6e-06,0.0049,108,158,199,247,187,252,0.86,50,48,65
OceanDNA-b40442,1416,11.9,0.0,5.5e-06,0.011,123,146,147,170,135,185,0.86,23,23,50
OceanDNA-b44662,2521,9.7,0.0,5.4e-05,0.073,117,143,116,142,104,165,0.86,26,26,61
OceanDNA-b3599,397,16.7,0.0,3.9e-07,0.00015,112,154,152,195,135,228,0.86,42,43,93
OceanDNA-b46298,2456,11.1,0.0,1.9e-05,0.046,106,168,211,274,203,279,0.86,62,63,76
OceanDNA-b10018,226,-1.9,0.1,0.09,64.0,214,255,337,378,330,381,0.86,41,41,51
OceanDNA-b6205,629,11.6,0.0,6.8e-06,0.0048,76,109,45,78,37,90,0.86,33,33,53
OceanDNA-b46309,65,18.9,0.0,4.2e-08,9.7e-05,106,156,224,272,216,278,0.86,50,48,62
OceanDNA-b10027,423,10.6,0.0,1.4e-05,0.0076,164,231,192,257,184,265,0.86,67,65,81
OceanDNA-b24743,76,11.8,0.0,6.1e-06,0.0047,119,146,156,183,146,195,0.86,27,27,49
OceanDNA-b22995,1823,13.2,0.0,6.7e-06,0.0047,105,157,292,342,283,354,0.86,52,50,71
OceanDNA-b16123,12,9.6,0.0,5.7e-05,0.021,118,150,141,173,124,191,0.86,32,32,67
OceanDNA-b17563,890,12.1,0.0,9.6e-06,0.011,163,228,635,702,622,705,0.86,65,67,83
OceanDNA-b13570,213,12.0,0.1,1e-05,0.0068,115,152,134,171,95,180,0.86,37,37,85
OceanDNA-b23271,540,16.6,0.0,4e-07,0.00051,70,141,88,159,69,175,0.86,71,71,106
OceanDNA-b23643,1966,-2.4,0.0,0.26,320.0,72,85,30,43,27,53,0.86,13,13,26
OceanDNA-b23643,1966,11.5,0.0,1.6e-05,0.019,78,150,67,133,43,141,0.86,72,66,98
OceanDNA-b32753,11,10.3,0.0,1.8e-05,0.0085,116,156,214,254,204,270,0.86,40,40,66
OceanDNA-b35916,559,11.1,0.0,2e-05,0.025,113,147,120,154,108,162,0.86,34,34,54
OceanDNA-b10094,20,114.7,0.1,2.5e-37,1.2e-34,20,240,39,267,26,273,0.86,220,228,247
OceanDNA-b40473,146,10.8,0.0,2.4e-05,0.013,120,144,148,172,131,188,0.86,24,24,57
OceanDNA-b33394,1170,14.2,0.0,2.3e-06,0.0031,120,147,68,95,62,107,0.86,27,27,45
OceanDNA-b4111,10,13.7,0.0,1.6e-06,0.0011,100,161,104,166,98,171,0.86,61,62,73
OceanDNA-b4149,154,13.0,0.0,2.6e-06,0.0032,162,225,465,530,458,542,0.86,63,65,84
OceanDNA-a3040,26,-3.9,0.0,0.37,280.0,161,176,260,275,258,276,0.86,15,15,18
OceanDNA-b36649,521,21.8,0.0,5.4e-09,4.4e-06,118,155,260,298,241,369,0.86,37,38,128
OceanDNA-b23463,1474,11.3,0.0,8.7e-06,0.017,124,150,40,66,32,74,0.86,26,26,42
OceanDNA-b45848,879,17.9,0.0,8.3e-08,0.00016,110,168,182,242,174,253,0.86,58,60,79
OceanDNA-b30206,2000,10.8,0.1,2.4e-05,0.027,163,230,213,278,206,283,0.86,67,65,77
OceanDNA-b11732,492,15.5,0.0,4.4e-07,0.00045,151,189,298,336,286,342,0.86,38,38,56
OceanDNA-b5007,104,96.7,0.0,7.8e-32,2.1e-29,19,244,33,268,20,277,0.86,225,235,257
OceanDNA-b27622,294,-2.0,0.0,0.096,74.0,93,121,209,236,201,241,0.86,28,27,40
OceanDNA-b22654,701,17.4,0.0,6.2e-07,0.00015,115,146,249,280,238,288,0.86,31,31,50
OceanDNA-b2668,146,12.1,0.0,4.8e-06,0.0019,119,154,12,47,2,55,0.86,35,35,53
OceanDNA-b3594,247,7.2,0.0,0.00016,0.17,202,237,299,335,291,344,0.86,35,36,53
OceanDNA-b46812,1546,12.4,0.0,1.6e-05,0.0095,72,140,83,151,72,158,0.86,68,68,86
OceanDNA-b35155,386,13.9,0.0,1.4e-06,0.0021,121,141,144,164,126,179,0.86,20,20,53
OceanDNA-b24046,1227,11.7,0.0,6.4e-06,0.016,119,161,2,44,1,61,0.86,42,42,60
OceanDNA-b22830,3137,13.2,0.0,4.5e-06,0.01,111,148,233,270,214,284,0.86,37,37,70
OceanDNA-b3152,792,13.4,0.0,2e-06,0.0029,53,83,51,81,28,112,0.86,30,30,84
OceanDNA-b40613,659,133.1,0.1,1.9e-42,4.8e-40,33,239,94,316,84,330,0.86,206,222,246
OceanDNA-b26571,13,23.5,0.0,3.4e-09,1.3e-06,117,149,147,179,131,196,0.86,32,32,65
OceanDNA-b28563,1394,12.0,0.0,5.5e-06,0.011,118,140,143,165,130,189,0.86,22,22,59
OceanDNA-b26155,41,21.0,0.0,9.7e-09,4.9e-06,51,147,67,167,59,181,0.86,96,100,122
OceanDNA-b33515,675,0.2,0.1,0.02,30.0,127,164,66,101,64,115,0.86,37,35,51
OceanDNA-b37442,373,2.4,0.0,0.0043,4.3,54,86,138,170,127,176,0.86,32,32,49
OceanDNA-b20510,60,17.1,0.0,1.5e-07,5e-05,89,155,210,278,201,294,0.86,66,68,93
OceanDNA-b30757,244,11.6,0.0,6.8e-06,0.0027,118,149,167,198,156,205,0.86,31,31,49
OceanDNA-b19403,295,8.7,0.0,5.5e-05,0.017,49,86,191,228,178,242,0.86,37,37,64
OceanDNA-b40635,555,135.8,0.1,9.3e-44,5.6e-41,32,237,79,300,66,310,0.86,205,221,244
OceanDNA-b10034,204,12.3,0.0,8.5e-06,0.002,99,154,105,158,28,168,0.86,55,53,140
OceanDNA-b23049,1569,10.6,0.0,1.4e-05,0.033,162,226,195,255,188,258,0.86,64,60,70
OceanDNA-b1836,2872,7.2,0.1,0.00016,0.53,123,149,185,211,138,218,0.86,26,26,80
OceanDNA-b32861,681,16.2,0.0,5.5e-07,0.00035,87,158,112,186,96,195,0.86,71,74,99
OceanDNA-b35069,310,17.2,0.0,4.2e-07,0.00013,163,229,620,688,582,690,0.86,66,68,108
OceanDNA-b47087,581,15.6,0.0,8.3e-07,0.0011,107,149,65,107,57,124,0.86,42,42,67
OceanDNA-b40018,534,18.0,0.0,7.8e-08,4.3e-05,118,145,138,165,109,192,0.86,27,27,83
OceanDNA-b22521,2208,12.3,0.0,4.1e-06,0.01,117,149,268,300,254,317,0.86,32,32,63
OceanDNA-b34949,288,12.0,0.0,1.6e-05,0.0053,163,226,608,669,596,677,0.86,63,61,81
OceanDNA-b37918,626,13.1,0.0,4.9e-06,0.0019,119,145,32,58,27,71,0.86,26,26,44
OceanDNA-b37918,608,12.0,0.0,1e-05,0.0039,163,232,222,293,211,299,0.86,69,71,88
OceanDNA-b3645,564,15.9,0.0,3.4e-07,0.0003,151,185,279,311,270,347,0.86,34,32,77
OceanDNA-b22513,1918,9.4,0.0,6.8e-05,0.096,115,156,222,263,208,270,0.86,41,41,62
OceanDNA-b34939,348,11.6,0.0,7.1e-06,0.0062,163,227,630,696,620,699,0.86,64,66,79
OceanDNA-b31521,15,16.3,0.0,5e-07,0.00052,163,229,674,742,647,743,0.86,66,68,96
OceanDNA-b30215,1413,4.1,0.0,0.0042,2.6,17,52,78,113,73,125,0.86,35,35,52
OceanDNA-b40641,953,134.1,0.2,1.2e-42,3.9e-40,32,252,113,349,102,354,0.86,220,236,252
OceanDNA-b44480,233,16.9,0.0,1.6e-07,5.6e-05,118,150,171,203,149,214,0.86,32,32,65
OceanDNA-b27542,1053,10.9,0.0,3.4e-05,0.025,118,141,146,169,138,186,0.86,23,23,48
OceanDNA-b45659,148,12.4,0.0,3.9e-06,0.0013,117,154,229,266,197,288,0.86,37,37,91
OceanDNA-b44448,147,11.7,0.0,6.6e-06,0.0017,119,150,151,182,143,191,0.86,31,31,48
OceanDNA-b36658,307,14.8,0.0,1.5e-06,0.00066,123,145,57,79,44,90,0.86,22,22,46
OceanDNA-b2796,1858,-1.2,0.0,0.11,120.0,163,182,332,351,322,360,0.86,19,19,38
OceanDNA-b39367,257,15.1,0.0,5.9e-07,0.00044,119,145,148,174,119,190,0.86,26,26,71
OceanDNA-b8077,136,14.5,0.0,9.4e-07,0.00019,100,152,100,150,71,160,0.86,52,50,89
OceanDNA-b37535,1422,12.1,0.0,1e-05,0.0091,102,145,19,61,11,79,0.86,43,42,68
OceanDNA-b22840,3847,11.1,0.0,2e-05,0.042,114,157,235,278,218,286,0.86,43,43,68
OceanDNA-b517,1813,-2.5,0.0,0.14,560.0,243,260,288,305,284,305,0.86,17,17,21
OceanDNA-b29496,1108,13.0,0.1,5.4e-06,0.007,122,147,149,174,105,209,0.86,25,25,104
OceanDNA-b4608,21,16.4,0.0,4.8e-07,0.00012,162,234,188,260,177,272,0.86,72,72,95
OceanDNA-b9927,6,13.4,0.1,1.9e-06,0.00069,105,155,110,158,26,165,0.86,50,48,139
OceanDNA-b46206,314,10.9,0.0,1.2e-05,0.014,123,152,108,137,81,142,0.86,29,29,61
OceanDNA-b20094,183,11.8,0.0,1.8e-05,0.0023,116,161,262,311,235,319,0.86,45,49,84
OceanDNA-b7191,212,12.6,0.0,3.6e-06,0.0016,98,146,101,148,87,158,0.86,48,47,71
OceanDNA-b12579,234,10.7,0.0,1.3e-05,0.0049,119,150,114,145,108,156,0.86,31,31,48
OceanDNA-b4007,753,11.2,0.0,9.6e-06,0.0099,160,231,196,265,186,285,0.86,71,69,99
OceanDNA-b36646,1282,0.1,0.0,0.023,47.0,162,185,248,271,229,280,0.86,23,23,51
OceanDNA-b7450,995,2.5,0.0,0.0086,5.6,216,250,369,403,357,414,0.86,34,34,57
OceanDNA-b30722,230,11.5,0.0,7.3e-06,0.0068,119,142,144,167,138,190,0.86,23,23,52
OceanDNA-b30678,1209,11.2,0.0,9.3e-06,0.013,119,141,148,170,143,194,0.86,22,22,51
OceanDNA-b31270,447,13.8,0.1,2.9e-06,0.0034,122,145,167,190,162,203,0.86,23,23,41
OceanDNA-b8399,69,16.8,0.0,1.8e-07,4.7e-05,105,154,128,178,123,185,0.86,49,50,62
OceanDNA-b260,485,9.0,0.1,8.6e-05,0.14,21,85,44,110,29,115,0.86,64,66,86
OceanDNA-b41604,183,10.7,0.1,1.3e-05,0.014,121,145,79,103,45,161,0.86,24,24,116
OceanDNA-b41301,4206,14.4,0.0,2e-06,0.0048,151,214,231,292,218,304,0.86,63,61,86
OceanDNA-b46308,465,11.7,0.0,1.3e-05,0.013,106,157,233,282,225,293,0.86,51,49,68
OceanDNA-b16280,24,3.4,0.0,0.0022,0.6,54,85,236,267,225,277,0.86,31,31,52
OceanDNA-b34663,386,12.2,0.0,1.4e-05,0.0039,163,212,568,617,558,633,0.86,49,49,75
OceanDNA-b35250,67,6.6,0.0,0.00024,0.16,119,152,506,540,491,549,0.86,33,34,58
OceanDNA-b30408,365,4.1,0.0,0.0027,3.1,119,153,188,222,176,244,0.86,34,34,68
OceanDNA-b13457,695,13.0,0.0,2.5e-06,0.0018,107,162,21,77,9,83,0.86,55,56,74
OceanDNA-b5610,599,14.5,0.0,9.4e-07,0.00076,198,233,12,48,2,59,0.86,35,36,57
OceanDNA-b33299,3441,12.9,0.1,2.7e-06,0.011,119,143,453,477,446,492,0.86,24,24,46
OceanDNA-b16039,280,5.9,0.0,0.00037,0.45,42,82,275,316,251,341,0.86,40,41,90
OceanDNA-b4197,39,19.8,0.0,2.2e-08,1.4e-05,118,161,225,269,212,299,0.86,43,44,87
OceanDNA-b23549,463,11.5,0.0,2.2e-05,0.014,163,229,620,688,613,694,0.86,66,68,81
OceanDNA-b31271,856,14.7,0.0,7.9e-07,0.0019,122,146,169,193,163,205,0.86,24,24,42
OceanDNA-b37266,1047,12.5,0.0,3.7e-06,0.013,163,230,622,691,615,695,0.86,67,69,80
OceanDNA-b16141,638,4.0,0.0,0.0014,1.1,49,87,55,93,48,103,0.86,38,38,55
OceanDNA-b37593,2183,12.0,0.0,5.3e-06,0.014,40,86,70,116,61,123,0.86,46,46,62
OceanDNA-a5075,29,13.6,0.0,1.8e-06,0.00068,118,157,273,313,260,321,0.86,39,40,61
OceanDNA-b40885,211,13.9,0.0,1.4e-06,0.0009,163,229,648,716,638,720,0.86,66,68,82
OceanDNA-b498,308,6.6,0.0,0.00024,0.67,126,152,180,206,150,211,0.86,26,26,61
OceanDNA-b22943,1409,11.2,0.0,1.9e-05,0.035,163,222,167,226,162,234,0.86,59,59,72
OceanDNA-b4487,412,10.3,0.0,3.4e-05,0.027,117,147,304,334,293,341,0.86,30,30,48
OceanDNA-b6917,61,11.1,0.0,1e-05,0.0027,163,228,621,688,607,691,0.86,65,67,84
OceanDNA-b34471,261,17.9,0.0,8.1e-08,7.2e-05,163,232,664,735,648,739,0.86,69,71,91
OceanDNA-b20370,55,10.1,0.0,2e-05,0.0076,118,161,602,649,594,656,0.86,43,47,62
OceanDNA-b31687,6,10.3,0.0,1.7e-05,0.047,152,229,258,333,245,340,0.86,77,75,95
OceanDNA-b21002,2996,5.5,0.1,0.001,2.8,163,210,353,398,328,409,0.86,47,45,81
OceanDNA-b23229,1147,11.0,0.1,2.1e-05,0.015,115,146,41,72,12,81,0.86,31,31,69
OceanDNA-b23382,1938,10.3,0.0,1.8e-05,0.04,126,148,190,212,182,224,0.86,22,22,42
OceanDNA-b12521,140,127.0,0.0,4.3e-41,1.1e-38,25,248,52,287,36,297,0.86,223,235,261
OceanDNA-b9951,224,123.6,0.1,4.7e-40,1.9e-37,20,241,44,273,31,288,0.86,221,229,257
OceanDNA-b17611,2958,11.3,0.0,1.7e-05,0.028,116,161,111,157,54,165,0.86,45,46,111
OceanDNA-b20995,1577,10.6,0.1,2.9e-05,0.075,113,150,54,91,39,96,0.86,37,37,57
OceanDNA-b22882,788,11.2,0.0,9.2e-06,0.038,115,160,228,273,212,279,0.86,45,45,67
OceanDNA-b47086,269,2.0,0.0,0.018,26.0,71,88,209,226,197,242,0.86,17,17,45
OceanDNA-b16224,1390,-3.8,0.0,0.34,520.0,160,181,433,454,426,460,0.86,21,21,34
OceanDNA-b10365,327,12.6,0.0,6.9e-06,0.0024,123,200,146,225,128,233,0.86,77,79,105
OceanDNA-b32030,969,13.8,0.5,1.5e-06,0.0027,15,73,94,155,85,184,0.86,58,61,99
OceanDNA-b27826,351,12.3,0.0,4.4e-06,0.0019,123,148,82,107,53,126,0.86,25,25,73
OceanDNA-b23055,698,15.1,0.0,1.2e-06,0.00045,100,158,37,93,32,114,0.86,58,56,82
OceanDNA-b34266,2223,14.1,0.0,1.2e-06,0.0033,66,101,224,259,203,269,0.86,35,35,66
OceanDNA-b37349,143,0.8,0.0,0.014,8.9,54,86,141,173,131,178,0.86,32,32,47
OceanDNA-b46594,693,-4.3,0.0,0.51,780.0,6,22,603,619,600,622,0.86,16,16,22
OceanDNA-b36703,499,10.5,0.0,1.5e-05,0.015,122,145,152,175,127,188,0.86,23,23,61
OceanDNA-b466,148,9.8,0.0,7.5e-05,0.073,119,147,144,172,132,181,0.86,28,28,49
OceanDNA-b22322,2331,18.1,0.0,1.5e-07,0.00028,97,151,221,276,215,283,0.86,54,55,68
OceanDNA-b46917,568,12.8,0.1,6e-06,0.0051,116,153,246,283,223,295,0.86,37,37,72
OceanDNA-b23379,1414,10.9,0.0,2.3e-05,0.026,122,147,267,292,251,299,0.86,25,25,48
OceanDNA-b33317,1303,2.6,0.0,0.0038,10.0,163,194,240,270,235,279,0.86,31,30,44
OceanDNA-b22507,1506,0.4,0.0,0.036,53.0,51,87,189,225,170,231,0.86,36,36,61
OceanDNA-b4683,266,113.6,0.0,5.3e-37,2.6e-34,35,240,55,266,27,273,0.86,205,211,246
OceanDNA-b3982,579,19.3,0.0,6.3e-08,1.9e-05,105,150,133,178,106,190,0.86,45,45,84
OceanDNA-b22226,1447,10.8,0.0,2.5e-05,0.021,117,150,173,206,156,300,0.86,33,33,144
OceanDNA-b35165,250,16.1,0.0,3e-07,0.00016,163,231,596,666,586,668,0.86,68,70,82
OceanDNA-b16127,236,4.5,0.0,0.002,0.64,42,84,31,74,26,81,0.86,42,43,55
OceanDNA-b11706,669,11.0,0.0,1.1e-05,0.0099,151,184,217,250,206,258,0.86,33,33,52
OceanDNA-b6506,167,10.9,0.0,1.2e-05,0.0067,124,150,112,138,24,151,0.86,26,26,127
OceanDNA-b20668,73,16.3,0.0,5.2e-07,7e-05,110,157,225,272,201,276,0.86,47,47,75
OceanDNA-b29530,932,-0.4,0.0,0.031,100.0,162,183,236,257,225,265,0.86,21,21,40
OceanDNA-b20922,6387,12.4,0.0,1.2e-05,0.028,100,150,157,207,146,224,0.86,50,50,78
OceanDNA-b35796,702,1.9,0.0,0.0063,6.4,163,182,254,273,241,278,0.86,19,19,37
OceanDNA-b30006,1262,13.8,0.0,1.5e-06,0.0054,120,147,351,378,342,395,0.86,27,27,53
OceanDNA-b12541,171,133.2,0.0,5.7e-43,1.9e-40,19,249,40,285,29,297,0.86,230,245,268
OceanDNA-b11624,517,12.1,0.0,5.1e-06,0.0052,151,186,294,329,283,334,0.86,35,35,51
OceanDNA-b31535,300,13.9,0.1,2.8e-06,0.0039,120,144,161,185,153,200,0.86,24,24,47
OceanDNA-b17623,2903,11.5,0.0,1.5e-05,0.022,118,146,272,300,260,308,0.86,28,28,48
OceanDNA-b22801,867,9.9,0.0,4.7e-05,0.059,114,157,289,332,269,340,0.86,43,43,71
OceanDNA-b26627,2594,11.5,0.0,7.4e-06,0.028,112,147,388,423,353,429,0.86,35,35,76
OceanDNA-b23187,394,10.6,0.0,1.4e-05,0.016,114,150,32,68,21,74,0.86,36,36,53
OceanDNA-b25306,13,10.0,0.0,2.2e-05,0.0049,118,150,87,119,65,126,0.86,32,32,61
OceanDNA-b32156,2476,11.3,0.0,8.6e-06,0.024,119,145,152,178,135,191,0.86,26,26,56
OceanDNA-b2939,88,16.4,0.0,2.4e-07,6.9e-05,51,152,36,134,20,140,0.86,101,98,120
OceanDNA-b30703,272,12.5,0.1,3.7e-06,0.0065,119,145,144,170,140,188,0.86,26,26,48
OceanDNA-b8408,166,9.7,0.0,2.6e-05,0.0054,163,228,601,668,596,671,0.86,65,67,75
OceanDNA-b22421,360,13.2,0.0,2.3e-06,0.0084,99,140,156,194,137,215,0.86,41,38,78
OceanDNA-b35278,403,4.3,0.0,0.0023,0.92,120,152,513,546,503,556,0.86,32,33,53
OceanDNA-b13621,87,14.4,0.0,2.9e-06,0.00029,115,148,128,161,116,173,0.86,33,33,57
OceanDNA-b33096,1031,3.2,0.0,0.0079,3.4,117,152,75,110,16,116,0.85,35,35,100
OceanDNA-b13482,93,11.6,0.0,7.2e-06,0.0018,106,162,125,182,113,189,0.85,56,57,76
OceanDNA-b20043,202,92.3,0.0,3.3e-30,5.5e-28,17,245,223,463,212,473,0.85,228,240,261
OceanDNA-b20915,804,10.8,0.0,1.3e-05,0.01,122,143,113,134,100,146,0.85,21,21,46
OceanDNA-b15188,166,10.7,0.0,1.3e-05,0.0028,117,148,89,120,78,127,0.85,31,31,49
OceanDNA-b10398,161,13.5,0.0,1.8e-06,0.00045,162,229,166,235,154,237,0.85,67,69,83
OceanDNA-b3910,170,10.8,0.0,1.2e-05,0.012,99,154,128,183,118,194,0.85,55,55,76
OceanDNA-b30570,249,17.2,0.0,1.3e-07,0.00037,118,144,188,214,177,240,0.85,26,26,63
OceanDNA-b28203,1009,12.1,0.1,4.8e-06,0.014,119,146,133,160,100,171,0.85,27,27,71
OceanDNA-b15909,99,15.0,0.0,6.4e-07,0.00023,26,153,6,129,3,133,0.85,127,123,130
OceanDNA-b40594,236,133.3,0.0,5.3e-43,2e-40,36,246,80,306,70,313,0.85,210,226,243
OceanDNA-b20782,423,18.7,0.0,4.7e-08,4.6e-05,119,157,251,289,215,300,0.85,38,38,85
OceanDNA-b23327,1031,-1.9,0.0,0.091,140.0,88,105,247,264,240,264,0.85,17,17,24
OceanDNA-b46188,73,7.7,0.0,0.00011,0.089,115,159,90,134,75,141,0.85,44,44,66
OceanDNA-b33525,417,7.1,0.0,0.00017,0.64,125,148,222,245,171,254,0.85,23,23,83
OceanDNA-b26845,3023,12.5,0.0,3.7e-06,0.012,119,144,148,173,126,185,0.85,25,25,59
OceanDNA-b46188,73,4.3,0.0,0.0012,0.95,162,227,178,240,169,243,0.85,65,62,74
OceanDNA-b22478,1038,1.3,0.0,0.019,23.0,70,88,75,93,57,102,0.85,18,18,45
OceanDNA-b6769,267,10.7,0.0,1.4e-05,0.0058,151,181,278,308,268,356,0.85,30,30,88
OceanDNA-b22650,1489,6.7,0.1,0.00044,0.52,118,143,22,47,7,66,0.85,25,25,59
OceanDNA-b41695,55,14.8,0.0,1.5e-06,0.00013,110,155,93,140,47,175,0.85,45,47,128
OceanDNA-b27579,40,5.7,0.1,0.0009,1.3,118,152,117,151,86,172,0.85,34,34,86
OceanDNA-b34288,969,21.8,0.0,1.1e-08,7e-06,162,230,619,689,601,697,0.85,68,70,96
OceanDNA-b46921,2201,22.8,0.0,5.3e-09,6.3e-06,85,154,156,224,142,253,0.85,69,68,111
OceanDNA-b46684,332,-2.9,0.0,0.18,140.0,202,235,490,523,477,528,0.85,33,33,51
OceanDNA-b22239,1889,13.4,0.1,1.9e-06,0.0043,117,154,155,192,108,200,0.85,37,37,92
OceanDNA-b27445,13,15.9,0.0,3.4e-07,7.5e-05,116,162,216,259,205,276,0.85,46,43,71
OceanDNA-b40617,78,12.0,0.0,1e-05,0.0022,59,146,28,109,13,123,0.85,87,81,110
OceanDNA-b23634,1957,20.9,0.0,3e-08,2.4e-05,98,156,132,187,69,212,0.85,58,55,143
OceanDNA-b37977,501,17.4,0.1,1.2e-07,0.0001,103,163,125,184,117,187,0.85,60,59,70
OceanDNA-b11244,330,14.8,0.0,7.2e-07,0.00024,118,157,203,243,191,288,0.85,39,40,97
OceanDNA-b22548,1091,10.2,0.0,5.8e-05,0.025,115,157,216,258,202,268,0.85,42,42,66
OceanDNA-b29496,1411,15.1,0.0,1.2e-06,0.0016,119,145,139,165,131,213,0.85,26,26,82
OceanDNA-b26387,1475,11.1,0.0,9.8e-06,0.015,17,80,290,357,284,360,0.85,63,67,76
OceanDNA-b36666,772,10.8,0.0,2.5e-05,0.015,123,150,162,189,155,205,0.85,27,27,50
OceanDNA-b15831,1481,10.3,0.0,1.8e-05,0.031,116,151,166,203,155,211,0.85,35,37,56
OceanDNA-b46520,903,12.3,0.0,4.1e-06,0.0078,92,156,111,174,70,182,0.85,64,63,112
OceanDNA-b35946,297,11.7,0.0,6.7e-06,0.003,121,145,142,166,121,184,0.85,24,24,63
OceanDNA-b32285,973,11.2,0.0,9.1e-06,0.0091,122,146,149,173,141,188,0.85,24,24,47
OceanDNA-b42068,240,12.4,0.0,4e-06,0.0012,118,179,145,208,125,254,0.85,61,63,129
OceanDNA-b19626,358,1.7,0.0,0.015,3.6,186,244,255,313,229,314,0.85,58,58,85
OceanDNA-b19697,279,-1.0,0.0,0.05,17.0,51,85,202,236,193,242,0.85,34,34,49
OceanDNA-b23817,867,10.9,0.0,2.3e-05,0.018,120,148,192,220,173,237,0.85,28,28,64
OceanDNA-b45508,965,1.7,0.0,0.0073,8.3,70,88,64,82,20,87,0.85,18,18,67
OceanDNA-b60,1272,1.5,0.0,0.0086,11.0,198,231,237,271,231,277,0.85,33,34,46
OceanDNA-b17579,139,15.7,0.0,3.8e-07,0.0012,104,156,157,209,142,220,0.85,52,52,78
OceanDNA-b44,1285,19.2,0.0,6.7e-08,0.00025,163,231,632,702,627,705,0.85,68,70,78
OceanDNA-b28718,16,13.9,0.1,1.4e-06,0.00068,118,140,148,170,136,188,0.85,22,22,52
OceanDNA-b11787,224,39.5,0.0,2.2e-14,1.4e-11,41,209,138,312,128,328,0.85,168,174,200
OceanDNA-b7477,141,11.0,0.0,2.1e-05,0.0067,197,231,104,139,78,164,0.85,34,35,86
OceanDNA-b36730,3243,13.9,0.0,2.8e-06,0.0046,163,229,190,258,183,265,0.85,66,68,82
OceanDNA-b47086,2846,11.4,0.0,2.4e-05,0.034,115,155,103,143,87,161,0.85,40,40,74
OceanDNA-b37704,397,11.9,0.0,5.7e-06,0.0034,117,144,171,198,146,211,0.85,27,27,65
OceanDNA-b17743,2586,10.0,0.0,2.2e-05,0.082,104,157,157,210,146,220,0.85,53,53,74
OceanDNA-b40232,2108,193.4,0.0,7.5e-61,5.8e-58,20,241,121,358,109,371,0.85,221,237,262
OceanDNA-b23549,1740,8.0,0.0,0.00026,0.17,162,228,188,255,182,258,0.85,66,67,76
OceanDNA-b37652,816,15.0,0.0,6.4e-07,0.00081,119,145,174,200,153,220,0.85,26,26,67
OceanDNA-b14155,50,11.2,0.1,9.1e-06,0.0036,128,192,397,460,382,468,0.85,64,63,86
OceanDNA-b23043,1917,10.8,0.1,2.5e-05,0.048,117,152,66,101,41,105,0.85,35,35,64
OceanDNA-b16140,391,0.7,0.0,0.029,13.0,50,85,119,154,111,160,0.85,35,35,49
OceanDNA-b32,528,-0.1,0.0,0.053,16.0,162,181,263,282,256,293,0.85,19,19,37
OceanDNA-b37960,533,5.3,0.0,0.00057,0.32,117,145,170,199,151,212,0.85,28,29,61
OceanDNA-b35035,536,10.5,0.0,3e-05,0.012,163,226,607,668,596,676,0.85,63,61,80
OceanDNA-b15777,892,11.6,0.0,2e-05,0.012,160,208,197,243,182,249,0.85,48,46,67
OceanDNA-b40713,137,11.6,0.0,1.4e-05,0.0057,117,146,263,292,252,300,0.85,29,29,48
OceanDNA-b34384,302,11.5,0.0,1.5e-05,0.0062,117,147,81,111,29,158,0.85,30,30,129
OceanDNA-b16135,34,14.0,0.0,2.5e-06,0.0012,120,145,147,172,139,193,0.85,25,25,54
OceanDNA-b18420,192,10.5,0.0,1.5e-05,0.0069,102,137,117,153,47,166,0.85,35,36,119
OceanDNA-b13250,3720,3.8,0.0,0.017,7.0,124,147,134,157,108,165,0.85,23,23,57
OceanDNA-b2854,33,16.6,0.0,6.2e-07,0.00072,103,139,225,261,214,276,0.85,36,36,62
OceanDNA-b29543,472,11.2,0.0,9.6e-06,0.012,117,145,144,172,115,181,0.85,28,28,66
OceanDNA-b35076,458,11.1,0.0,1.9e-05,0.0072,122,145,145,168,125,191,0.85,23,23,66
OceanDNA-b22504,1657,27.1,0.0,4e-10,3.9e-07,119,211,230,326,216,336,0.85,92,96,120
OceanDNA-b17430,13,10.2,0.0,1.8e-05,0.039,119,140,115,136,97,145,0.85,21,21,48
OceanDNA-b20092,192,13.3,0.0,2.1e-06,0.00049,118,158,246,286,217,339,0.85,40,40,122
OceanDNA-b46939,472,7.9,0.0,9.2e-05,0.12,162,228,193,256,181,258,0.85,66,63,77
OceanDNA-b12532,131,128.8,0.0,1.2e-41,3.8e-39,19,249,52,297,42,309,0.85,230,245,267
OceanDNA-b15518,387,12.8,0.0,5.9e-06,0.0019,116,162,103,149,83,155,0.85,46,46,72
OceanDNA-b15518,206,11.7,0.0,1.3e-05,0.0041,117,162,22,67,3,81,0.85,45,45,78
OceanDNA-b30221,614,14.3,0.0,2.1e-06,0.0023,119,142,173,196,167,235,0.85,23,23,68
OceanDNA-b16141,638,4.0,0.0,0.0014,1.1,100,140,128,166,118,172,0.85,40,38,54
OceanDNA-b38157,292,16.9,0.0,3.4e-07,0.00012,163,231,647,717,610,721,0.85,68,70,111
OceanDNA-b22806,2866,11.4,0.0,2.5e-05,0.038,115,146,244,275,230,285,0.85,31,31,55
OceanDNA-b20951,344,11.3,0.1,8.9e-06,0.022,93,143,223,269,218,286,0.85,50,46,68
OceanDNA-b35076,477,13.0,0.0,5.1e-06,0.0019,163,226,183,244,170,252,0.85,63,61,82
OceanDNA-b24641,274,10.2,0.1,1.9e-05,0.0063,153,230,177,252,167,255,0.85,77,75,88
OceanDNA-b34860,267,18.0,0.0,7.6e-08,5.3e-05,163,230,615,684,577,686,0.85,67,69,109
OceanDNA-b44610,1442,5.8,0.0,0.00043,0.71,119,150,217,248,199,259,0.85,31,31,60
OceanDNA-b41853,159,14.0,0.0,1.3e-06,0.00025,118,180,114,178,100,214,0.85,62,64,114
OceanDNA-b31475,251,10.8,0.0,1.2e-05,0.0077,125,149,181,205,168,221,0.85,24,24,53
OceanDNA-b37060,975,11.6,0.0,7.1e-06,0.0073,114,152,178,217,132,225,0.85,38,39,93
OceanDNA-b30572,993,12.9,0.0,2.7e-06,0.008,119,144,169,194,165,233,0.85,25,25,68
OceanDNA-b16198,1641,14.7,0.0,7.8e-07,0.0014,96,143,25,72,8,80,0.85,47,47,72
OceanDNA-b37076,208,5.5,0.0,0.0005,0.57,54,86,150,182,135,187,0.85,32,32,52
OceanDNA-b20911,5136,7.3,0.0,0.00029,1.0,197,230,61,94,53,101,0.85,33,33,48
OceanDNA-b19130,5,7.6,0.0,0.00023,0.052,49,86,204,241,195,264,0.85,37,37,69
OceanDNA-b30166,781,23.4,0.2,1.7e-09,3e-06,101,156,146,199,97,208,0.85,55,53,111
OceanDNA-b34299,271,13.9,0.0,2.7e-06,0.0027,119,144,141,166,119,180,0.85,25,25,61
OceanDNA-b22935,660,16.0,0.0,6.6e-07,0.0013,116,150,220,254,205,268,0.85,34,34,63
OceanDNA-b41358,795,72.8,0.0,3e-24,1.8e-21,18,209,45,240,31,273,0.85,191,195,242
OceanDNA-b46252,556,-3.1,0.1,0.87,500.0,177,193,32,48,27,49,0.85,16,16,22
OceanDNA-b45835,357,13.8,0.0,2.9e-06,0.0014,118,151,126,159,111,188,0.85,33,33,77
OceanDNA-b43907,173,17.8,0.0,1.8e-07,3.2e-05,119,149,137,167,115,177,0.85,30,30,62
OceanDNA-b46210,121,10.3,0.0,1.7e-05,0.0054,113,154,239,280,215,291,0.85,41,41,76
OceanDNA-b41651,61,12.0,0.0,5.4e-06,0.0012,115,152,86,123,61,128,0.85,37,37,67
OceanDNA-b38518,99,16.9,0.0,3.4e-07,0.00016,115,150,139,174,121,189,0.85,35,35,68
OceanDNA-b40607,496,119.4,0.0,9e-39,5.5e-36,28,240,115,343,106,355,0.85,212,228,249
OceanDNA-b37246,288,22.2,0.0,4e-09,3.4e-06,117,183,108,176,80,201,0.85,66,68,121
OceanDNA-b20918,1140,16.1,0.0,6e-07,0.00095,112,178,221,288,192,298,0.85,66,67,106
OceanDNA-b46722,616,11.2,0.0,2.8e-05,0.015,118,155,165,203,150,226,0.85,37,38,76
OceanDNA-b45257,1554,11.5,0.0,7.6e-06,0.016,65,102,43,80,37,121,0.85,37,37,84
OceanDNA-b34275,864,11.4,0.0,1.6e-05,0.0074,124,145,157,178,136,194,0.85,21,21,58
OceanDNA-b10747,400,10.6,0.0,1.4e-05,0.0081,95,144,139,188,121,204,0.85,49,49,83
OceanDNA-b30045,558,13.8,0.0,1.5e-06,0.0038,118,141,169,192,153,205,0.85,23,23,52
OceanDNA-b46298,1400,10.8,0.0,2.5e-05,0.059,110,155,306,351,246,363,0.85,45,45,117
OceanDNA-b17578,527,10.8,0.0,1.2e-05,0.017,98,155,172,230,137,238,0.85,57,58,101
OceanDNA-b310,562,12.3,0.1,8.6e-06,0.0062,117,151,142,176,123,208,0.85,34,34,85
OceanDNA-b23003,1276,12.4,0.0,1.2e-05,0.0099,117,154,284,322,246,366,0.85,37,38,120
OceanDNA-b22383,363,-0.8,0.0,0.087,150.0,199,237,219,255,209,262,0.85,38,36,53
OceanDNA-b10383,74,10.9,0.0,1.2e-05,0.0039,163,229,378,446,372,448,0.85,66,68,76
OceanDNA-b26781,1409,10.7,0.0,2.6e-05,0.023,119,144,71,96,64,111,0.85,25,25,47
OceanDNA-b45095,586,8.9,0.0,4.7e-05,0.038,118,165,101,149,90,172,0.85,47,48,82
OceanDNA-b32474,247,13.7,0.0,1.6e-06,0.00052,118,211,109,206,96,220,0.85,93,97,124
OceanDNA-b3684,19,12.4,0.0,4.1e-06,0.0052,138,193,194,249,189,280,0.85,55,55,91
OceanDNA-b20922,2978,5.5,0.0,0.0015,3.5,197,232,223,259,207,264,0.85,35,36,57
OceanDNA-b13544,146,-1.0,0.1,0.049,57.0,54,81,54,81,44,83,0.85,27,27,39
OceanDNA-b33515,675,12.3,0.0,4.3e-06,0.0064,116,161,263,309,257,316,0.85,45,46,59
OceanDNA-b3434,756,11.1,0.0,1.9e-05,0.014,114,154,116,156,100,162,0.85,40,40,62
OceanDNA-b22385,2068,13.2,0.0,4.7e-06,0.009,111,157,176,222,164,227,0.85,46,46,63
OceanDNA-b3337,1561,10.6,0.0,2.8e-05,0.05,119,151,28,61,12,79,0.85,32,33,67
OceanDNA-b22184,660,12.8,0.0,3e-06,0.0075,107,158,17,66,8,75,0.85,51,49,67
OceanDNA-b22817,460,9.8,0.0,2.5e-05,0.1,115,157,233,275,217,286,0.85,42,42,69
OceanDNA-b37058,112,20.6,0.0,1.3e-08,8.1e-06,94,157,260,325,253,344,0.85,63,65,91
OceanDNA-b23515,852,9.7,0.0,5.4e-05,0.033,163,222,416,475,413,487,0.85,59,59,74
OceanDNA-b24595,2814,10.8,0.0,1.3e-05,0.046,158,194,232,268,205,286,0.85,36,36,81
OceanDNA-b18796,201,5.4,0.1,0.00054,0.15,53,86,202,235,193,272,0.85,33,33,79
OceanDNA-b36995,376,25.4,0.0,4.3e-10,3.3e-07,92,157,218,285,214,307,0.85,65,67,93
OceanDNA-b23103,4082,14.8,0.0,7.6e-07,0.0038,115,162,93,141,83,146,0.85,47,48,63
OceanDNA-b16778,122,12.5,0.0,1.1e-05,0.0061,107,160,74,126,13,172,0.85,53,52,159
OceanDNA-b29381,649,7.3,0.0,0.00014,0.13,160,209,261,310,251,318,0.85,49,49,67
OceanDNA-b19690,88,4.1,0.0,0.0027,0.59,53,86,203,236,189,256,0.85,33,33,67
OceanDNA-b40474,484,-2.8,0.0,0.35,170.0,221,234,19,32,16,36,0.85,13,13,20
OceanDNA-b10236,240,17.0,0.0,1.6e-07,4.2e-05,163,229,65,133,41,134,0.85,66,68,93
OceanDNA-b45647,130,12.2,0.0,4.7e-06,0.003,159,226,175,239,169,243,0.85,67,64,74
OceanDNA-b46617,448,12.5,0.0,3.8e-06,0.0068,106,158,168,218,159,228,0.85,52,50,69
OceanDNA-b42513,128,4.8,0.0,0.00085,0.22,200,222,277,299,267,316,0.85,22,22,49
OceanDNA-b21009,2557,3.3,0.0,0.0024,7.9,13,51,326,365,323,369,0.85,38,39,46
OceanDNA-b5513,155,131.5,0.0,1.8e-42,7.8e-40,18,247,32,276,19,285,0.85,229,244,266
OceanDNA-b21009,2557,8.4,0.1,6.5e-05,0.21,95,138,654,701,620,716,0.85,43,47,96
OceanDNA-b22895,678,11.4,0.0,8.2e-06,0.013,114,156,336,377,321,391,0.85,42,41,70
OceanDNA-b34608,1113,13.4,0.0,2e-06,0.0023,122,148,149,175,130,191,0.85,26,26,61
OceanDNA-b31070,2171,12.7,0.0,1.3e-05,0.0098,105,157,103,149,87,156,0.85,52,46,69
OceanDNA-b10437,4,15.4,0.0,4.7e-07,0.00012,113,157,220,265,210,294,0.85,44,45,84
OceanDNA-b33325,189,10.0,0.0,2.2e-05,0.035,125,145,147,167,141,182,0.85,20,20,41
OceanDNA-b4882,38,104.1,0.1,4.3e-34,1e-31,18,238,36,268,25,285,0.85,220,232,260
OceanDNA-b16212,559,10.6,0.0,1.4e-05,0.017,123,150,161,188,144,201,0.85,27,27,57
OceanDNA-b41349,858,70.5,0.0,1.5e-23,9.3e-21,18,209,45,240,31,273,0.85,191,195,242
OceanDNA-b38311,923,12.1,0.0,5e-06,0.0071,105,144,130,170,123,183,0.85,39,40,60
OceanDNA-b38906,131,10.5,0.0,1.5e-05,0.017,123,147,148,172,137,186,0.85,24,24,49
OceanDNA-b24625,31,13.2,0.1,4.6e-06,0.0012,85,132,216,266,214,283,0.85,47,50,69
OceanDNA-b30168,407,13.5,0.0,3.7e-06,0.0028,17,75,245,307,232,310,0.85,58,62,78
OceanDNA-b45554,234,5.4,0.0,0.0011,0.32,161,226,208,270,192,273,0.85,65,62,81
OceanDNA-b40947,36,112.2,0.0,1.5e-36,1.2e-33,33,232,70,283,62,295,0.85,199,213,233
OceanDNA-b32215,652,15.9,0.0,3.4e-07,0.00078,163,222,621,680,606,693,0.85,59,59,87
OceanDNA-b19805,352,12.5,0.0,3.6e-06,0.0014,99,157,144,200,138,205,0.85,58,56,67
OceanDNA-b17609,3614,0.0,0.0,0.024,110.0,167,187,306,326,295,364,0.85,20,20,69
OceanDNA-b16127,558,14.0,0.0,2.7e-06,0.00084,115,151,165,201,151,219,0.85,36,36,68
OceanDNA-b26639,931,5.7,0.0,0.00046,0.62,161,186,207,232,191,233,0.85,25,25,42
OceanDNA-b20676,16,101.0,0.0,7.4e-33,1.2e-30,19,246,20,256,15,270,0.85,227,236,255
OceanDNA-b20894,3731,12.6,0.1,3.6e-06,0.015,162,220,245,300,226,308,0.85,58,55,82
OceanDNA-b23468,540,13.1,0.0,2.4e-06,0.0065,119,146,138,165,127,179,0.85,27,27,52
OceanDNA-b38741,416,-2.8,0.0,0.17,86.0,72,85,178,191,161,194,0.85,13,13,33
OceanDNA-b3820,2333,12.0,0.0,5.3e-06,0.013,151,183,54,86,42,97,0.85,32,32,55
OceanDNA-b23275,379,13.2,0.0,2.3e-06,0.008,116,145,162,191,151,204,0.85,29,29,53
OceanDNA-b22858,2614,12.5,0.0,7.3e-06,0.013,114,157,235,278,218,287,0.85,43,43,69
OceanDNA-a3660,363,16.2,0.0,2.7e-07,0.00011,118,157,67,107,52,115,0.85,39,40,63
OceanDNA-b13261,228,48.8,0.0,6.1e-17,3.7e-14,71,233,183,342,144,359,0.85,162,159,215
OceanDNA-b3653,417,10.6,0.1,4.3e-05,0.033,163,229,621,689,566,690,0.85,66,68,124
OceanDNA-b34889,746,9.8,0.0,2.5e-05,0.02,163,222,166,225,160,238,0.85,59,59,78
OceanDNA-b34576,1076,14.0,0.0,1.3e-06,0.0015,121,148,148,175,129,191,0.85,27,27,62
OceanDNA-b40171,78,0.9,0.0,0.012,5.9,162,192,301,330,287,348,0.85,30,29,61
OceanDNA-b22801,1851,11.1,0.0,2e-05,0.026,163,225,587,651,582,659,0.85,62,64,77
OceanDNA-b38332,52,12.3,0.0,4.4e-06,0.0065,105,144,130,170,118,184,0.85,39,40,66
OceanDNA-b28501,49,14.3,0.0,1e-06,0.00046,119,146,147,174,135,193,0.85,27,27,58
OceanDNA-b20967,119,16.4,0.0,2.5e-07,0.00037,162,210,303,350,297,362,0.85,48,47,65
OceanDNA-b46852,925,11.9,0.1,1.1e-05,0.007,112,151,233,272,211,284,0.85,39,39,73
OceanDNA-b19769,45,0.4,0.0,0.037,8.7,49,85,201,237,195,257,0.85,36,36,62
OceanDNA-b11358,140,12.0,0.0,5.1e-06,0.0022,112,148,28,64,17,131,0.85,36,36,114
OceanDNA-b27542,1349,13.5,0.2,5.6e-06,0.0041,161,231,199,267,191,270,0.85,70,68,79
OceanDNA-b36729,927,8.1,0.1,8.1e-05,0.18,118,150,235,267,224,287,0.85,32,32,63
OceanDNA-b34611,71,26.6,0.0,1.9e-10,2.4e-07,163,229,614,682,600,688,0.85,66,68,88
OceanDNA-b37510,372,16.1,0.0,6.1e-07,0.0005,163,229,620,688,606,696,0.85,66,68,90
OceanDNA-b17602,3042,14.1,0.8,1.2e-06,0.005,109,195,4,94,1,100,0.85,86,90,99
OceanDNA-b46222,1352,8.9,0.0,9.4e-05,0.076,162,228,204,267,194,271,0.85,66,63,77
OceanDNA-b30373,1656,13.8,0.0,1.5e-06,0.0038,119,143,169,193,165,218,0.85,24,24,53
OceanDNA-b16139,352,0.9,0.0,0.025,10.0,210,241,475,506,417,515,0.85,31,31,98
OceanDNA-b17640,25,17.1,0.0,1.4e-07,0.0001,111,158,182,228,135,268,0.85,47,46,133
OceanDNA-b2513,1391,3.4,0.0,0.0043,3.2,9,43,90,124,84,153,0.85,34,34,69
OceanDNA-b31229,288,13.3,0.0,4.2e-06,0.0032,117,145,139,167,124,180,0.85,28,28,56
OceanDNA-b2796,846,17.7,0.0,1.9e-07,0.0002,110,155,305,352,288,357,0.85,45,47,69
OceanDNA-b16011,182,12.6,0.0,3.5e-06,0.0032,99,150,135,187,66,197,0.85,51,52,131
OceanDNA-b22965,2488,10.7,0.0,2.6e-05,0.056,114,144,96,126,65,136,0.85,30,30,71
OceanDNA-b3323,131,10.9,0.2,2.3e-05,0.037,100,146,134,180,99,184,0.85,46,46,85
OceanDNA-b5520,32,123.2,0.0,6.5e-40,3e-37,19,247,35,278,24,288,0.85,228,243,264
OceanDNA-b32925,605,10.9,0.0,1.2e-05,0.026,140,186,191,237,184,281,0.85,46,46,97
OceanDNA-b10381,264,-2.1,0.2,0.1,36.0,21,48,161,188,157,194,0.85,27,27,37
OceanDNA-b36140,2310,13.3,0.0,2.1e-06,0.006,163,227,648,714,643,723,0.85,64,66,80
OceanDNA-b1719,2754,11.2,0.1,1.9e-05,0.028,122,148,107,133,95,142,0.85,26,26,47
OceanDNA-b47053,235,13.4,0.1,2e-06,0.0013,123,163,103,143,70,150,0.85,40,40,80
OceanDNA-b9096,342,14.3,0.0,2.2e-06,0.00037,162,229,286,355,273,358,0.85,67,69,85
OceanDNA-b46299,2174,11.3,0.0,2.5e-05,0.042,115,156,199,240,187,251,0.85,41,41,64
OceanDNA-b17735,2830,10.1,0.0,2e-05,0.061,104,156,157,209,143,220,0.84,52,52,77
OceanDNA-b11418,498,5.6,0.0,0.00048,0.26,122,150,101,132,32,145,0.84,28,31,113
OceanDNA-b15470,77,10.4,0.0,1.6e-05,0.014,114,158,162,206,141,226,0.84,44,44,85
OceanDNA-b18344,110,19.7,0.0,2.4e-08,4.4e-06,110,153,145,190,133,223,0.84,43,45,90
OceanDNA-b6771,196,6.2,0.0,0.00094,0.29,124,147,126,149,115,159,0.84,23,23,44
OceanDNA-b24678,261,10.9,0.0,1.2e-05,0.011,119,150,145,176,124,187,0.84,31,31,63
OceanDNA-b28506,368,10.9,0.0,1.1e-05,0.0061,124,143,149,168,139,190,0.84,19,19,51
OceanDNA-b15134,177,16.4,0.0,4.8e-07,7.3e-05,117,157,240,281,227,292,0.84,40,41,65
OceanDNA-b10602,233,11.0,0.0,1.1e-05,0.0034,99,155,101,155,37,161,0.84,56,54,124
OceanDNA-b15938,254,10.5,0.0,1.5e-05,0.0044,122,146,100,124,78,136,0.84,24,24,58
OceanDNA-b46255,2575,13.2,0.0,6.6e-06,0.0073,111,154,139,183,120,188,0.84,43,44,68
OceanDNA-b3688,499,11.5,0.0,7.7e-06,0.0071,123,151,81,109,69,155,0.84,28,28,86
OceanDNA-b46675,479,12.1,0.0,5e-06,0.01,104,158,539,591,525,605,0.84,54,52,80
OceanDNA-b2811,1320,4.1,0.0,0.0014,2.1,149,182,335,368,317,377,0.84,33,33,60
OceanDNA-b26605,363,16.2,0.1,2.9e-07,0.00016,112,148,140,176,128,211,0.84,36,36,83
OceanDNA-b44435,1547,13.3,0.0,4.4e-06,0.0057,119,150,148,179,120,185,0.84,31,31,65
OceanDNA-b17638,663,18.2,0.0,6.6e-08,4.8e-05,118,159,186,228,168,285,0.84,41,42,117
OceanDNA-b41476,1378,11.7,0.0,1.3e-05,0.0092,119,143,155,179,128,197,0.84,24,24,69
OceanDNA-b10020,371,10.6,0.0,2.8e-05,0.0068,163,229,614,682,595,684,0.84,66,68,89
OceanDNA-b10365,303,10.1,0.0,4.1e-05,0.014,116,153,133,170,114,175,0.84,37,37,61
OceanDNA-b22406,2680,14.7,0.0,3.3e-06,0.0024,117,152,220,255,179,261,0.84,35,35,82
OceanDNA-b16227,471,-1.7,0.0,0.24,85.0,53,85,299,331,288,335,0.84,32,32,47
OceanDNA-b17549,984,14.9,0.0,7e-07,0.0027,118,155,269,306,253,320,0.84,37,37,67
OceanDNA-b13250,3720,5.7,0.0,0.0045,1.8,154,193,248,286,237,293,0.84,39,38,56
OceanDNA-b17548,274,0.0,0.0,0.024,42.0,50,84,138,172,132,199,0.84,34,34,67
OceanDNA-b33288,2766,12.1,0.0,9.6e-06,0.014,121,149,383,411,363,426,0.84,28,28,63
OceanDNA-b23260,70,9.4,0.0,3.2e-05,0.023,160,221,206,266,128,271,0.84,61,60,143
OceanDNA-b4282,21,30.5,0.0,1.2e-11,3.3e-09,116,208,143,237,121,249,0.84,92,94,128
OceanDNA-b36411,1726,5.6,0.0,0.0014,0.93,161,187,248,274,206,284,0.84,26,26,78
OceanDNA-b23333,179,12.6,0.1,1e-05,0.0056,116,153,546,584,529,588,0.84,37,38,59
OceanDNA-b22840,1018,12.9,0.0,5.7e-06,0.012,112,145,228,261,211,270,0.84,33,33,59
OceanDNA-b46919,1190,11.7,0.0,1.3e-05,0.01,103,150,206,254,199,260,0.84,47,48,61
OceanDNA-b20505,46,0.6,0.0,0.016,4.4,45,85,125,165,114,173,0.84,40,40,59
OceanDNA-b3624,700,4.2,0.0,0.0013,1.1,109,152,138,182,124,190,0.84,43,44,66
OceanDNA-b15238,333,14.6,0.0,8.7e-07,0.00033,117,157,266,307,255,340,0.84,40,41,85
OceanDNA-b29542,14,14.7,0.1,1.6e-06,0.0018,119,148,139,168,134,208,0.84,29,29,74
OceanDNA-b13256,1037,29.7,0.0,1.5e-10,4.2e-08,18,146,215,345,207,437,0.84,128,130,230
OceanDNA-b12668,103,14.1,0.0,1.2e-06,0.00053,152,233,184,263,177,279,0.84,81,79,102
OceanDNA-b37592,1558,16.6,0.1,2.1e-07,0.00043,118,148,177,208,125,218,0.84,30,31,93
OceanDNA-b5433,327,125.4,0.0,1.3e-40,5.8e-38,18,248,35,280,23,289,0.84,230,245,266
OceanDNA-b22178,122,11.6,0.0,7.2e-06,0.0025,112,157,484,529,470,540,0.84,45,45,70
OceanDNA-b13256,1175,15.0,0.0,4.4e-06,0.0013,116,147,132,162,65,181,0.84,31,30,116
OceanDNA-b30493,1068,4.6,0.0,0.00094,1.4,125,154,151,180,102,193,0.84,29,29,91
OceanDNA-b23229,1345,10.9,0.0,2.4e-05,0.017,114,144,115,145,101,146,0.84,30,30,45
OceanDNA-b10043,168,14.2,0.0,1.2e-06,0.00047,98,154,122,176,45,187,0.84,56,54,142
OceanDNA-b12280,47,34.5,0.0,7e-13,2.7e-10,113,207,136,233,50,246,0.84,94,97,196
OceanDNA-b13175,254,11.0,0.0,1.1e-05,0.0097,119,145,145,171,140,200,0.84,26,26,60
OceanDNA-b19665,207,13.8,0.0,3e-06,0.00072,108,157,72,119,60,124,0.84,49,47,64
OceanDNA-b46982,145,11.7,0.0,2.5e-05,0.0042,105,157,169,219,159,225,0.84,52,50,66
OceanDNA-b44,4810,18.8,0.0,9.1e-08,0.00034,163,228,614,681,560,684,0.84,65,67,124
OceanDNA-b33329,1259,13.2,0.1,2.3e-06,0.0036,125,150,147,172,126,186,0.84,25,25,60
OceanDNA-b22138,112,10.5,0.0,1.5e-05,0.009,114,158,121,165,104,177,0.84,44,44,73
OceanDNA-b19665,86,21.8,0.0,1.1e-08,2.6e-06,89,156,288,359,282,380,0.84,67,71,98
OceanDNA-b13836,229,8.0,0.0,9e-05,0.026,162,193,583,613,564,621,0.84,31,30,57
OceanDNA-b282,312,16.3,0.0,5.2e-07,0.00038,130,210,1,83,1,94,0.84,80,82,93
OceanDNA-b22939,2050,12.1,0.0,4.9e-06,0.021,107,158,529,578,519,592,0.84,51,49,73
OceanDNA-b3337,2399,9.9,0.0,4.7e-05,0.084,49,86,185,223,165,230,0.84,37,38,65
OceanDNA-b10020,371,2.6,0.0,0.0075,1.9,118,155,534,571,520,581,0.84,37,37,61
OceanDNA-b28010,562,5.4,0.1,0.00053,1.7,163,231,208,274,200,277,0.84,68,66,77
OceanDNA-b35152,1683,13.3,0.0,2.1e-06,0.004,121,141,144,164,125,181,0.84,20,20,56
OceanDNA-b22513,1918,1.3,0.0,0.02,28.0,51,87,142,178,114,184,0.84,36,36,70
OceanDNA-b7219,294,17.7,0.0,9.9e-08,3.3e-05,102,152,102,150,88,167,0.84,50,48,79
OceanDNA-b41152,1030,1.4,0.0,0.026,20.0,163,187,211,234,180,247,0.84,24,23,67
OceanDNA-b11234,311,26.1,0.0,2.7e-10,1.2e-07,117,193,144,221,115,231,0.84,76,77,116
OceanDNA-b22513,1659,10.9,0.0,2.3e-05,0.033,163,228,629,693,623,701,0.84,65,64,78
OceanDNA-b6501,409,9.4,0.0,9.7e-05,0.016,114,149,237,272,212,280,0.84,35,35,68
OceanDNA-b4053,568,11.0,0.0,2.2e-05,0.0076,110,145,115,150,83,174,0.84,35,35,91
OceanDNA-b28587,550,6.2,0.0,0.0003,0.25,153,192,240,279,216,293,0.84,39,39,77
OceanDNA-b10298,485,14.5,0.0,1.9e-06,0.00053,94,157,15,80,2,94,0.84,63,65,92
OceanDNA-b16096,300,1.3,0.0,0.0094,3.3,161,183,200,222,190,238,0.84,22,22,48
OceanDNA-b24591,1677,10.7,0.0,1.4e-05,0.037,119,146,149,176,134,188,0.84,27,27,54
OceanDNA-b7470,187,22.9,0.0,2.5e-09,1.4e-06,98,155,99,152,87,166,0.84,57,53,79
OceanDNA-b22885,1053,15.6,0.0,8.4e-07,0.0018,105,158,184,235,167,255,0.84,53,51,88
OceanDNA-b46656,2661,10.9,0.0,4.6e-05,0.039,105,158,547,598,536,614,0.84,53,51,78
OceanDNA-b12512,193,34.6,0.0,6.8e-13,2.1e-10,106,208,135,239,121,261,0.84,102,104,140
OceanDNA-b1588,529,6.4,0.1,0.00027,0.22,115,153,109,146,92,155,0.84,38,37,63
OceanDNA-b32076,1774,14.5,0.0,8.9e-07,0.0028,119,146,162,189,148,200,0.84,27,27,52
OceanDNA-b7191,212,-1.7,0.0,0.079,34.0,163,186,215,238,208,254,0.84,23,23,46
OceanDNA-b35108,62,9.0,0.0,4.5e-05,0.029,163,228,615,682,588,684,0.84,65,67,96
OceanDNA-b37856,208,5.1,0.0,0.00068,0.55,119,153,183,219,163,235,0.84,34,36,72
OceanDNA-b34767,147,22.4,0.0,6.9e-09,3.1e-06,114,154,206,247,188,270,0.84,40,41,82
OceanDNA-b19626,358,38.5,0.0,8.7e-14,2.1e-11,37,138,77,183,54,204,0.84,101,106,150
OceanDNA-b26769,766,-1.4,0.0,0.066,130.0,18,38,218,238,206,243,0.84,20,20,37
OceanDNA-b23401,359,17.2,0.0,1.4e-07,0.0003,112,153,550,593,538,597,0.84,41,43,59
OceanDNA-b20705,111,13.9,0.0,1.4e-06,0.00034,186,240,263,318,238,332,0.84,54,55,94
OceanDNA-b8980,2,21.0,0.0,9.7e-09,2.7e-06,118,164,195,242,182,285,0.84,46,47,103
OceanDNA-b26737,1759,4.8,0.0,0.0017,2.0,197,233,234,271,205,279,0.84,36,37,74
OceanDNA-b32606,3261,6.6,0.0,0.00023,1.0,117,135,193,211,177,226,0.84,18,18,49
OceanDNA-b16133,1080,12.3,0.0,1.3e-05,0.0049,122,145,155,178,145,203,0.84,23,23,58
OceanDNA-b28146,1182,8.1,0.0,8.4e-05,0.16,164,231,173,238,161,241,0.84,67,65,80
OceanDNA-b18639,160,12.5,0.0,7.4e-06,0.0015,96,157,217,280,210,291,0.84,61,63,81
OceanDNA-b11187,24,24.0,0.0,2.3e-09,5.6e-07,117,192,147,223,133,233,0.84,75,76,100
OceanDNA-b22185,127,120.1,0.0,5.5e-39,1.3e-35,18,249,67,312,51,324,0.84,231,245,273
OceanDNA-b22314,3718,9.8,0.0,2.6e-05,0.12,107,157,192,240,182,245,0.84,50,48,63
OceanDNA-b22656,602,-0.7,0.0,0.039,32.0,70,87,198,215,183,224,0.84,17,17,41
OceanDNA-b13590,1708,3.2,0.0,0.0075,7.2,164,202,226,263,221,271,0.84,38,37,50
OceanDNA-b40618,310,121.2,0.0,7.7e-39,1.5e-36,31,215,99,296,81,340,0.84,184,197,259
OceanDNA-b34551,807,15.2,0.0,1.7e-06,0.00051,104,157,120,174,109,181,0.84,53,54,72
OceanDNA-b31510,83,10.6,0.0,4.3e-05,0.016,163,222,611,670,596,679,0.84,59,59,83
OceanDNA-b34564,654,15.2,0.0,5.7e-07,0.00042,104,157,118,172,108,179,0.84,53,54,71
OceanDNA-b31510,971,3.6,0.0,0.0059,2.2,119,152,492,526,478,538,0.84,33,34,60
OceanDNA-b23089,3322,11.3,0.0,1.7e-05,0.034,111,146,316,351,303,366,0.84,35,35,63
OceanDNA-b16220,635,7.3,0.0,0.00028,0.17,42,115,105,180,102,190,0.84,73,75,88
OceanDNA-b23089,2834,28.4,0.0,1.1e-10,2.1e-07,116,186,160,231,97,265,0.84,70,71,168
OceanDNA-b23273,1319,10.1,0.2,2e-05,0.045,123,152,230,259,192,263,0.84,29,29,71
OceanDNA-b20056,332,12.2,0.0,8.9e-06,0.0017,116,162,595,645,587,653,0.84,46,50,66
OceanDNA-b20934,768,11.2,1.1,9.2e-06,0.052,91,119,31,58,25,94,0.84,28,27,69
OceanDNA-b45437,549,3.1,0.0,0.0028,3.5,70,88,30,48,13,56,0.84,18,18,43
OceanDNA-b30622,11,13.2,0.0,2.3e-06,0.0015,119,146,146,173,138,199,0.84,27,27,61
OceanDNA-b35278,403,8.1,0.0,0.00017,0.068,162,219,589,646,582,656,0.84,57,57,74
OceanDNA-b23559,253,1.7,0.0,0.0072,12.0,167,189,239,261,232,282,0.84,22,22,50
OceanDNA-b14822,76,1.7,0.0,0.0072,1.7,184,219,144,179,131,186,0.84,35,35,55
OceanDNA-b6262,96,11.3,0.0,8.9e-06,0.0044,100,150,101,149,81,155,0.84,50,48,74
OceanDNA-b9009,46,13.0,0.0,5.1e-06,0.00056,114,153,145,185,134,189,0.84,39,40,55
OceanDNA-b34301,471,17.3,0.0,1.3e-07,9.4e-05,162,230,334,404,299,406,0.84,68,70,107
OceanDNA-b22487,594,12.1,0.0,9.5e-06,0.012,117,149,320,352,307,357,0.84,32,32,50
OceanDNA-b22487,2098,11.8,0.0,1.2e-05,0.015,111,157,22,68,9,75,0.84,46,46,66
OceanDNA-b20043,325,13.9,0.0,2.9e-06,0.00048,116,161,172,221,160,230,0.84,45,49,70
OceanDNA-b45104,704,10.4,0.0,1.6e-05,0.013,118,165,20,68,11,95,0.84,47,48,84
OceanDNA-b26586,900,1.6,0.0,0.0078,7.4,158,184,241,267,220,290,0.84,26,26,70
OceanDNA-b46641,1672,13.5,0.0,1.9e-06,0.0037,115,160,91,136,80,149,0.84,45,45,69
OceanDNA-b47105,25,7.8,0.0,9.9e-05,0.031,156,193,246,282,238,292,0.84,37,36,54
OceanDNA-b37601,1136,10.9,0.0,2.2e-05,0.017,102,158,70,127,57,165,0.84,56,57,108
OceanDNA-b15326,263,20.9,0.0,1e-08,3e-06,63,153,100,189,64,196,0.84,90,89,132
OceanDNA-b34951,651,10.9,0.0,1.2e-05,0.0086,163,227,435,497,422,505,0.84,64,62,83
OceanDNA-b37613,422,16.8,0.0,1.8e-07,0.00035,119,181,121,186,50,225,0.84,62,65,175
OceanDNA-b33192,401,6.3,0.1,0.00056,0.12,197,230,113,148,102,149,0.84,33,35,47
OceanDNA-b29385,2659,23.8,0.0,4.1e-09,4.6e-06,45,141,335,435,319,449,0.84,96,100,130
OceanDNA-b32721,2142,17.2,0.0,1.4e-07,0.00032,120,204,1,85,1,101,0.84,84,84,100
OceanDNA-b13541,1191,14.8,0.0,7.2e-07,0.001,104,149,204,250,193,256,0.84,45,46,63
OceanDNA-b12581,54,109.8,0.0,7.5e-36,1.8e-33,35,230,60,266,31,285,0.84,195,206,254
OceanDNA-b3425,223,14.4,0.0,2e-06,0.00076,115,155,251,291,239,309,0.84,40,40,70
OceanDNA-b46326,1716,12.0,0.0,1.1e-05,0.014,118,151,258,291,241,307,0.84,33,33,66
OceanDNA-b19079,130,15.6,0.0,4.1e-07,0.00014,115,154,123,163,88,184,0.84,39,40,96
OceanDNA-b22859,218,12.0,0.0,1.1e-05,0.015,111,148,241,278,227,286,0.84,37,37,59
OceanDNA-b23996,682,9.7,0.0,5.5e-05,0.032,162,213,613,664,600,682,0.84,51,51,82
OceanDNA-b36650,251,10.5,0.0,1.5e-05,0.0053,123,147,141,165,133,182,0.84,24,24,49
OceanDNA-b34760,599,11.2,0.0,9e-06,0.0055,163,219,261,317,243,326,0.84,56,56,83
OceanDNA-b22858,2614,0.4,0.0,0.037,63.0,69,87,174,192,135,199,0.84,18,18,64
OceanDNA-b30206,2000,3.8,0.3,0.0034,3.9,126,152,131,157,79,176,0.84,26,26,97
OceanDNA-b22858,1665,11.6,0.0,1.4e-05,0.023,108,157,239,286,228,291,0.84,49,47,63
OceanDNA-b31526,855,17.6,0.0,3.2e-07,0.00011,45,86,206,247,196,276,0.84,41,41,80
OceanDNA-b46704,248,11.3,0.0,2.5e-05,0.016,104,158,531,583,517,592,0.84,54,52,75
OceanDNA-b19786,331,13.4,0.0,2e-06,0.00078,111,157,157,203,144,213,0.84,46,46,69
OceanDNA-b1825,1867,14.9,0.0,1.4e-06,0.0025,86,154,443,510,403,534,0.84,68,67,131
OceanDNA-b36405,186,11.5,0.0,7.6e-06,0.0033,125,151,146,172,140,215,0.84,26,26,75
OceanDNA-b34805,485,-2.2,0.0,0.11,67.0,49,76,368,395,362,413,0.84,27,27,51
OceanDNA-b16480,1016,-3.3,0.0,0.24,270.0,56,82,156,182,154,192,0.84,26,26,38
OceanDNA-b45857,4007,15.3,0.0,5.1e-07,0.0021,102,150,181,229,172,265,0.84,48,48,93
OceanDNA-b38220,389,12.3,0.0,4.2e-06,0.0052,105,144,140,180,128,194,0.84,39,40,66
OceanDNA-b32141,2451,11.1,0.1,3e-05,0.03,120,140,320,340,316,356,0.84,20,20,40
OceanDNA-b21014,2057,12.1,0.0,5e-06,0.015,118,152,151,185,133,207,0.84,34,34,74
OceanDNA-b29397,1522,12.7,0.0,3.2e-06,0.008,119,145,146,172,131,197,0.84,26,26,66
OceanDNA-b27544,463,10.4,0.1,1.6e-05,0.025,163,232,181,248,169,252,0.84,69,67,83
OceanDNA-b26167,208,12.5,0.0,3.7e-06,0.0032,51,147,59,159,48,173,0.84,96,100,125
OceanDNA-b28262,307,1.9,0.0,0.0063,3.1,125,142,86,103,72,131,0.84,17,17,59
OceanDNA-a1697,90,10.8,0.0,1.2e-05,0.003,119,183,187,253,175,263,0.84,64,66,88
OceanDNA-b4256,145,18.9,0.0,4.2e-08,1.1e-05,163,231,228,298,214,298,0.84,68,70,84
OceanDNA-b26604,235,16.3,0.1,2.7e-07,0.00014,112,148,140,176,128,225,0.84,36,36,97
OceanDNA-b31464,1668,3.5,0.0,0.002,3.9,166,230,197,259,184,274,0.84,64,62,90
OceanDNA-b34854,147,15.4,0.0,4.8e-07,0.0003,163,228,612,679,575,682,0.84,65,67,107
OceanDNA-b13539,88,13.3,0.0,4.3e-06,0.0033,104,149,488,534,479,540,0.84,45,46,61
OceanDNA-b32047,264,24.4,0.0,2.6e-09,3e-06,95,168,123,195,61,231,0.84,73,72,170
OceanDNA-b27525,1050,3.2,0.0,0.01,7.0,172,232,406,468,379,476,0.84,60,62,97
OceanDNA-b32047,2007,12.0,0.0,1.6e-05,0.018,120,142,210,232,205,246,0.84,22,22,41
OceanDNA-b32709,1502,5.1,0.0,0.0013,1.1,161,180,237,256,223,301,0.84,19,19,78
OceanDNA-b45222,860,0.2,0.0,0.021,53.0,126,171,530,576,514,579,0.84,45,46,65
OceanDNA-b45818,6,22.0,0.0,2.4e-08,7.2e-06,116,154,176,215,151,276,0.84,38,39,125
OceanDNA-b32139,904,1.8,0.0,0.013,16.0,163,186,249,273,239,281,0.84,23,24,42
OceanDNA-b22409,2960,12.9,0.1,8.3e-06,0.011,53,123,30,97,6,104,0.84,70,67,98
OceanDNA-b31995,2721,1.1,0.0,0.011,37.0,26,40,212,226,207,240,0.84,14,14,33
OceanDNA-b25128,263,15.9,0.0,3.4e-07,0.0003,160,212,338,388,331,407,0.84,52,50,76
OceanDNA-b35110,497,10.8,0.0,2.5e-05,0.0099,104,152,59,106,30,121,0.84,48,47,91
OceanDNA-b19701,335,18.9,0.0,8.6e-08,1.7e-05,110,156,21,67,2,88,0.84,46,46,86
OceanDNA-b40493,544,17.0,0.0,1.6e-07,0.00014,121,149,146,174,135,190,0.84,28,28,55
OceanDNA-b10297,536,17.5,0.0,1.1e-07,6.2e-05,163,231,608,678,601,678,0.84,68,70,77
OceanDNA-b34384,115,12.8,0.0,5.9e-06,0.0025,124,152,130,158,50,165,0.84,28,28,115
OceanDNA-b46581,1256,11.6,0.0,1.4e-05,0.011,111,158,170,217,158,227,0.84,47,47,69
OceanDNA-b3656,73,11.2,0.0,1.9e-05,0.0051,163,228,619,686,606,687,0.84,65,67,81
OceanDNA-b23976,1658,1.1,0.0,0.022,19.0,197,229,232,265,196,270,0.84,32,33,74
OceanDNA-b22760,2709,-1.3,0.0,0.061,220.0,70,87,186,203,174,209,0.84,17,17,35
OceanDNA-b45519,118,21.3,0.0,7.9e-09,9.6e-06,95,154,187,246,156,272,0.84,59,59,116
OceanDNA-b2829,55,14.0,0.0,2.7e-06,0.0042,131,208,194,268,188,281,0.84,77,74,93
OceanDNA-b9635,310,8.1,0.1,8.2e-05,0.04,139,187,196,244,191,268,0.84,48,48,77
OceanDNA-b41512,504,7.0,0.0,0.00018,0.36,43,83,44,86,38,107,0.84,40,42,69
OceanDNA-b23145,1394,0.8,0.0,0.028,30.0,214,246,269,301,257,308,0.84,32,32,51
OceanDNA-b10371,327,14.6,0.1,8.4e-07,0.00031,163,227,301,367,286,369,0.84,64,66,83
OceanDNA-b28545,234,17.4,0.0,1.2e-07,0.00025,119,145,140,166,123,190,0.84,26,26,67
OceanDNA-b22935,3464,12.6,0.0,6.7e-06,0.013,107,158,518,567,508,634,0.84,51,49,126
OceanDNA-b20290,149,13.3,0.0,2.1e-06,0.00099,118,162,597,645,590,651,0.84,44,48,61
OceanDNA-b27522,1516,0.0,0.0,0.024,46.0,210,240,132,162,115,174,0.84,30,30,59
OceanDNA-b13692,196,7.8,0.0,0.0001,0.047,163,192,616,644,602,654,0.84,29,28,52
OceanDNA-b40885,211,-3.3,0.1,0.24,150.0,51,71,401,421,399,427,0.84,20,20,28
OceanDNA-b16210,467,0.8,0.0,0.028,16.0,162,189,484,512,462,532,0.84,27,28,70
OceanDNA-b38353,719,15.1,0.0,1.2e-06,0.0014,105,151,150,197,143,210,0.84,46,47,67
OceanDNA-b31677,556,15.3,0.0,5.3e-07,0.00081,163,230,505,574,470,579,0.84,67,69,109
OceanDNA-b512,233,11.2,0.0,9e-06,0.015,114,151,89,127,38,132,0.84,37,38,94
OceanDNA-b42188,85,10.9,0.0,1.1e-05,0.0033,118,179,125,188,105,229,0.84,61,63,124
OceanDNA-b1355,3402,11.3,0.0,8.9e-06,0.032,124,167,128,171,115,194,0.84,43,43,79
OceanDNA-b18413,186,9.7,0.0,2.7e-05,0.016,163,222,610,669,596,680,0.84,59,59,84
OceanDNA-b10019,206,2.6,0.0,0.0038,2.0,118,155,535,572,521,582,0.84,37,37,61
OceanDNA-b45747,1546,17.8,0.0,9.2e-08,0.00021,114,153,155,195,137,221,0.84,39,40,84
OceanDNA-b45669,259,10.7,0.0,1.3e-05,0.007,119,142,267,290,257,301,0.84,23,23,44
OceanDNA-b46939,472,12.1,0.0,4.8e-06,0.0064,122,160,112,150,42,159,0.84,38,38,117
OceanDNA-b46970,790,13.3,0.0,4.4e-06,0.0018,116,151,172,207,141,218,0.84,35,35,77
OceanDNA-b10019,206,9.2,0.0,3.9e-05,0.02,163,228,615,682,596,684,0.84,65,67,88
OceanDNA-b33388,2196,12.8,0.1,1.6e-05,0.012,116,152,139,174,136,193,0.84,36,35,57
OceanDNA-b25111,205,11.7,0.1,6.6e-06,0.0073,124,153,115,144,107,202,0.84,29,29,95
OceanDNA-b20290,149,-1.9,0.1,0.092,44.0,153,166,285,298,280,301,0.84,13,13,21
OceanDNA-b17032,419,15.2,0.0,5.5e-07,0.00074,51,153,36,139,20,162,0.84,102,103,142
OceanDNA-b46741,1437,12.6,0.0,6.9e-06,0.0061,117,154,101,139,86,169,0.84,37,38,83
OceanDNA-b35857,444,-1.7,0.0,0.081,38.0,208,230,198,220,185,233,0.84,22,22,48
OceanDNA-b17716,254,16.6,0.0,2.1e-07,0.00027,116,159,196,240,180,274,0.84,43,44,94
OceanDNA-b23561,1571,9.6,0.0,2.9e-05,0.066,118,145,224,251,218,267,0.84,27,27,49
OceanDNA-b46717,981,14.0,0.0,2.6e-06,0.0044,117,154,222,260,208,269,0.84,37,38,61
OceanDNA-b37960,533,9.2,0.0,3.7e-05,0.021,22,85,55,117,42,137,0.84,63,62,95
OceanDNA-b44662,1421,-1.5,0.0,0.14,190.0,52,62,724,734,709,738,0.84,10,10,29
OceanDNA-b31537,1880,11.0,0.2,1e-05,0.023,110,152,126,168,99,174,0.84,42,42,75
OceanDNA-b38177,705,13.4,0.0,2e-06,0.0057,163,229,636,704,631,708,0.83,66,68,77
OceanDNA-b30042,2509,11.4,0.0,7.9e-06,0.027,111,150,115,154,107,163,0.83,39,39,56
OceanDNA-b45823,1426,10.7,0.0,2.6e-05,0.023,118,151,135,168,112,216,0.83,33,33,104
OceanDNA-b3641,425,14.1,0.0,2.4e-06,0.00062,118,154,165,201,139,258,0.83,36,36,119
OceanDNA-b13544,146,6.5,0.0,0.00025,0.3,123,152,121,150,117,181,0.83,29,29,64
OceanDNA-b13147,274,15.1,0.0,6e-07,0.00023,106,145,130,169,122,184,0.83,39,39,62
OceanDNA-b19913,237,11.0,0.0,1e-05,0.0035,116,165,135,184,121,217,0.83,49,49,96
OceanDNA-b32152,3251,11.2,0.0,1.8e-05,0.031,119,145,233,259,213,271,0.83,26,26,58
OceanDNA-b4249,812,12.1,0.0,4.9e-06,0.0069,157,231,198,270,182,275,0.83,74,72,93
OceanDNA-b15450,1537,20.5,0.5,2.8e-08,2.9e-05,158,208,165,213,82,224,0.83,50,48,142
OceanDNA-b14516,393,5.5,0.0,0.00053,0.3,119,147,85,113,80,130,0.83,28,28,50
OceanDNA-b26893,2035,1.7,0.0,0.014,24.0,158,209,252,303,243,308,0.83,51,51,65
OceanDNA-b41014,1220,1.7,0.0,0.015,16.0,163,193,211,240,193,251,0.83,30,29,58
OceanDNA-b34300,366,9.2,0.0,7.8e-05,0.034,163,226,613,678,605,688,0.83,63,65,83
OceanDNA-b30134,407,8.3,0.1,7e-05,0.16,119,150,121,152,82,166,0.83,31,31,84
OceanDNA-b20595,175,45.5,0.0,3.2e-16,8.9e-14,32,155,89,217,71,224,0.83,123,128,153
OceanDNA-b31726,1049,11.0,0.0,1e-05,0.019,163,229,666,735,652,740,0.83,66,69,88
OceanDNA-b30953,1742,9.9,0.8,2.3e-05,0.064,94,140,20,67,11,75,0.83,46,47,64
OceanDNA-b22174,57,-3.1,0.0,0.22,130.0,47,66,294,313,290,330,0.83,19,19,40
OceanDNA-b5526,273,125.8,0.0,1e-40,5.4e-38,34,247,92,317,58,327,0.83,213,225,269
OceanDNA-b19690,88,19.8,0.0,4.4e-08,9.9e-06,89,157,267,339,249,358,0.83,68,72,109
OceanDNA-b20657,47,47.4,0.0,1.7e-16,2.5e-14,20,154,65,206,61,213,0.83,134,141,152
OceanDNA-b4594,24,11.2,0.0,1.8e-05,0.0045,161,233,187,257,177,270,0.83,72,70,93
OceanDNA-b40457,1543,1.5,0.0,0.0084,13.0,123,150,157,184,149,205,0.83,27,27,56
OceanDNA-b15108,1673,12.9,0.0,2.9e-06,0.0048,115,185,307,383,256,397,0.83,70,76,141
OceanDNA-b30095,2002,15.7,0.0,3.9e-07,0.00099,118,142,141,165,132,189,0.83,24,24,57
OceanDNA-b22632,979,16.3,0.0,2.6e-07,0.00087,105,156,177,231,168,234,0.83,51,54,66
OceanDNA-b24739,379,11.0,0.0,1.1e-05,0.007,119,147,34,62,16,91,0.83,28,28,75
OceanDNA-b23996,1022,13.8,0.0,3e-06,0.0018,162,232,110,182,95,184,0.83,70,72,89
OceanDNA-b32785,766,13.5,0.0,1.8e-06,0.0019,109,151,84,126,11,143,0.83,42,42,132
OceanDNA-b17033,596,11.6,0.0,1.4e-05,0.011,118,151,107,140,94,145,0.83,33,33,51
OceanDNA-b10921,32,9.9,0.0,2.3e-05,0.005,163,228,527,594,511,596,0.83,65,67,85
OceanDNA-b30257,76,14.7,0.0,7.8e-07,0.0016,119,144,172,197,168,224,0.83,25,25,56
OceanDNA-b35156,466,14.8,0.1,7.3e-07,0.0013,121,143,144,166,124,181,0.83,22,22,57
OceanDNA-b37268,282,19.5,0.0,2.8e-08,4.5e-05,118,145,143,170,114,187,0.83,27,27,73
OceanDNA-b46391,1300,11.0,0.0,1.1e-05,0.027,117,171,178,233,156,252,0.83,54,55,96
OceanDNA-b22615,1167,14.8,0.1,1.5e-06,0.0045,116,154,133,172,124,207,0.83,38,39,83
OceanDNA-a1600,65,11.6,0.0,7.1e-06,0.0017,119,183,178,244,164,254,0.83,64,66,90
OceanDNA-b22449,284,13.4,0.0,4e-06,0.0032,68,156,140,230,131,242,0.83,88,90,111
OceanDNA-b37859,480,23.2,0.0,2e-09,1.9e-06,163,234,705,778,678,786,0.83,71,73,108
OceanDNA-b38872,355,-0.8,0.0,0.041,27.0,204,247,265,309,256,321,0.83,43,44,65
OceanDNA-b22380,743,14.0,0.0,3.8e-06,0.002,88,150,131,192,103,202,0.83,62,61,99
OceanDNA-b31526,1023,18.2,0.0,2.1e-07,7.1e-05,162,229,51,120,16,121,0.83,67,69,105
OceanDNA-b20676,199,47.7,0.0,1.3e-16,2.2e-14,35,154,84,208,63,216,0.83,119,124,153
OceanDNA-b33391,2935,17.0,0.0,1.6e-07,0.00091,43,140,41,137,19,146,0.83,97,96,127
OceanDNA-b43,3904,11.0,0.0,2.2e-05,0.074,116,146,62,92,39,163,0.83,30,30,124
OceanDNA-b7494,551,13.2,0.0,2.3e-06,0.0027,57,144,17,100,9,110,0.83,87,83,101
OceanDNA-b38376,1555,76.0,0.1,4.6e-25,3.9e-22,36,210,65,244,55,286,0.83,174,179,231
OceanDNA-b13575,549,19.9,0.0,2.1e-08,2.2e-05,57,145,23,108,12,125,0.83,88,85,113
OceanDNA-b40548,381,15.6,0.0,4.2e-07,0.00047,100,156,155,207,123,247,0.83,56,52,124
OceanDNA-b22177,281,10.6,0.0,1.4e-05,0.012,107,157,498,546,485,554,0.83,50,48,69
OceanDNA-b36076,862,-2.1,0.0,0.21,270.0,165,182,261,278,256,282,0.83,17,17,26
OceanDNA-b32385,103,-0.1,0.0,0.026,8.2,126,151,84,109,62,134,0.83,25,25,72
OceanDNA-b515,1005,15.3,0.0,5.1e-07,0.0013,108,148,7,49,1,87,0.83,40,42,86
OceanDNA-b4488,407,7.1,0.1,0.00048,0.43,122,156,94,129,80,136,0.83,34,35,56
OceanDNA-b26756,121,15.7,0.0,3.9e-07,0.00053,118,145,138,165,122,179,0.83,27,27,57
OceanDNA-b46557,381,10.5,0.0,3e-05,0.0071,120,164,127,171,63,179,0.83,44,44,116
OceanDNA-b4058,514,20.4,0.0,2.9e-08,1e-05,66,178,117,239,83,287,0.83,112,122,204
OceanDNA-b30115,454,5.1,0.1,0.0007,1.8,121,150,126,155,105,170,0.83,29,29,65
OceanDNA-b22448,1490,10.4,0.0,1.7e-05,0.025,114,157,22,65,9,72,0.83,43,43,63
OceanDNA-b35493,143,15.2,0.0,5.4e-07,0.00012,116,180,108,175,16,215,0.83,64,67,199
OceanDNA-b17572,742,7.1,0.0,0.00016,0.16,120,156,6,42,2,48,0.83,36,36,46
OceanDNA-b23839,428,12.4,0.0,3.9e-06,0.004,119,145,242,268,225,281,0.83,26,26,56
OceanDNA-b23644,7,12.1,0.0,5.1e-06,0.013,121,152,186,217,168,253,0.83,31,31,85
OceanDNA-b1353,3339,-3.9,0.0,1.1,1500.0,120,137,295,312,294,315,0.83,17,17,21
OceanDNA-b22396,1374,16.4,0.0,2.4e-07,0.00065,111,157,211,257,197,263,0.83,46,46,66
OceanDNA-b6424,614,58.7,0.0,9e-20,1.9e-17,18,124,42,154,29,155,0.83,106,112,126
OceanDNA-b20674,70,49.0,0.0,2.7e-17,8.1e-15,21,154,72,212,68,219,0.83,133,140,151
OceanDNA-b36577,1192,8.4,0.0,0.00014,0.13,148,184,229,265,209,282,0.83,36,36,73
OceanDNA-b46763,1616,13.3,0.0,2.1e-06,0.0053,119,165,145,192,130,244,0.83,46,47,114
OceanDNA-b11496,91,-0.1,0.0,0.027,11.0,119,147,182,210,168,238,0.83,28,28,70
OceanDNA-b6424,505,10.5,0.0,4.4e-05,0.0091,121,150,70,99,55,111,0.83,29,29,56
OceanDNA-b13570,390,19.8,0.0,4.4e-08,2.9e-05,57,142,22,105,10,123,0.83,85,83,113
OceanDNA-b13086,1080,11.5,0.0,7.3e-06,0.018,113,169,226,280,217,294,0.83,56,54,77
OceanDNA-b289,3696,14.1,0.0,2.5e-06,0.0048,160,206,184,228,174,237,0.83,46,44,63
OceanDNA-b22415,436,-2.9,0.0,0.18,480.0,237,254,309,326,306,328,0.83,17,17,22
OceanDNA-b22840,3847,-0.5,0.0,0.067,140.0,69,87,174,192,148,198,0.83,18,18,50
OceanDNA-b46829,980,-1.0,0.0,0.05,97.0,143,165,362,385,357,391,0.83,22,23,34
OceanDNA-b10067,117,11.1,0.0,1e-05,0.0048,163,229,615,683,596,685,0.83,66,68,89
OceanDNA-b22077,185,9.4,0.1,3.3e-05,0.045,117,144,176,203,163,218,0.83,27,27,55
OceanDNA-b34944,273,12.2,0.0,4.7e-06,0.0034,163,229,542,610,506,612,0.83,66,68,106
OceanDNA-b3676,275,6.0,0.1,0.00037,1.1,126,152,135,161,112,180,0.83,26,26,68
OceanDNA-b24045,2236,12.4,0.0,7.7e-06,0.01,122,150,68,96,48,107,0.83,28,28,59
OceanDNA-b517,1813,14.6,0.0,8.4e-07,0.0033,119,150,228,259,215,266,0.83,31,31,51
OceanDNA-b23559,253,18.4,0.0,5.9e-08,9.4e-05,98,147,127,173,65,183,0.83,49,46,118
OceanDNA-b45372,298,12.2,0.0,4.4e-06,0.0035,116,150,129,163,110,201,0.83,34,34,91
OceanDNA-b32762,963,23.3,0.1,1.9e-09,3e-06,49,164,61,180,12,185,0.83,115,119,173
OceanDNA-b23556,1878,15.6,0.2,8.7e-07,0.001,117,152,255,290,242,303,0.83,35,35,61
OceanDNA-b10067,117,1.4,0.0,0.009,4.2,117,155,534,572,520,582,0.83,38,38,62
OceanDNA-b15801,1332,13.2,0.1,4.6e-06,0.0034,117,145,128,156,95,167,0.83,28,28,72
OceanDNA-b46695,1303,16.4,0.0,1.2e-06,0.00052,98,150,131,178,116,189,0.83,52,47,73
OceanDNA-b46695,1180,39.7,0.0,9.4e-14,4.1e-11,118,208,150,243,135,256,0.83,90,93,121
OceanDNA-b34923,521,0.9,0.0,0.013,10.0,119,143,148,172,93,186,0.83,24,24,93
OceanDNA-b33194,434,6.6,0.0,0.00024,0.25,117,143,201,227,185,244,0.83,26,26,59
OceanDNA-b31695,307,12.1,0.0,4.9e-06,0.0092,117,148,545,576,485,600,0.83,31,31,115
OceanDNA-b22498,2720,1.8,0.0,0.013,21.0,70,88,168,186,150,191,0.83,18,18,41
OceanDNA-b16139,377,6.9,0.0,0.00038,0.16,95,140,324,367,315,377,0.83,45,43,62
OceanDNA-b11842,884,42.5,0.1,2.6e-15,3.1e-12,59,207,89,241,79,251,0.83,148,152,172
OceanDNA-b6504,238,11.7,0.1,6.6e-06,0.0034,138,199,192,253,187,278,0.83,61,61,91
OceanDNA-b26816,500,9.4,1.0,3.2e-05,0.1,89,152,418,480,410,487,0.83,63,62,77
OceanDNA-b30773,857,8.7,0.0,5.2e-05,0.15,159,231,244,314,233,320,0.83,72,70,87
OceanDNA-a1153,65,12.1,0.0,5e-06,0.00077,156,229,226,298,214,303,0.83,73,72,89
OceanDNA-b3980,783,14.6,0.0,1.7e-06,0.001,104,149,47,92,30,103,0.83,45,45,73
OceanDNA-b22922,367,12.6,0.0,7.1e-06,0.0059,117,154,225,261,195,344,0.83,37,36,149
OceanDNA-b20109,173,2.8,0.0,0.0035,1.4,47,85,133,171,89,185,0.83,38,38,96
OceanDNA-b41214,2347,0.5,0.0,0.016,63.0,119,149,86,116,53,149,0.83,30,30,96
OceanDNA-b29538,190,10.4,0.0,1.6e-05,0.033,53,153,54,157,23,177,0.83,100,103,154
OceanDNA-b22922,715,12.3,0.0,8.5e-06,0.0071,117,212,172,268,116,292,0.83,95,96,176
OceanDNA-b20495,104,51.8,0.0,3.7e-18,7.8e-16,35,155,87,212,64,223,0.83,120,125,159
OceanDNA-b45598,209,10.7,0.0,1.3e-05,0.007,122,171,333,382,298,388,0.83,49,49,90
OceanDNA-b4587,117,14.5,0.1,9.2e-07,0.00064,152,232,181,259,160,283,0.83,80,78,123
OceanDNA-b30215,1298,14.7,0.0,2.4e-06,0.0014,119,144,172,197,168,224,0.83,25,25,56
OceanDNA-a1686,137,11.0,0.0,1e-05,0.0026,119,183,186,252,172,262,0.83,64,66,90
OceanDNA-b45220,1971,1.5,0.0,0.0083,32.0,161,185,237,261,212,280,0.83,24,24,68
OceanDNA-b6771,196,9.7,0.1,8.1e-05,0.025,139,215,219,293,212,301,0.83,76,74,89
OceanDNA-b23832,1041,13.9,0.0,1.4e-06,0.0024,119,148,144,172,127,190,0.83,29,28,63
OceanDNA-b31120,118,11.1,0.0,3e-05,0.011,125,146,146,167,127,187,0.83,21,21,60
OceanDNA-b10381,264,11.4,0.2,8.1e-06,0.0029,163,229,400,468,338,470,0.83,66,68,132
OceanDNA-b33308,960,11.0,0.0,2.1e-05,0.034,119,145,160,186,148,198,0.83,26,26,50
OceanDNA-b38915,32,12.6,0.0,3.4e-06,0.0018,90,151,92,145,72,173,0.83,61,53,101
OceanDNA-b20349,336,41.3,0.0,6.2e-15,2.6e-12,33,139,70,181,51,202,0.83,106,111,151
OceanDNA-b36897,631,14.6,0.0,8.4e-07,0.001,120,150,140,170,135,178,0.83,30,30,43
OceanDNA-b45499,524,2.6,0.0,0.0038,4.3,161,226,206,268,198,272,0.83,65,62,74
OceanDNA-b17160,71,16.6,0.0,2.1e-07,3.9e-05,105,156,281,332,271,356,0.83,51,51,85
OceanDNA-b15134,83,10.2,0.0,3.8e-05,0.0058,122,162,124,164,98,177,0.83,40,40,79
OceanDNA-b24941,2495,8.0,0.1,0.00017,0.24,118,150,133,165,121,172,0.83,32,32,51
OceanDNA-b31115,642,11.9,0.0,5.7e-06,0.0046,96,174,3,79,1,105,0.83,78,76,104
OceanDNA-b22944,383,10.5,0.0,1.5e-05,0.063,112,144,295,327,276,336,0.83,32,32,60
OceanDNA-b20726,68,36.4,0.0,1.9e-13,3.2e-11,39,154,81,205,61,211,0.83,115,124,150
OceanDNA-b20911,6686,12.4,0.0,8.2e-06,0.029,90,144,103,151,69,164,0.83,54,48,95
OceanDNA-b46303,3235,18.6,0.0,1e-07,0.00018,115,153,176,215,165,236,0.83,38,39,71
OceanDNA-b10383,74,-3.0,0.1,0.2,68.0,21,48,139,166,136,172,0.83,27,27,36
OceanDNA-b37345,482,-1.2,0.0,0.17,79.0,121,161,159,199,139,204,0.83,40,40,65
OceanDNA-b5161,252,-0.3,0.0,0.03,8.5,156,182,208,234,200,257,0.83,26,26,57
OceanDNA-b3605,370,16.4,0.0,4.9e-07,0.00049,118,180,151,212,109,221,0.83,62,61,112
OceanDNA-b22613,197,11.9,0.0,5.6e-06,0.019,108,150,272,314,263,357,0.83,42,42,94
OceanDNA-b40235,671,15.9,0.0,3.4e-07,0.00025,119,146,150,177,143,195,0.83,27,27,52
OceanDNA-b4159,28,18.1,0.0,7.3e-08,3.4e-05,69,155,88,178,80,181,0.83,86,90,101
OceanDNA-b17035,8,16.5,0.0,2.3e-07,0.00022,101,152,129,178,106,219,0.83,51,49,113
OceanDNA-b20982,1046,6.5,0.0,0.00025,0.76,144,177,236,269,214,287,0.83,33,33,73
OceanDNA-b26781,497,5.9,0.1,0.00074,0.65,121,150,162,191,149,201,0.83,29,29,52
OceanDNA-b13103,517,11.7,0.0,1.3e-05,0.006,59,151,719,806,702,826,0.83,92,87,124
OceanDNA-b6501,409,1.1,0.0,0.033,5.6,159,222,371,434,349,437,0.83,63,63,88
OceanDNA-b40523,459,13.9,0.0,1.4e-06,0.0015,123,148,151,176,141,192,0.83,25,25,51
OceanDNA-b30082,342,11.6,0.0,6.8e-06,0.012,119,144,164,189,155,227,0.83,25,25,72
OceanDNA-b22398,2035,5.1,0.0,0.002,2.0,162,230,346,414,328,417,0.83,68,68,89
OceanDNA-b15539,807,16.6,0.0,2.2e-07,0.00035,117,156,8,47,5,68,0.83,39,39,63
OceanDNA-b46316,649,14.2,1.2,1.2e-06,0.0024,138,196,17,75,6,97,0.83,58,58,91
OceanDNA-b23169,959,19.7,0.0,2.3e-08,5.3e-05,109,187,206,280,188,367,0.83,78,74,179
OceanDNA-b13836,229,5.6,0.0,0.00049,0.14,116,154,502,540,487,556,0.83,38,38,69
OceanDNA-b40249,8,22.6,0.0,3.1e-09,2.2e-06,118,147,150,179,130,197,0.83,29,29,67
OceanDNA-b42035,172,12.3,0.0,4.2e-06,0.001,111,197,168,259,159,287,0.83,86,91,128
OceanDNA-b24235,159,14.4,0.0,9.9e-07,0.00036,119,150,147,178,118,191,0.83,31,31,73
OceanDNA-b20148,305,12.7,0.0,3.2e-06,0.0013,91,156,215,282,208,288,0.83,65,67,80
OceanDNA-b28583,702,0.6,0.0,0.016,15.0,153,194,240,281,225,292,0.83,41,41,67
OceanDNA-b22383,363,11.8,0.0,1.2e-05,0.021,107,153,135,182,128,191,0.83,46,47,63
OceanDNA-b46296,2016,13.9,0.1,1.4e-06,0.0039,116,149,204,237,185,250,0.83,33,33,65
OceanDNA-b4297,78,12.7,0.0,3.3e-06,0.00093,163,229,600,668,591,670,0.83,66,68,79
OceanDNA-b21004,1385,4.3,0.0,0.0035,2.2,166,210,333,375,305,386,0.83,44,42,81
OceanDNA-b36729,927,-2.3,0.0,0.12,270.0,96,111,54,69,50,72,0.83,15,15,22
OceanDNA-b43874,51,17.0,0.0,1.5e-07,8.9e-05,118,145,140,167,111,184,0.83,27,27,73
OceanDNA-b22348,719,11.8,0.0,1.2e-05,0.0069,117,148,131,162,115,178,0.83,31,31,63
OceanDNA-b27542,367,10.9,0.5,3.4e-05,0.025,41,153,63,182,58,199,0.83,112,119,141
OceanDNA-b42457,210,11.7,0.0,6.7e-06,0.0021,124,155,138,169,106,192,0.83,31,31,86
OceanDNA-b16208,255,16.0,0.0,3.2e-07,0.00036,53,107,289,341,273,399,0.83,54,52,126
OceanDNA-b22835,3165,11.6,0.1,7.1e-06,0.026,117,147,269,299,255,306,0.83,30,30,51
OceanDNA-b20043,202,-2.8,0.0,0.34,56.0,5,32,50,77,47,90,0.83,27,27,43
OceanDNA-b10045,116,12.9,0.0,2.7e-06,0.0012,163,229,615,683,605,685,0.83,66,68,80
OceanDNA-b19701,291,-2.2,0.0,0.22,45.0,51,83,222,254,216,258,0.83,32,32,42
OceanDNA-b36441,2119,1.9,0.0,0.013,18.0,115,140,128,153,114,164,0.83,25,25,50
OceanDNA-b38880,867,1.4,0.1,0.018,8.5,149,176,187,214,166,221,0.83,27,27,55
OceanDNA-b22504,1295,13.4,0.0,5.8e-06,0.0056,105,152,379,428,368,455,0.83,47,49,87
OceanDNA-b3653,1280,8.3,0.0,0.00021,0.16,197,230,236,270,218,282,0.83,33,34,64
OceanDNA-b27605,1123,12.7,0.1,3.3e-06,0.0073,113,151,49,87,21,92,0.83,38,38,71
OceanDNA-b23817,324,10.2,0.1,3.9e-05,0.03,117,156,106,146,86,154,0.83,39,40,68
OceanDNA-b11500,110,0.7,0.0,0.015,5.8,119,147,180,208,164,222,0.83,28,28,58
OceanDNA-b22808,143,20.6,0.0,1.2e-08,5.2e-05,108,153,96,136,79,143,0.83,45,40,64
OceanDNA-b7645,100,10.4,0.0,1.6e-05,0.0029,102,152,156,208,147,232,0.83,50,52,85
OceanDNA-b22533,692,36.4,0.0,1.9e-13,2.6e-10,118,210,158,254,144,264,0.83,92,96,120
OceanDNA-b32139,30,0.4,0.0,0.037,43.0,197,229,253,286,212,289,0.83,32,33,77
OceanDNA-b21342,331,9.8,0.0,2.5e-05,0.012,117,150,124,157,102,164,0.83,33,33,62
OceanDNA-b34767,496,17.6,0.0,2.1e-07,9.4e-05,98,159,111,171,33,181,0.83,61,60,148
OceanDNA-b29386,888,13.0,0.0,5.4e-06,0.0051,92,150,117,174,77,186,0.83,58,57,109
OceanDNA-b22507,1506,11.1,0.0,2e-05,0.029,107,156,261,310,253,318,0.83,49,49,65
OceanDNA-b28583,702,10.8,0.0,1.2e-05,0.011,117,145,119,147,83,160,0.83,28,28,77
OceanDNA-b17548,274,8.9,0.0,4.7e-05,0.084,97,154,219,278,205,288,0.83,57,59,83
OceanDNA-b7448,59,7.2,0.0,0.00015,0.1,162,232,191,259,181,278,0.83,70,68,97
OceanDNA-b34788,303,12.3,0.2,4.3e-06,0.0027,121,150,158,187,136,195,0.83,29,29,59
OceanDNA-b16777,43,-3.4,0.0,0.79,770.0,24,45,347,368,344,376,0.83,21,21,32
OceanDNA-b40237,535,15.1,0.0,6.1e-07,0.00045,119,146,148,175,142,193,0.83,27,27,51
OceanDNA-b15453,1319,14.0,0.1,2.6e-06,0.0029,53,145,293,382,265,422,0.83,92,89,157
OceanDNA-b26636,3711,9.1,0.0,4.2e-05,0.16,96,133,152,189,132,189,0.83,37,37,57
OceanDNA-b22827,3176,11.4,0.4,3.2e-05,0.04,78,172,28,118,14,130,0.83,94,90,116
OceanDNA-b11517,108,12.5,0.1,3.8e-06,0.0018,117,195,172,250,147,288,0.83,78,78,141
OceanDNA-b40669,87,2.1,0.0,0.011,3.6,125,150,145,170,126,204,0.83,25,25,78
OceanDNA-b37351,1051,9.9,0.0,2.3e-05,0.029,162,228,620,688,610,689,0.83,66,68,79
OceanDNA-b32084,461,12.7,0.0,6.4e-06,0.01,120,144,143,167,133,180,0.83,24,24,47
OceanDNA-b34805,485,12.4,0.0,3.9e-06,0.0023,163,229,624,692,586,697,0.83,66,68,111
OceanDNA-b36617,25,10.6,0.0,1.5e-05,0.014,124,159,198,233,160,257,0.83,35,35,97
OceanDNA-b26769,766,6.6,0.0,0.00024,0.48,161,182,244,265,239,277,0.83,21,21,38
OceanDNA-b32143,845,11.2,0.0,2.8e-05,0.019,111,152,204,245,183,274,0.83,41,41,91
OceanDNA-b2939,88,0.3,0.0,0.02,5.7,192,218,249,276,228,283,0.83,26,27,55
OceanDNA-b6753,128,-1.0,0.0,0.05,31.0,208,233,609,634,603,643,0.83,25,25,40
OceanDNA-b46656,646,12.6,0.1,1.4e-05,0.012,112,159,227,274,216,279,0.83,47,47,63
OceanDNA-b22805,5940,12.5,0.0,7.2e-06,0.024,118,154,181,218,166,233,0.83,36,37,67
OceanDNA-b20668,130,46.8,0.1,2.6e-16,3.6e-14,20,154,65,206,62,213,0.83,134,141,151
OceanDNA-b27570,1226,12.3,0.2,8.7e-06,0.012,49,147,88,189,68,217,0.83,98,101,149
OceanDNA-b7949,171,10.0,0.0,2.1e-05,0.0066,103,152,111,158,100,173,0.83,49,47,73
OceanDNA-b3887,273,15.0,0.0,6.3e-07,0.00054,118,180,178,243,152,265,0.82,62,65,113
OceanDNA-b16160,304,12.4,0.0,4.1e-06,0.0033,39,150,19,134,5,142,0.82,111,115,137
OceanDNA-b37440,137,13.0,0.0,2.7e-06,0.0022,69,140,189,261,171,278,0.82,71,72,107
OceanDNA-b22460,1842,-1.1,0.0,0.1,180.0,102,157,87,141,81,156,0.82,55,54,75
OceanDNA-b47081,476,19.3,0.0,6.4e-08,1.9e-05,114,158,250,294,233,307,0.82,44,44,74
OceanDNA-b35035,642,10.8,0.1,2.5e-05,0.0099,106,147,63,104,42,124,0.82,41,41,82
OceanDNA-b21437,139,4.9,0.0,0.00077,0.17,157,185,175,203,164,238,0.82,28,28,74
OceanDNA-b3594,247,45.0,0.0,4.5e-16,4.8e-13,50,209,121,286,100,295,0.82,159,165,195
OceanDNA-b22842,3424,13.7,0.0,3.3e-06,0.0075,113,176,547,615,501,624,0.82,63,68,123
OceanDNA-b22842,1272,0.8,0.0,0.028,64.0,163,184,378,399,364,415,0.82,21,21,51
OceanDNA-b17770,189,11.1,0.0,9.8e-06,0.0029,42,148,20,132,14,140,0.82,106,112,126
OceanDNA-b7018,34,10.6,0.0,1.4e-05,0.0054,163,227,610,676,585,679,0.82,64,66,94
OceanDNA-b22827,1232,10.7,0.0,5.3e-05,0.067,117,144,222,249,204,258,0.82,27,27,54
OceanDNA-b22542,190,12.3,0.0,4.2e-06,0.0034,112,158,99,145,87,167,0.82,46,46,80
OceanDNA-b2809,605,10.7,0.1,1.4e-05,0.027,108,152,127,171,107,177,0.82,44,44,70
OceanDNA-b25087,664,11.5,0.0,7.3e-06,0.0056,39,151,33,150,21,156,0.82,112,117,135
OceanDNA-b38370,238,73.2,0.0,1.1e-24,1.8e-21,18,240,34,266,27,278,0.82,222,232,251
OceanDNA-b34674,221,33.4,0.0,1.6e-12,9.6e-10,31,139,133,255,118,267,0.82,108,122,149
OceanDNA-b6298,319,10.9,0.0,2.4e-05,0.0049,114,150,78,114,49,124,0.82,36,36,75
OceanDNA-b39489,22,-2.7,0.1,0.17,120.0,84,113,453,480,446,487,0.82,29,27,41
OceanDNA-b34187,445,10.9,0.3,1.1e-05,0.0051,26,100,35,111,26,197,0.82,74,76,171
OceanDNA-b26586,900,7.7,0.0,0.00011,0.1,121,160,140,179,105,203,0.82,39,39,98
OceanDNA-b44367,149,11.5,0.0,7.3e-06,0.0023,117,143,164,190,140,203,0.82,26,26,63
OceanDNA-b23524,1143,15.2,0.0,1.6e-06,0.00078,108,144,130,168,115,184,0.82,36,38,69
OceanDNA-b46733,84,12.0,0.0,5.4e-06,0.0094,119,159,136,177,119,234,0.82,40,41,115
OceanDNA-b7010,63,10.6,0.0,2.7e-05,0.0058,163,227,610,676,585,679,0.82,64,66,94
OceanDNA-b22348,286,44.5,0.0,1.3e-15,7.3e-13,117,217,149,255,135,266,0.82,100,106,131
OceanDNA-b45790,316,8.6,0.0,5.6e-05,0.023,159,226,213,277,207,281,0.82,67,64,74
OceanDNA-b38999,1473,11.9,0.0,5.5e-06,0.012,71,152,149,241,118,304,0.82,81,92,186
OceanDNA-b9835,190,14.1,0.0,1.2e-06,0.00036,107,154,69,114,47,127,0.82,47,45,80
OceanDNA-b36415,378,9.4,0.0,3.3e-05,0.051,115,151,112,148,13,157,0.82,36,36,144
OceanDNA-b40467,425,9.0,0.1,0.00013,0.069,49,94,248,293,241,305,0.82,45,45,64
OceanDNA-b46534,918,16.5,0.0,2.3e-07,0.00034,103,151,123,169,111,184,0.82,48,46,73
OceanDNA-b13830,55,10.4,0.0,3.3e-05,0.0041,102,150,210,252,201,263,0.82,48,42,62
OceanDNA-b41349,857,96.6,0.0,1.6e-31,9.9e-29,31,239,72,291,48,305,0.82,208,219,257
OceanDNA-b13830,31,6.5,0.0,0.00051,0.064,162,193,251,281,232,291,0.82,31,30,59
OceanDNA-b6504,238,2.7,0.0,0.0037,1.9,122,145,93,116,79,187,0.82,23,23,108
OceanDNA-b30783,1420,16.7,0.0,2e-07,0.00028,115,167,99,151,78,194,0.82,52,52,116
OceanDNA-b17210,56,13.7,0.0,1.6e-06,0.0018,118,162,126,170,37,175,0.82,44,44,138
OceanDNA-b13830,31,7.8,0.0,0.0002,0.026,112,154,165,208,147,225,0.82,42,43,78
OceanDNA-b35148,1840,24.5,0.1,8.1e-10,1.7e-06,40,151,88,205,49,217,0.82,111,117,168
OceanDNA-b10097,427,11.7,0.0,6.7e-06,0.0061,44,141,53,153,27,164,0.82,97,100,137
OceanDNA-b46717,1168,12.6,0.0,6.7e-06,0.012,119,165,145,192,131,244,0.82,46,47,113
OceanDNA-b6295,384,15.1,0.0,6e-07,0.00029,163,230,465,534,453,535,0.82,67,69,82
OceanDNA-b22378,991,4.5,0.0,0.0021,2.1,164,228,243,307,227,314,0.82,64,64,87
OceanDNA-b30787,852,17.8,0.1,8.9e-08,9.1e-05,42,150,28,142,9,153,0.82,108,114,144
OceanDNA-b24117,2173,9.0,0.0,8.9e-05,0.12,148,182,187,222,160,250,0.82,34,35,90
OceanDNA-b9609,10,16.5,0.0,2.3e-07,7.2e-05,116,156,136,179,127,187,0.82,40,43,60
OceanDNA-b23484,982,12.0,0.0,1.1e-05,0.0092,118,153,90,125,70,168,0.82,35,35,98
OceanDNA-b44515,264,10.9,0.0,1.2e-05,0.0034,117,155,111,149,89,192,0.82,38,38,103
OceanDNA-b39756,387,17.2,0.1,2.8e-07,5.8e-05,119,148,143,172,126,245,0.82,29,29,119
OceanDNA-b23145,1394,15.8,0.0,7.1e-07,0.00075,109,160,146,197,127,248,0.82,51,51,121
OceanDNA-b18473,63,-1.8,0.0,0.083,39.0,51,83,218,250,211,253,0.82,32,32,42
OceanDNA-b7917,251,13.4,0.0,2e-06,0.00053,103,152,31,78,19,90,0.82,49,47,71
OceanDNA-b11455,288,0.1,0.0,0.022,17.0,163,192,385,414,365,443,0.82,29,29,78
OceanDNA-b20105,218,33.0,0.0,2.1e-12,9.3e-10,121,211,162,263,70,271,0.82,90,101,201
OceanDNA-b23372,240,16.0,0.1,6.4e-07,0.00078,63,148,99,182,90,189,0.82,85,83,99
OceanDNA-b26571,659,13.3,0.0,4.3e-06,0.0017,39,151,33,150,24,157,0.82,112,117,133
OceanDNA-b231,9,23.8,0.0,1.3e-09,1.2e-06,115,210,117,213,86,223,0.82,95,96,137
OceanDNA-b30021,940,10.2,0.1,1.9e-05,0.035,161,231,207,275,198,278,0.82,70,68,80
OceanDNA-b9617,142,11.6,0.1,7e-06,0.0017,117,145,95,123,82,133,0.82,28,28,51
OceanDNA-b20559,114,1.0,0.0,0.012,3.6,43,85,131,175,126,189,0.82,42,44,63
OceanDNA-b24073,156,2.2,0.0,0.0053,4.7,3,38,39,74,37,94,0.82,35,35,57
OceanDNA-b3338,800,8.8,0.0,0.0001,0.18,39,86,139,190,115,197,0.82,47,51,82
OceanDNA-b22762,537,12.8,0.0,3.1e-06,0.0093,88,160,863,937,856,942,0.82,72,74,86
OceanDNA-b24894,844,10.4,0.0,1.6e-05,0.026,126,160,114,149,109,164,0.82,34,35,55
OceanDNA-b34725,188,3.4,0.0,0.0022,1.5,163,211,565,613,557,634,0.82,48,48,77
OceanDNA-b30044,1624,27.6,0.0,9e-11,1.5e-07,48,146,28,132,15,139,0.82,98,104,124
OceanDNA-b211,220,12.7,0.0,3.2e-06,0.003,113,154,133,175,95,185,0.82,41,42,90
OceanDNA-b20894,3731,2.7,0.0,0.0037,16.0,125,157,118,151,101,162,0.82,32,33,61
OceanDNA-b29510,997,28.4,0.3,1.5e-10,1.3e-07,44,146,56,165,23,197,0.82,102,109,174
OceanDNA-b8205,133,0.4,0.0,0.018,3.9,210,256,286,334,263,339,0.82,46,48,76
OceanDNA-b45,2039,-1.7,0.0,0.083,300.0,108,130,45,67,36,85,0.82,22,22,49
OceanDNA-b3670,249,10.6,0.0,1.4e-05,0.011,163,229,621,689,608,693,0.82,66,68,85
OceanDNA-b22997,745,12.4,0.0,7.9e-06,0.004,102,147,134,176,125,239,0.82,45,42,114
OceanDNA-b27576,2547,10.9,0.0,1.1e-05,0.03,97,187,118,214,108,239,0.82,90,96,131
OceanDNA-b4143,1413,10.6,0.0,4.1e-05,0.022,161,231,194,262,164,268,0.82,70,68,104
OceanDNA-b36891,1423,16.9,0.0,1.7e-07,0.00032,120,145,45,70,38,85,0.82,25,25,47
OceanDNA-b41544,516,2.1,0.0,0.0056,6.2,197,236,257,297,237,315,0.82,39,40,78
OceanDNA-b22117,2422,16.3,0.0,2.6e-07,0.00072,102,166,175,233,165,248,0.82,64,58,83
OceanDNA-b37345,482,11.0,0.0,3.3e-05,0.015,162,209,264,309,238,331,0.82,47,45,93
OceanDNA-b23088,2456,11.0,0.0,2.2e-05,0.043,120,151,159,190,139,214,0.82,31,31,75
OceanDNA-b5405,23,55.7,0.0,2.5e-19,2.4e-16,41,215,69,258,36,262,0.82,174,189,226
OceanDNA-b17550,544,14.5,0.0,8.9e-07,0.001,106,184,151,232,142,240,0.82,78,81,98
OceanDNA-b31526,385,14.5,0.0,2.7e-06,0.00093,162,221,308,367,291,378,0.82,59,59,87
OceanDNA-b8783,80,19.9,0.0,2.1e-08,3.7e-06,116,158,203,247,191,292,0.82,42,44,101
OceanDNA-b46972,580,14.0,0.0,2.5e-06,0.00098,118,153,233,269,214,285,0.82,35,36,71
OceanDNA-b4290,7,20.3,0.0,1.6e-08,3.9e-06,163,222,116,175,97,186,0.82,59,59,89
OceanDNA-b39196,629,12.6,0.0,3.4e-06,0.0025,121,146,159,184,138,199,0.82,25,25,61
OceanDNA-b45445,755,12.4,0.0,3.9e-06,0.0068,118,145,129,156,113,207,0.82,27,27,94
OceanDNA-b22943,3679,11.6,0.0,1.4e-05,0.026,102,145,222,265,203,279,0.82,43,43,76
OceanDNA-b38518,147,0.4,0.0,0.036,17.0,151,183,258,290,240,295,0.82,32,32,55
OceanDNA-b10080,169,0.9,0.0,0.025,12.0,159,180,204,225,191,241,0.82,21,21,50
OceanDNA-b22767,1464,13.4,0.0,1.9e-06,0.0053,113,154,149,191,133,207,0.82,41,42,74
OceanDNA-b24941,1854,12.5,0.0,7.3e-06,0.01,121,152,106,137,73,143,0.82,31,31,70
OceanDNA-b3313,1278,16.9,0.1,1.7e-07,0.00051,32,150,99,208,76,216,0.82,118,109,140
OceanDNA-b24117,2173,2.9,0.0,0.0065,8.6,123,146,88,111,81,122,0.82,23,23,41
OceanDNA-b38586,338,21.8,0.0,5.5e-09,3.1e-06,40,151,41,163,15,194,0.82,111,122,179
OceanDNA-b13084,750,-2.8,0.0,0.36,450.0,117,139,359,381,357,400,0.82,22,22,43
OceanDNA-b1863,352,13.3,0.0,2.2e-06,0.00096,45,141,57,158,29,182,0.82,96,101,153
OceanDNA-b42626,228,8.9,0.0,4.8e-05,0.012,156,184,199,227,187,245,0.82,28,28,58
OceanDNA-b17187,892,-3.3,0.0,0.24,240.0,167,188,138,159,136,164,0.82,21,21,28
OceanDNA-b6569,149,11.7,0.0,1.3e-05,0.0056,163,230,668,737,658,741,0.82,67,69,83
OceanDNA-b7639,155,12.8,0.0,3.1e-06,0.00099,111,155,111,155,87,169,0.82,44,44,82
OceanDNA-b27549,1961,8.2,0.2,0.00015,0.16,126,161,107,146,100,151,0.82,35,39,51
OceanDNA-b44624,60,-2.7,0.0,0.17,350.0,233,249,32,48,29,59,0.82,16,16,30
OceanDNA-b3982,297,12.3,0.0,8.4e-06,0.0025,167,230,193,254,171,268,0.82,63,61,97
OceanDNA-b20668,130,9.1,0.0,8.3e-05,0.011,185,241,261,317,233,335,0.82,56,56,102
OceanDNA-b13281,1799,17.3,0.0,1.2e-07,0.00023,118,155,115,152,58,194,0.82,37,37,136
OceanDNA-b23149,1687,12.3,0.0,8.8e-06,0.0078,104,152,128,175,123,207,0.82,48,47,84
OceanDNA-b19769,209,21.8,0.0,1.1e-08,2.6e-06,117,204,136,224,123,243,0.82,87,88,120
OceanDNA-b22322,1513,12.6,0.0,7.1e-06,0.014,98,152,203,253,183,299,0.82,54,50,116
OceanDNA-b20109,173,9.7,0.0,2.7e-05,0.011,92,156,212,278,200,289,0.82,64,66,89
OceanDNA-b30785,605,-3.1,0.0,0.22,310.0,162,184,695,718,692,723,0.82,22,23,31
OceanDNA-b23415,1001,10.7,0.0,1.3e-05,0.028,124,152,213,241,201,252,0.82,28,28,51
OceanDNA-b13250,797,40.4,0.1,1.2e-13,4.7e-11,73,193,105,224,61,242,0.82,120,119,181
OceanDNA-b16127,236,5.1,0.0,0.0014,0.43,100,143,113,154,102,171,0.82,43,41,69
OceanDNA-b13585,820,-0.2,0.0,0.11,41.0,167,195,180,207,174,235,0.82,28,27,61
OceanDNA-a2154,360,12.3,0.0,4.4e-06,0.0018,112,143,111,142,86,156,0.82,31,31,70
OceanDNA-b4344,7,18.8,0.0,4.6e-08,1.1e-05,163,229,604,672,594,675,0.82,66,68,81
OceanDNA-b22759,861,15.3,0.0,1e-06,0.00051,118,167,160,210,143,224,0.82,49,50,81
OceanDNA-b36862,966,17.8,0.0,8.9e-08,9.9e-05,117,152,175,210,130,280,0.82,35,35,150
OceanDNA-b22481,2461,14.7,0.2,7.7e-07,0.0027,86,158,157,232,148,238,0.82,72,75,90
OceanDNA-b45584,658,17.6,0.0,1.1e-07,0.00014,104,158,111,165,95,174,0.82,54,54,79
OceanDNA-b40453,373,15.0,0.0,1.3e-06,0.0008,111,149,196,234,152,255,0.82,38,38,103
OceanDNA-b937,2162,10.4,0.0,1.6e-05,0.035,146,213,192,256,158,265,0.82,67,64,107
OceanDNA-b19825,42,24.2,0.0,1e-09,5.1e-07,118,188,156,228,139,248,0.82,70,72,109
OceanDNA-b31120,370,11.4,0.0,2.4e-05,0.0085,123,150,83,110,37,143,0.82,27,27,106
OceanDNA-b27586,1040,11.4,0.1,7.8e-06,0.016,125,149,182,206,167,222,0.82,24,24,55
OceanDNA-b22797,238,16.8,0.0,3.5e-07,0.00023,54,157,171,273,159,331,0.82,103,102,172
OceanDNA-b3972,234,13.6,0.0,1.7e-06,0.0011,56,190,96,227,92,241,0.82,134,131,149
OceanDNA-b30842,113,10.6,0.0,1.4e-05,0.0081,121,145,146,170,125,187,0.82,24,24,62
OceanDNA-b1836,2872,5.5,0.0,0.00052,1.8,141,184,283,326,275,359,0.82,43,43,84
OceanDNA-b22800,1598,12.6,0.0,3.6e-06,0.0061,95,145,239,289,211,303,0.82,50,50,92
OceanDNA-b20097,206,-1.7,0.0,0.24,24.0,65,89,185,208,180,213,0.82,24,23,33
OceanDNA-b23153,73,-2.6,0.0,0.16,410.0,215,246,330,361,319,364,0.82,31,31,45
OceanDNA-b9684,662,-2.6,0.0,0.15,110.0,163,180,208,225,200,234,0.82,17,17,34
OceanDNA-b20491,297,41.5,0.0,1.1e-14,1.8e-12,27,168,65,211,48,216,0.82,141,146,168
OceanDNA-b9684,662,10.4,0.1,1.6e-05,0.012,113,156,79,123,70,132,0.82,43,44,62
OceanDNA-b33331,208,14.4,0.0,2e-06,0.0016,119,146,140,168,124,186,0.82,27,28,62
OceanDNA-b16227,638,21.3,0.0,2.3e-08,8e-06,102,151,140,183,107,200,0.82,49,43,93
OceanDNA-b17083,134,2.3,0.0,0.0047,4.6,163,182,238,257,227,288,0.82,19,19,61
OceanDNA-b9797,260,3.3,0.0,0.0024,1.2,110,154,122,166,101,182,0.82,44,44,81
OceanDNA-b22391,1504,13.1,0.0,7.3e-06,0.0045,102,146,438,482,427,498,0.82,44,44,71
OceanDNA-b16777,232,0.9,0.0,0.04,39.0,116,142,157,183,143,198,0.82,26,26,55
OceanDNA-b28321,428,11.5,0.0,7.4e-06,0.0035,119,144,2,27,1,53,0.82,25,25,52
OceanDNA-b15480,240,13.3,0.0,2.1e-06,0.0011,161,208,207,252,198,276,0.82,47,45,78
OceanDNA-b3695,832,16.8,0.0,3.5e-07,0.00032,157,210,283,334,234,353,0.82,53,51,119
OceanDNA-b31536,828,15.9,0.1,3.5e-07,0.00092,96,154,225,281,206,307,0.82,58,56,101
OceanDNA-b32709,628,-0.6,0.0,0.073,62.0,162,183,323,344,315,356,0.82,21,21,41
OceanDNA-b15480,240,4.1,0.0,0.0014,0.7,123,148,148,174,131,181,0.82,25,26,50
OceanDNA-b31464,1668,6.6,0.0,0.00023,0.44,126,150,111,135,43,151,0.82,24,24,108
OceanDNA-b3695,466,14.5,0.0,1.8e-06,0.0016,23,97,63,136,49,160,0.82,74,73,111
OceanDNA-b36646,1282,17.3,0.0,1.3e-07,0.00027,19,151,13,150,5,157,0.82,132,137,152
OceanDNA-b16674,643,11.9,0.0,5.6e-06,0.0045,102,149,481,529,466,542,0.82,47,48,76
OceanDNA-b13203,166,5.0,0.0,0.00072,0.74,126,153,112,139,37,151,0.82,27,27,114
OceanDNA-b25052,124,-1.5,0.0,0.069,70.0,160,180,204,224,180,241,0.82,20,20,61
OceanDNA-b22805,721,14.3,0.0,2.1e-06,0.007,112,150,159,197,141,208,0.82,38,38,67
OceanDNA-b6259,3,21.9,0.0,4.9e-09,6.4e-06,49,154,145,253,136,262,0.82,105,108,126
OceanDNA-b37976,273,13.7,0.0,1.6e-06,0.0028,119,146,157,184,134,200,0.82,27,27,66
OceanDNA-b4339,186,35.9,0.0,2.7e-13,6.9e-11,116,208,142,236,114,246,0.82,92,94,132
OceanDNA-b10294,339,21.0,0.0,2e-08,8.3e-06,39,156,51,175,34,182,0.82,117,124,148
OceanDNA-b22407,1618,15.1,0.0,5.9e-07,0.0018,97,153,405,461,379,478,0.82,56,56,99
OceanDNA-b46646,996,12.5,0.1,3.8e-06,0.013,118,148,252,282,237,299,0.82,30,30,62
OceanDNA-b22528,305,8.4,0.0,6.7e-05,0.055,165,211,145,191,132,199,0.82,46,46,67
OceanDNA-b17690,254,12.4,0.0,4e-06,0.008,90,150,107,167,89,182,0.82,60,60,93
OceanDNA-b1719,2754,4.1,0.0,0.0027,4.0,161,195,233,266,213,288,0.82,34,33,75
OceanDNA-b13250,1870,26.1,0.0,2.6e-09,1.1e-06,110,216,165,271,75,284,0.82,106,106,209
OceanDNA-b11554,590,-2.8,0.0,0.18,130.0,220,233,6,19,4,33,0.82,13,13,29
OceanDNA-b40552,42,20.1,0.0,3.6e-08,7.9e-06,119,150,140,171,117,184,0.82,31,31,67
OceanDNA-b11963,1108,43.2,0.2,1.6e-15,3.1e-12,43,208,118,289,94,300,0.82,165,171,206
OceanDNA-b35935,1408,7.5,0.1,0.00025,0.33,122,148,104,130,97,141,0.82,26,26,44
OceanDNA-b46405,1208,12.8,0.0,6e-06,0.0059,106,157,582,631,571,637,0.82,51,49,66
OceanDNA-b4491,128,11.9,0.0,1.1e-05,0.0039,110,155,126,172,88,187,0.82,45,46,99
OceanDNA-b24941,2495,1.7,0.0,0.015,21.0,163,193,263,292,257,307,0.82,30,29,50
OceanDNA-b41303,5,10.4,0.0,1.6e-05,0.045,148,183,192,226,179,261,0.82,35,34,82
OceanDNA-b22409,3727,10.4,0.0,4.8e-05,0.066,118,147,20,49,5,66,0.82,29,29,61
OceanDNA-b22817,460,0.4,0.0,0.019,78.0,69,87,171,189,141,195,0.82,18,18,54
OceanDNA-b6674,21,11.1,0.0,2e-05,0.0064,116,153,165,203,142,215,0.82,37,38,73
OceanDNA-b23096,1267,14.3,0.0,1.1e-06,0.0037,54,155,146,252,136,264,0.82,101,106,128
OceanDNA-b3700,1479,-2.5,0.0,0.14,360.0,214,248,412,446,408,453,0.82,34,34,45
OceanDNA-b35160,65,12.0,0.0,5.4e-06,0.0035,119,148,164,193,145,216,0.82,29,29,71
OceanDNA-b42439,10,11.9,0.0,5.6e-06,0.0015,104,154,100,151,92,157,0.82,50,51,65
OceanDNA-b34275,576,11.5,0.0,1.5e-05,0.0067,107,146,494,534,480,544,0.82,39,40,64
OceanDNA-b35376,1481,20.6,0.1,2.5e-08,3.2e-05,39,156,213,337,183,344,0.82,117,124,161
OceanDNA-b41044,1573,10.0,0.2,4.3e-05,0.039,151,229,179,255,156,256,0.82,78,76,100
OceanDNA-b14179,243,10.9,0.0,1.1e-05,0.0057,152,184,211,242,165,266,0.82,32,31,101
OceanDNA-b17342,69,12.2,0.1,4.4e-06,0.004,27,148,72,202,66,209,0.82,121,130,143
OceanDNA-b22616,1116,12.6,0.0,6.8e-06,0.015,104,147,105,150,82,175,0.82,43,45,93
OceanDNA-b45220,1971,18.7,0.0,4.7e-08,0.00018,92,155,90,147,82,166,0.82,63,57,84
OceanDNA-b6756,268,11.8,0.0,5.9e-06,0.0032,120,157,144,182,118,215,0.82,37,38,97
OceanDNA-b3564,323,11.1,0.0,9.8e-06,0.0055,126,159,108,142,102,159,0.82,33,34,57
OceanDNA-b46702,865,20.4,0.0,2.9e-08,2.6e-05,119,211,235,329,214,336,0.82,92,94,122
OceanDNA-b20891,298,43.4,0.0,1.4e-15,1.1e-12,119,209,162,254,112,267,0.82,90,92,155
OceanDNA-b45233,797,21.5,0.0,6.8e-09,9.9e-06,42,137,86,183,77,194,0.82,95,97,117
OceanDNA-b31528,915,11.9,0.0,5.6e-06,0.0056,101,154,128,178,120,186,0.82,53,50,66
OceanDNA-b35883,168,18.2,0.0,7e-08,2.5e-05,118,147,150,179,132,200,0.82,29,29,68
OceanDNA-b496,923,6.4,0.0,0.00053,0.69,161,191,234,263,182,283,0.82,30,29,101
OceanDNA-b16096,300,7.5,0.0,0.00013,0.044,119,157,82,121,68,130,0.82,38,39,62
OceanDNA-b3473,322,19.3,0.0,3.2e-08,2.4e-05,66,147,31,107,9,121,0.82,81,76,112
OceanDNA-b10408,194,20.4,0.0,1.5e-08,4.5e-06,118,158,202,243,188,260,0.82,40,41,72
OceanDNA-b27563,76,5.1,0.0,0.00068,1.1,121,145,55,79,37,119,0.82,24,24,82
OceanDNA-b32834,306,20.2,0.2,3.4e-08,1.4e-05,68,160,41,128,14,133,0.82,92,87,119
OceanDNA-b3605,1028,10.4,0.0,3.2e-05,0.031,105,145,128,169,113,184,0.82,40,41,71
OceanDNA-b20913,2398,14.8,0.0,7.2e-07,0.0054,103,153,213,262,204,269,0.82,50,49,65
OceanDNA-b22409,1234,-1.5,0.0,0.21,290.0,29,61,533,566,526,575,0.82,32,33,49
OceanDNA-b32734,108,3.5,0.0,0.0021,0.82,163,181,203,221,188,250,0.82,18,18,62
OceanDNA-b32604,166,2.0,0.1,0.006,5.5,124,146,69,91,35,139,0.82,22,22,104
OceanDNA-b32604,166,8.1,0.0,8e-05,0.074,140,184,158,202,149,234,0.82,44,44,85
OceanDNA-b37665,933,14.0,0.1,1.3e-06,0.0021,119,146,157,184,126,195,0.82,27,27,69
OceanDNA-b35069,865,12.7,0.0,1e-05,0.0031,106,148,63,105,41,126,0.82,42,42,85
OceanDNA-b32786,1051,22.6,0.0,9.1e-09,4.9e-06,52,162,45,158,21,165,0.82,110,113,144
OceanDNA-b23093,2393,15.0,0.0,1.9e-06,0.0039,113,199,262,352,206,368,0.82,86,90,162
OceanDNA-b23143,876,25.3,0.0,9.1e-10,1.2e-06,110,192,231,311,208,335,0.82,82,80,127
OceanDNA-b13204,619,10.7,0.0,1.3e-05,0.01,118,150,167,199,151,210,0.82,32,32,59
OceanDNA-b16778,1133,10.4,0.0,4.7e-05,0.025,58,144,145,233,133,258,0.82,86,88,125
OceanDNA-b13073,695,11.6,0.0,7.1e-06,0.0065,46,145,175,272,169,292,0.82,99,97,123
OceanDNA-b21043,56,10.9,0.0,2.3e-05,0.02,116,151,92,127,66,133,0.82,35,35,67
OceanDNA-b26893,2035,26.7,0.0,3.5e-10,5.9e-07,49,145,89,192,81,209,0.82,96,103,128
OceanDNA-a2501,135,10.5,0.0,1.5e-05,0.0063,112,143,108,139,71,153,0.82,31,31,82
OceanDNA-b40884,305,22.5,0.0,3.4e-09,1.3e-06,104,145,126,169,116,184,0.82,41,43,68
OceanDNA-b19403,295,15.0,0.0,6.6e-07,0.0002,89,155,259,329,249,339,0.82,66,70,90
OceanDNA-b35250,67,8.7,0.0,5.2e-05,0.035,162,219,583,640,576,650,0.82,57,57,74
OceanDNA-b10059,343,17.3,0.0,1.3e-07,5.9e-05,163,231,121,191,96,195,0.82,68,70,99
OceanDNA-b24637,144,-0.8,0.0,0.042,28.0,58,76,70,88,37,93,0.82,18,18,56
OceanDNA-b31529,2007,16.1,0.0,3e-07,0.00064,101,153,186,237,178,258,0.82,52,51,80
OceanDNA-b22406,1775,16.5,0.0,9.1e-07,0.00066,118,180,169,233,147,264,0.82,62,64,117
OceanDNA-b9171,194,10.7,0.0,2.7e-05,0.0055,103,139,150,186,134,191,0.82,36,36,57
OceanDNA-a3351,125,-4.2,0.0,0.46,200.0,240,258,58,75,57,77,0.82,18,17,20
OceanDNA-b20819,318,14.5,0.0,1.9e-06,0.00064,111,152,134,176,115,185,0.82,41,42,70
OceanDNA-b45818,1209,12.5,0.0,1.8e-05,0.0054,54,135,75,156,27,169,0.82,81,81,142
OceanDNA-b33192,401,0.9,0.0,0.025,5.4,95,124,78,105,68,112,0.82,29,27,44
OceanDNA-b22806,3861,10.6,0.0,4.1e-05,0.064,53,144,134,214,130,239,0.81,91,80,109
OceanDNA-b3631,550,2.6,0.0,0.004,4.1,126,150,111,135,73,153,0.81,24,24,80
OceanDNA-b32851,680,19.9,0.3,2e-08,1.6e-05,67,156,40,124,13,131,0.81,89,84,118
OceanDNA-b35112,242,11.8,0.0,6.1e-06,0.0063,118,156,203,242,185,268,0.81,38,39,83
OceanDNA-b15291,275,11.1,0.0,1e-05,0.0031,90,193,79,179,16,186,0.81,103,100,170
OceanDNA-b47092,365,10.8,0.0,1.3e-05,0.024,98,177,139,218,127,279,0.81,79,79,152
OceanDNA-b18171,65,22.7,0.0,2.9e-09,4.9e-07,111,157,114,160,96,185,0.81,46,46,89
OceanDNA-b36648,147,6.4,0.0,0.00026,0.15,162,219,582,639,570,651,0.81,57,57,81
OceanDNA-b2866,2165,14.7,0.0,8e-07,0.0021,86,157,451,521,439,589,0.81,71,70,150
OceanDNA-b30043,1162,7.6,0.0,0.00024,0.23,126,163,112,153,36,160,0.81,37,41,124
OceanDNA-b15769,769,20.1,0.0,5.4e-08,3.1e-05,71,176,125,243,116,278,0.81,105,118,162
OceanDNA-b23850,7,6.4,0.0,0.00083,0.41,126,150,117,141,100,160,0.81,24,24,60
OceanDNA-b10017,7,-2.7,0.0,0.16,120.0,157,178,210,231,207,239,0.81,21,21,32
OceanDNA-b37573,2280,13.0,0.1,5.3e-06,0.0073,36,154,53,175,21,241,0.81,118,122,220
OceanDNA-b22849,1949,12.6,0.0,7e-06,0.007,118,152,171,205,99,218,0.81,34,34,119
OceanDNA-b22504,1215,10.4,0.0,5.1e-05,0.049,109,148,863,902,852,913,0.81,39,39,61
OceanDNA-b3424,671,14.4,0.0,9.9e-07,0.0017,119,154,129,164,113,221,0.81,35,35,108
OceanDNA-b44612,1129,6.0,0.0,0.00035,0.91,159,212,584,637,576,654,0.81,53,53,78
OceanDNA-b32763,549,16.5,0.0,4.4e-07,0.00035,106,146,100,140,21,160,0.81,40,40,139
OceanDNA-b20094,30,14.3,0.0,3.3e-06,0.00041,118,163,242,287,214,337,0.81,45,45,123
OceanDNA-b22848,486,-4.1,0.0,0.83,1700.0,162,180,430,448,430,456,0.81,18,18,26
OceanDNA-b20958,2954,11.4,0.0,8.3e-06,0.059,112,140,166,194,152,201,0.81,28,28,49
OceanDNA-b26056,5,10.5,0.0,1.5e-05,0.0059,115,156,73,114,25,128,0.81,41,41,103
OceanDNA-b30427,1176,3.4,0.0,0.0043,4.6,123,153,134,164,108,201,0.81,30,30,93
OceanDNA-b4498,638,25.4,0.0,1.3e-09,4.3e-07,45,154,82,201,59,215,0.81,109,119,156
OceanDNA-b4498,474,-0.2,0.0,0.081,27.0,194,236,198,237,181,242,0.81,42,39,61
OceanDNA-b22787,1043,5.4,0.0,0.00055,0.74,128,164,308,345,288,350,0.81,36,37,62
OceanDNA-b26761,515,13.3,0.0,2.2e-06,0.0019,122,150,146,174,125,182,0.81,28,28,57
OceanDNA-b16107,394,7.9,0.0,9.6e-05,0.067,159,217,416,472,390,488,0.81,58,56,98
OceanDNA-b4103,43,11.2,0.0,9.6e-06,0.0096,104,163,115,174,107,179,0.81,59,59,72
OceanDNA-b30487,1180,31.4,0.2,1.3e-11,1.8e-08,45,139,134,235,119,247,0.81,94,101,128
OceanDNA-b40473,241,13.9,0.0,2.7e-06,0.0015,108,155,108,157,97,176,0.81,47,49,79
OceanDNA-b12697,775,11.0,0.0,2.1e-05,0.0087,116,150,258,292,238,299,0.81,34,34,61
OceanDNA-b22409,1234,12.9,0.0,8.7e-06,0.012,117,154,604,641,584,652,0.81,37,37,68
OceanDNA-b13153,314,12.5,0.0,3.8e-06,0.0027,115,149,137,171,119,179,0.81,34,34,60
OceanDNA-b13590,599,14.5,0.0,2.7e-06,0.0026,106,188,350,436,278,455,0.81,82,86,177
OceanDNA-b22398,2836,12.3,0.0,1.3e-05,0.013,118,149,249,280,232,281,0.81,31,31,49
OceanDNA-b32865,275,2.3,0.0,0.0049,2.5,167,230,203,264,187,268,0.81,63,61,81
OceanDNA-b15801,1289,26.0,0.0,5.8e-10,4.3e-07,45,173,29,166,21,184,0.81,128,137,163
OceanDNA-b36666,959,5.7,0.0,0.00087,0.53,112,153,533,576,522,591,0.81,41,43,69
OceanDNA-b13868,724,10.7,0.0,1.3e-05,0.018,119,181,144,209,101,226,0.81,62,65,125
OceanDNA-b44378,1157,13.4,0.0,2e-06,0.0025,153,227,328,402,279,407,0.81,74,74,128
OceanDNA-b1353,1714,6.3,0.0,0.00089,1.2,158,230,293,361,278,362,0.81,72,68,84
OceanDNA-b15525,654,13.5,0.0,1.9e-06,0.0031,115,162,112,159,17,165,0.81,47,47,148
OceanDNA-b4763,238,11.8,0.0,6.2e-06,0.0031,163,204,308,353,241,361,0.81,41,45,120
OceanDNA-b32084,1484,-2.5,0.0,0.28,460.0,72,83,207,218,197,220,0.81,11,11,23
OceanDNA-b46513,159,12.0,0.0,1.1e-05,0.0031,111,157,555,601,542,607,0.81,46,46,65
OceanDNA-a1153,65,0.5,0.0,0.017,2.7,52,82,66,95,43,108,0.81,30,29,65
OceanDNA-b31070,715,12.2,0.0,1.8e-05,0.014,114,154,114,154,62,200,0.81,40,40,138
OceanDNA-b20944,992,12.0,0.0,5.4e-06,0.0097,115,148,93,126,73,149,0.81,33,33,76
OceanDNA-b10294,774,6.0,0.0,0.00069,0.29,164,230,197,261,190,271,0.81,66,64,81
OceanDNA-b23139,2350,-0.1,0.0,0.052,62.0,166,211,243,285,239,295,0.81,45,42,56
OceanDNA-b47071,444,12.9,0.0,5.5e-06,0.0021,107,152,197,242,174,260,0.81,45,45,86
OceanDNA-b23261,218,13.0,0.0,5.3e-06,0.0062,125,164,124,167,53,172,0.81,39,43,119
OceanDNA-b30001,346,2.8,0.0,0.0034,5.6,160,209,280,330,262,333,0.81,49,50,71
OceanDNA-b34782,645,0.5,0.0,0.018,12.0,167,187,122,142,112,155,0.81,20,20,43
OceanDNA-b37047,313,29.3,0.1,2.7e-11,1.9e-08,95,160,160,227,154,239,0.81,65,67,85
OceanDNA-b19757,13,11.0,0.0,1e-05,0.0051,40,86,82,129,57,151,0.81,46,47,94
OceanDNA-b40249,8,1.1,0.0,0.011,8.1,58,89,64,98,40,112,0.81,31,34,72
OceanDNA-b46766,1355,12.1,0.0,9.6e-06,0.0085,118,153,204,240,178,252,0.81,35,36,74
OceanDNA-b27525,414,7.2,0.1,0.0006,0.4,116,146,118,148,104,209,0.81,30,30,105
OceanDNA-b20097,208,36.1,0.0,7.3e-13,7.2e-11,111,211,153,263,88,271,0.81,100,110,183
OceanDNA-b11647,386,11.1,0.1,1e-05,0.0046,107,146,39,78,28,89,0.81,39,39,61
OceanDNA-b11387,576,0.9,0.0,0.025,7.6,48,85,183,220,172,226,0.81,37,37,54
OceanDNA-b13570,390,9.8,0.0,4.8e-05,0.032,150,217,172,237,160,250,0.81,67,65,90
OceanDNA-b14174,315,12.0,0.0,5.3e-06,0.0022,118,181,110,176,87,203,0.81,63,66,116
OceanDNA-b10261,75,13.1,0.0,2.4e-06,0.00083,100,148,106,152,96,162,0.81,48,46,66
OceanDNA-b22415,436,9.9,0.0,2.2e-05,0.059,120,146,232,258,213,276,0.81,26,26,63
OceanDNA-b9784,941,13.3,0.0,4.3e-06,0.0026,111,152,120,162,103,239,0.81,41,42,136
OceanDNA-b14740,185,11.7,0.0,6.4e-06,0.0017,87,159,78,151,66,162,0.81,72,73,96
OceanDNA-b9635,310,1.6,0.0,0.0079,3.8,117,142,91,116,79,175,0.81,25,25,96
OceanDNA-b32883,871,18.9,0.0,4.1e-08,6.8e-05,113,146,140,175,129,193,0.81,33,35,64
OceanDNA-b25045,394,10.2,0.0,1.8e-05,0.016,117,144,143,170,126,207,0.81,27,27,81
OceanDNA-b32730,173,11.6,0.0,7.2e-06,0.0038,115,153,220,259,189,278,0.81,38,39,89
OceanDNA-b36099,123,7.9,0.2,9.3e-05,0.19,34,72,178,216,146,227,0.81,38,38,81
OceanDNA-b21580,140,14.1,0.0,1.2e-06,0.00043,117,158,157,199,134,245,0.81,41,42,111
OceanDNA-b33192,401,5.6,0.0,0.00098,0.21,127,161,1,39,1,45,0.81,34,38,44
OceanDNA-b42626,228,0.8,0.0,0.014,3.5,119,145,85,111,71,126,0.81,26,26,55
OceanDNA-b41544,516,4.1,0.0,0.0013,1.5,54,83,66,95,48,105,0.81,29,29,57
OceanDNA-b2514,271,9.2,0.0,3.8e-05,0.027,115,145,27,57,13,84,0.81,30,30,71
OceanDNA-b46581,1131,10.6,0.0,2.8e-05,0.023,117,146,249,278,231,286,0.81,29,29,55
OceanDNA-b45554,223,11.5,0.0,1.5e-05,0.0045,123,173,333,383,308,394,0.81,50,50,86
OceanDNA-b5207,24,18.8,0.0,4.5e-08,1.5e-05,111,150,108,147,21,160,0.81,39,39,139
OceanDNA-b23364,1970,8.5,0.0,0.00012,0.15,111,142,147,178,80,203,0.81,31,31,123
OceanDNA-b36402,186,12.7,0.1,3.3e-06,0.0023,113,153,158,200,146,210,0.81,40,42,64
OceanDNA-b24146,108,4.1,0.1,0.0014,3.0,121,145,150,174,135,185,0.81,24,24,50
OceanDNA-b15465,164,12.7,0.0,9.5e-06,0.0034,160,208,203,249,192,253,0.81,48,46,61
OceanDNA-b38495,572,20.9,0.0,9.9e-09,8.2e-06,54,141,109,203,63,220,0.81,87,94,157
OceanDNA-b2563,333,11.5,0.0,7.7e-06,0.0031,121,147,245,271,235,295,0.81,26,26,60
OceanDNA-b36740,366,1.9,0.0,0.0062,3.4,161,197,264,299,242,308,0.81,36,35,66
OceanDNA-b60,1272,16.3,0.1,2.6e-07,0.00034,43,149,40,146,25,154,0.81,106,106,129
OceanDNA-b23643,888,10.9,0.0,2.3e-05,0.029,119,158,121,159,87,171,0.81,39,38,84
OceanDNA-b36730,1280,14.0,0.0,2.6e-06,0.0042,118,157,608,651,595,659,0.81,39,43,64
OceanDNA-b22212,22,-3.3,0.0,0.24,200.0,227,244,116,133,112,137,0.81,17,17,25
OceanDNA-b22823,2872,11.9,0.1,1.1e-05,0.023,113,144,150,181,94,231,0.81,31,31,137
OceanDNA-b32141,443,11.2,0.0,2.8e-05,0.028,112,154,174,216,162,222,0.81,42,42,60
OceanDNA-b32141,2161,7.9,0.0,0.00028,0.28,122,151,159,188,121,199,0.81,29,29,78
OceanDNA-b16117,600,8.7,0.0,0.00011,0.04,151,181,216,246,202,285,0.81,30,30,83
OceanDNA-b13575,549,11.4,0.0,8.1e-06,0.0085,157,228,180,250,163,255,0.81,71,70,92
OceanDNA-b6567,196,11.0,0.0,1.1e-05,0.011,163,230,395,464,385,467,0.81,67,69,82
OceanDNA-b4346,139,19.1,0.0,7.1e-08,8.7e-06,163,229,433,501,414,504,0.81,66,68,90
OceanDNA-b29209,436,0.0,0.0,0.024,14.0,163,183,314,334,296,344,0.81,20,20,48
OceanDNA-b19130,353,18.0,0.0,1.5e-07,3.4e-05,100,153,112,164,84,180,0.81,53,52,96
OceanDNA-b26639,931,7.3,0.0,0.00014,0.19,105,145,74,117,62,135,0.81,40,43,73
OceanDNA-b26126,494,3.4,0.0,0.0022,1.5,152,188,185,221,163,249,0.81,36,36,86
OceanDNA-b35208,909,5.5,0.1,0.00051,0.49,139,184,230,275,175,305,0.81,45,45,130
OceanDNA-b29506,1769,23.3,0.2,1.9e-09,6.3e-06,57,146,100,193,86,200,0.81,89,93,114
OceanDNA-b8082,149,15.5,0.0,4.5e-07,0.00013,115,153,125,163,106,175,0.81,38,38,69
OceanDNA-b13263,277,-3.0,0.0,0.59,190.0,177,207,484,514,474,519,0.81,30,30,45
OceanDNA-b36885,333,15.7,0.0,4.1e-07,0.00028,111,157,215,261,159,269,0.81,46,46,110
OceanDNA-b22946,3695,12.5,0.0,3.6e-06,0.017,103,145,223,265,210,278,0.81,42,42,68
OceanDNA-b10305,433,16.7,0.0,1.9e-07,8.4e-05,163,229,343,411,319,412,0.81,66,68,93
OceanDNA-b16280,24,14.2,0.0,1.1e-06,0.00031,158,212,397,451,371,472,0.81,54,54,101
OceanDNA-b4489,579,10.5,0.0,1.6e-05,0.0099,122,150,64,92,46,100,0.81,28,28,54
OceanDNA-b20788,524,-3.5,0.0,0.29,190.0,42,68,263,289,253,299,0.81,26,26,46
OceanDNA-b20703,336,2.0,0.0,0.006,2.4,52,86,142,176,133,183,0.81,34,34,50
OceanDNA-b10080,169,10.2,0.1,3.7e-05,0.018,119,156,85,123,71,132,0.81,37,38,61
OceanDNA-b20788,524,11.6,0.0,6.9e-06,0.0046,104,157,335,388,313,400,0.81,53,53,87
OceanDNA-b46530,453,10.5,0.0,2.9e-05,0.017,105,157,559,609,549,615,0.81,52,50,66
OceanDNA-b10231,282,15.4,0.0,4.9e-07,0.00019,44,205,23,181,13,214,0.81,161,158,201
OceanDNA-b46725,44,21.4,0.0,1.4e-08,1.5e-05,118,211,250,345,223,354,0.81,93,95,131
OceanDNA-b10045,116,2.0,0.0,0.0061,2.7,116,155,533,572,519,582,0.81,39,39,63
OceanDNA-b26825,261,10.2,0.1,1.9e-05,0.02,163,235,202,272,190,278,0.81,72,70,88
OceanDNA-b4608,21,7.8,0.0,0.0002,0.053,119,162,97,147,20,154,0.81,43,50,134
OceanDNA-b13692,196,7.0,0.0,0.00018,0.082,119,155,537,573,523,594,0.81,36,36,71
OceanDNA-b2578,226,11.8,0.0,6.2e-06,0.0024,119,147,243,271,210,284,0.81,28,28,74
OceanDNA-b22801,867,0.7,0.0,0.03,38.0,65,87,224,246,203,254,0.81,22,22,51
OceanDNA-b27615,747,11.1,0.1,1e-05,0.042,102,142,18,57,8,67,0.81,40,39,59
OceanDNA-b36767,303,3.7,0.0,0.0018,1.6,54,86,136,168,123,190,0.81,32,32,67
OceanDNA-b510,1351,-0.1,0.0,0.026,56.0,164,193,249,277,215,301,0.81,29,28,86
OceanDNA-b34612,209,23.0,0.0,2.3e-09,2.1e-06,73,169,116,209,81,227,0.81,96,93,146
OceanDNA-b4494,996,32.0,0.0,4.2e-12,4.9e-09,70,157,147,241,132,253,0.81,87,94,121
OceanDNA-b28098,354,18.2,0.0,6.6e-08,0.0001,118,145,139,166,121,185,0.81,27,27,64
OceanDNA-b34087,371,10.0,0.2,2.2e-05,0.011,159,232,188,259,181,261,0.81,73,71,80
OceanDNA-b23556,470,12.8,0.0,5.8e-06,0.0067,122,152,190,220,169,260,0.81,30,30,91
OceanDNA-b496,1635,11.8,0.0,1.2e-05,0.016,162,213,58,109,32,141,0.81,51,51,109
OceanDNA-b4491,657,35.2,0.0,8.9e-13,3.1e-10,49,141,139,241,130,249,0.81,92,102,119
OceanDNA-b31521,15,0.7,0.0,0.029,30.0,105,154,581,630,576,643,0.81,49,49,67
OceanDNA-b13621,203,11.0,0.0,3.2e-05,0.0032,105,154,126,175,51,194,0.81,49,49,143
OceanDNA-b41998,118,23.5,0.0,1.7e-09,2.7e-07,49,141,67,164,51,196,0.81,92,97,145
OceanDNA-b23372,2389,10.8,0.0,2.5e-05,0.031,119,152,175,208,155,228,0.81,33,33,73
OceanDNA-b2647,780,11.4,0.1,1.6e-05,0.023,117,149,238,270,200,287,0.81,32,32,87
OceanDNA-b3607,603,20.9,0.0,2e-08,2.5e-05,117,184,105,171,47,200,0.81,67,66,153
OceanDNA-b20533,45,6.6,0.0,0.00024,0.063,162,208,190,234,177,248,0.81,46,44,71
OceanDNA-b17579,139,-0.4,0.0,0.031,96.0,176,199,269,291,259,297,0.81,23,22,38
OceanDNA-b9760,691,22.2,0.0,4.2e-09,3.7e-06,40,177,94,242,82,292,0.81,137,148,210
OceanDNA-b12519,196,35.8,0.0,2.8e-13,9.4e-11,116,197,131,216,45,235,0.81,81,85,190
OceanDNA-b43678,719,13.6,0.0,1.7e-06,0.0017,115,171,78,132,38,158,0.81,56,54,120
OceanDNA-b41695,121,18.1,0.0,1.5e-07,1.4e-05,62,151,32,119,26,125,0.81,89,87,99
OceanDNA-b15772,735,11.9,0.0,5.6e-06,0.0057,124,164,45,85,17,129,0.81,40,40,112
OceanDNA-b4297,78,1.4,0.0,0.0092,2.6,117,155,519,557,506,567,0.81,38,38,61
OceanDNA-b3643,751,11.6,0.0,6.9e-06,0.0059,100,148,98,145,87,229,0.81,48,47,142
OceanDNA-b22885,443,11.0,0.0,2.1e-05,0.045,113,145,240,272,222,286,0.81,32,32,64
OceanDNA-b22876,1950,-1.6,0.0,0.074,270.0,65,86,95,116,89,137,0.81,21,21,48
OceanDNA-b26770,298,9.5,0.0,3e-05,0.044,145,210,710,780,697,787,0.81,65,70,90
OceanDNA-b40457,1543,7.7,0.1,0.00011,0.17,164,217,283,332,271,341,0.81,53,49,70
OceanDNA-b20559,114,13.5,0.0,1.9e-06,0.00056,90,156,211,279,201,302,0.81,66,68,101
OceanDNA-b34671,566,33.7,0.1,1.2e-12,9.4e-10,32,139,153,274,130,285,0.81,107,121,155
OceanDNA-b39304,776,19.7,0.0,2.3e-08,2.8e-05,110,154,157,203,107,232,0.81,44,46,125
OceanDNA-b17763,2384,11.4,0.0,8e-06,0.032,111,148,194,230,148,240,0.81,37,36,92
OceanDNA-b9778,658,11.3,0.0,8.6e-06,0.012,120,154,152,187,129,219,0.81,34,35,90
OceanDNA-b36831,738,16.6,0.0,2e-07,0.00022,117,152,142,177,96,249,0.81,35,35,153
OceanDNA-b4307,173,12.0,0.0,5.3e-06,0.0017,111,154,131,176,83,204,0.81,43,45,121
OceanDNA-b37447,293,5.2,0.1,0.00061,0.44,160,195,264,298,202,328,0.81,35,34,126
OceanDNA-b20950,1951,1.1,0.0,0.011,62.0,144,177,251,284,237,290,0.81,33,33,53
OceanDNA-b9447,96,2.0,0.0,0.0058,1.9,157,193,238,273,218,284,0.81,36,35,66
OceanDNA-b23153,73,13.3,0.0,2.1e-06,0.0055,110,160,207,257,187,306,0.81,50,50,119
OceanDNA-b13164,157,13.0,0.0,2.7e-06,0.0018,110,148,132,170,117,180,0.81,38,38,63
OceanDNA-a3708,129,10.5,0.1,1.6e-05,0.0051,145,183,366,407,356,422,0.81,38,41,66
OceanDNA-b17621,378,20.8,0.0,1.1e-08,1.3e-05,111,157,176,223,154,252,0.81,46,47,98
OceanDNA-b45634,653,5.4,0.0,0.0017,0.41,163,227,98,159,84,163,0.81,64,61,79
OceanDNA-b28010,562,7.4,0.0,0.00013,0.43,126,162,126,166,122,178,0.81,36,40,56
OceanDNA-b20900,1297,14.5,0.1,9.1e-07,0.002,107,143,55,91,12,132,0.81,36,36,120
OceanDNA-b36884,804,11.8,0.1,6.3e-06,0.0093,114,167,87,140,51,157,0.81,53,53,106
OceanDNA-b33512,2615,12.2,0.0,4.5e-06,0.018,119,145,164,190,146,204,0.81,26,26,58
OceanDNA-b20495,104,12.9,0.0,2.8e-06,0.00059,186,237,263,315,235,325,0.81,51,52,90
OceanDNA-b22022,2999,19.1,0.0,7.3e-08,0.00012,117,177,158,225,119,243,0.81,60,67,124
OceanDNA-b8720,145,7.3,0.0,0.00014,0.039,71,143,83,153,48,161,0.81,72,70,113
OceanDNA-b44610,1442,5.3,0.0,0.00059,0.99,162,208,293,339,289,364,0.81,46,46,75
OceanDNA-b35823,451,10.7,0.0,2.6e-05,0.057,106,145,136,173,125,187,0.81,39,37,62
OceanDNA-b16121,452,2.9,0.0,0.0033,2.5,159,184,429,454,401,481,0.81,25,25,80
OceanDNA-b43875,440,-1.4,0.0,0.063,36.0,179,224,52,97,40,105,0.81,45,45,65
OceanDNA-b9056,131,11.1,0.0,1e-05,0.0031,163,229,337,405,322,407,0.81,66,68,85
OceanDNA-b45652,255,11.0,0.0,1.1e-05,0.0062,101,150,126,172,112,183,0.81,49,46,71
OceanDNA-b16140,405,5.0,0.0,0.0015,0.68,203,243,509,551,490,562,0.81,40,42,72
OceanDNA-b20148,305,4.7,0.0,0.00092,0.37,49,85,139,175,94,186,0.81,36,36,92
OceanDNA-b20627,234,17.0,0.0,1.6e-07,5.2e-05,104,156,224,276,194,287,0.81,52,52,93
OceanDNA-b23379,895,12.8,0.0,5.8e-06,0.0066,112,154,324,367,309,374,0.81,42,43,65
OceanDNA-b31569,1828,10.9,0.1,1.1e-05,0.033,120,140,450,470,447,488,0.81,20,20,41
OceanDNA-b3695,832,2.5,0.0,0.0082,7.4,113,143,158,188,145,201,0.81,30,30,56
OceanDNA-b45622,631,18.0,0.0,7.9e-08,5.7e-05,116,159,32,76,9,126,0.81,43,44,117
OceanDNA-b22833,1824,15.8,0.0,3.7e-07,0.0015,113,147,251,285,202,299,0.81,34,34,97
OceanDNA-b18620,349,12.0,0.0,1.1e-05,0.0022,98,157,185,246,174,250,0.81,59,61,76
OceanDNA-b1733,3583,21.2,0.0,8.1e-09,2.9e-05,74,190,136,251,104,265,0.81,116,115,161
OceanDNA-b45634,653,7.0,0.0,0.00054,0.13,122,155,16,49,4,59,0.81,33,33,55
OceanDNA-b22114,761,13.0,0.1,2.7e-06,0.0069,111,153,58,100,43,111,0.81,42,42,68
OceanDNA-b23367,1849,15.8,0.1,3.7e-07,0.00076,116,145,123,155,114,162,0.81,29,32,48
OceanDNA-b19147,356,13.4,0.0,4.1e-06,0.00072,148,181,269,302,256,326,0.81,33,33,70
OceanDNA-b36771,228,3.7,0.0,0.0018,2.0,54,86,136,168,123,188,0.81,32,32,65
OceanDNA-b24003,129,15.1,0.0,1.2e-06,0.0009,110,147,128,167,118,181,0.81,37,39,63
OceanDNA-b37054,2027,13.3,0.0,4.3e-06,0.0068,119,140,140,161,122,177,0.81,21,21,55
OceanDNA-b38580,272,12.5,0.0,3.7e-06,0.0023,174,213,56,97,51,107,0.81,39,41,56
OceanDNA-b23524,154,13.1,0.0,7.2e-06,0.0034,115,155,83,123,62,139,0.81,40,40,77
OceanDNA-b27549,1961,3.4,0.0,0.0045,4.9,162,230,188,254,178,257,0.81,68,66,79
OceanDNA-b41265,427,11.5,0.0,7.7e-06,0.01,148,193,135,178,122,202,0.81,45,43,80
OceanDNA-b42278,58,15.4,0.0,4.7e-07,9.9e-05,48,140,64,160,32,169,0.81,92,96,137
OceanDNA-b34662,91,10.8,0.1,1.2e-05,0.011,54,139,89,171,77,185,0.81,85,82,108
OceanDNA-b44852,144,18.8,0.0,4.6e-08,2.9e-05,43,154,26,148,5,209,0.8,111,122,204
OceanDNA-b34544,56,12.5,0.0,3.8e-06,0.0028,123,151,129,157,88,165,0.8,28,28,77
OceanDNA-b45823,1602,20.5,0.0,2.7e-08,2.4e-05,112,154,424,467,403,472,0.8,42,43,69
OceanDNA-b467,2682,10.4,0.1,1.6e-05,0.045,152,213,182,240,167,254,0.8,61,58,87
OceanDNA-b46852,1158,12.5,0.0,7.2e-06,0.0044,118,150,143,175,126,188,0.8,32,32,62
OceanDNA-b30427,1668,15.9,0.0,6.9e-07,0.00073,119,144,201,226,194,258,0.8,25,25,64
OceanDNA-b38936,280,11.2,0.0,1.9e-05,0.006,44,152,26,131,19,140,0.8,108,105,121
OceanDNA-b41234,545,10.3,0.0,3.5e-05,0.034,150,185,177,211,166,233,0.8,35,34,67
OceanDNA-b22862,2207,10.7,0.1,1.4e-05,0.046,118,179,174,237,162,265,0.8,61,63,103
OceanDNA-b16123,12,1.4,0.0,0.018,6.6,162,188,211,237,192,248,0.8,26,26,56
OceanDNA-b22450,341,14.6,0.3,1.7e-06,0.0011,41,139,531,631,500,669,0.8,98,100,169
OceanDNA-b22517,2947,29.3,0.0,5.7e-11,9.3e-08,115,214,184,289,172,294,0.8,99,105,122
OceanDNA-b22517,1461,15.2,0.0,1.1e-06,0.0019,93,154,170,229,160,267,0.8,61,59,107
OceanDNA-b46554,500,14.8,0.0,7.7e-07,0.0008,113,154,148,190,129,220,0.8,41,42,91
OceanDNA-b22654,819,11.2,0.0,4.6e-05,0.011,102,153,254,304,239,362,0.8,51,50,123
OceanDNA-b22654,53,12.3,0.0,2.1e-05,0.0052,118,184,150,216,127,245,0.8,66,66,118
OceanDNA-b46917,94,12.5,0.0,7.5e-06,0.0065,92,151,105,163,85,181,0.8,59,58,96
OceanDNA-b23005,190,32.5,0.0,2.9e-12,9.7e-09,13,208,196,410,190,417,0.8,195,214,227
OceanDNA-b37525,354,32.2,0.0,3.6e-12,8.1e-09,40,193,82,256,36,269,0.8,153,174,233
OceanDNA-b16133,307,2.4,0.0,0.014,5.1,161,230,212,275,178,279,0.8,69,63,101
OceanDNA-b46982,311,16.8,0.0,7.4e-07,0.00012,109,152,116,160,93,173,0.8,43,44,80
OceanDNA-b46834,1327,31.0,0.0,8.5e-12,1.2e-08,118,208,118,211,103,224,0.8,90,93,121
OceanDNA-b46224,424,10.6,0.0,2.8e-05,0.015,117,158,257,299,237,307,0.8,41,42,70
OceanDNA-b20036,28,14.7,0.0,2.4e-06,0.00031,108,146,127,165,99,179,0.8,38,38,80
OceanDNA-b40641,883,1.5,0.0,0.034,11.0,164,230,205,269,170,276,0.8,66,64,106
OceanDNA-b22398,2035,4.6,0.0,0.0029,2.8,115,141,251,277,230,291,0.8,26,26,61
OceanDNA-b17223,1768,12.2,0.0,1.4e-05,0.013,118,190,408,481,364,491,0.8,72,73,127
OceanDNA-b7352,307,12.0,0.0,5.2e-06,0.0017,104,153,114,165,83,173,0.8,49,51,90
OceanDNA-b32786,393,12.3,0.0,1.3e-05,0.007,113,150,233,270,161,276,0.8,37,37,115
OceanDNA-b7194,460,5.4,0.0,0.0016,0.45,162,218,215,268,199,285,0.8,56,53,86
OceanDNA-b46222,883,10.8,0.0,2.4e-05,0.019,116,153,225,262,199,280,0.8,37,37,81
OceanDNA-b22496,4234,16.3,0.0,5.2e-07,0.0012,69,143,94,166,66,196,0.8,74,72,130
OceanDNA-b22324,2449,11.0,0.0,5.2e-05,0.043,108,155,283,331,262,348,0.8,47,48,86
OceanDNA-b3951,745,16.9,0.0,1.7e-07,0.00018,112,174,44,107,21,138,0.8,62,63,117
OceanDNA-b46982,421,11.8,0.0,2.5e-05,0.0041,110,150,138,176,119,183,0.8,40,38,64
OceanDNA-b45373,219,21.7,0.0,6e-09,4.2e-06,118,186,198,268,179,302,0.8,68,70,123
OceanDNA-b16220,635,6.1,0.1,0.00068,0.42,108,145,196,233,177,239,0.8,37,37,62
OceanDNA-b46222,1352,9.7,0.0,5.2e-05,0.042,124,160,125,161,107,168,0.8,36,36,61
OceanDNA-b41451,1253,13.8,0.1,3.1e-06,0.0022,103,151,71,119,40,125,0.8,48,48,85
OceanDNA-b28240,1776,14.9,0.1,6.9e-07,0.0018,93,150,211,269,203,274,0.8,57,58,71
OceanDNA-b22650,1489,6.5,0.0,0.00049,0.58,164,218,123,177,107,183,0.8,54,54,76
OceanDNA-b31195,338,9.1,0.0,3.9e-05,0.024,143,228,191,273,184,277,0.8,85,82,93
OceanDNA-b23101,3276,26.7,0.2,1.7e-10,5.5e-07,47,177,173,305,146,322,0.8,130,132,176
OceanDNA-b46728,1637,21.3,0.0,3e-08,1.3e-05,118,211,196,291,170,300,0.8,93,95,130
OceanDNA-b23634,108,4.6,0.0,0.003,2.4,116,144,130,158,109,175,0.8,28,28,66
OceanDNA-b19769,45,17.0,0.0,3.2e-07,7.4e-05,87,156,267,340,251,361,0.8,69,73,110
OceanDNA-b260,485,2.7,0.0,0.0072,12.0,114,150,164,200,130,210,0.8,36,36,80
OceanDNA-b1901,223,13.3,0.0,2.1e-06,0.0011,51,142,63,159,40,199,0.8,91,96,159
OceanDNA-b23149,1072,10.5,0.0,3.1e-05,0.027,113,140,78,106,66,118,0.8,27,28,52
OceanDNA-b6493,685,11.8,0.0,1.2e-05,0.0045,104,143,425,464,416,492,0.8,39,39,76
OceanDNA-b23417,1309,16.0,0.1,6.6e-07,0.00096,114,153,577,617,562,621,0.8,39,40,59
OceanDNA-b22127,244,-4.1,0.1,0.44,740.0,49,64,131,146,129,150,0.8,15,15,21
OceanDNA-b32706,1844,13.7,0.0,1.6e-06,0.0032,53,167,48,166,22,169,0.8,114,118,147
OceanDNA-b22226,977,26.8,0.0,3.3e-10,2.8e-07,116,188,161,234,152,259,0.8,72,73,107
OceanDNA-b357,456,27.1,0.1,1.3e-10,6.9e-08,52,155,56,166,23,172,0.8,103,110,149
OceanDNA-b31124,86,16.2,0.0,2.8e-07,0.00018,83,194,179,297,170,309,0.8,111,118,139
OceanDNA-b44623,260,4.7,0.0,0.0018,1.9,160,211,611,662,605,677,0.8,51,51,72
OceanDNA-b3956,990,5.7,0.0,0.00044,0.46,162,232,191,259,180,267,0.8,70,68,87
OceanDNA-b36889,1742,15.5,0.1,4.6e-07,0.0012,53,142,78,172,63,264,0.8,89,94,201
OceanDNA-b41152,264,16.1,0.1,8.6e-07,0.00065,41,159,112,235,94,249,0.8,118,123,155
OceanDNA-b23261,218,6.7,0.0,0.00045,0.53,185,233,228,275,199,291,0.8,48,47,92
OceanDNA-b22397,559,12.9,0.0,1.1e-05,0.0075,116,147,262,293,241,302,0.8,31,31,61
OceanDNA-b27525,414,5.7,0.0,0.0018,1.2,166,195,253,282,231,306,0.8,29,29,75
OceanDNA-b45514,593,14.5,0.0,8.9e-07,0.0018,114,153,228,267,193,284,0.8,39,39,91
OceanDNA-b8078,199,12.2,0.0,4.8e-06,0.001,113,152,164,204,145,213,0.8,39,40,68
OceanDNA-b33061,3028,13.1,0.0,4.9e-06,0.0077,43,151,76,185,41,228,0.8,108,109,187
OceanDNA-b34918,458,13.6,0.0,3.4e-06,0.0018,105,144,170,210,163,223,0.8,39,40,60
OceanDNA-b35378,46,5.7,0.0,0.00044,0.73,152,230,180,256,157,262,0.8,78,76,105
OceanDNA-b1965,72,19.3,0.0,3.2e-08,1e-05,40,142,52,159,38,168,0.8,102,107,130
OceanDNA-b31070,1116,11.6,0.0,2.7e-05,0.021,116,182,122,191,85,207,0.8,66,69,122
OceanDNA-b40669,87,9.6,0.0,5.9e-05,0.019,156,210,219,271,187,284,0.8,54,52,97
OceanDNA-b20944,992,-0.4,0.0,0.033,58.0,163,181,209,227,186,233,0.8,18,18,47
OceanDNA-b20820,150,20.1,0.0,1.8e-08,1e-05,113,157,233,278,206,286,0.8,44,45,80
OceanDNA-b16777,232,8.0,0.0,0.00027,0.26,157,210,224,274,217,298,0.8,53,50,81
OceanDNA-b45886,179,11.5,0.1,7.7e-06,0.004,72,146,92,166,73,239,0.8,74,74,166
OceanDNA-b45442,308,12.5,0.0,1.1e-05,0.0055,118,148,218,248,200,258,0.8,30,30,58
OceanDNA-b22528,305,17.2,0.0,1.4e-07,0.00012,113,145,56,88,32,103,0.8,32,32,71
OceanDNA-b13088,1543,0.6,0.0,0.033,60.0,198,229,231,263,224,267,0.8,31,32,43
OceanDNA-b33328,1067,7.5,0.0,0.00013,0.15,111,141,21,51,3,69,0.8,30,30,66
OceanDNA-b22801,1851,-2.5,0.3,0.28,350.0,33,55,332,353,327,363,0.8,22,21,36
OceanDNA-b3605,1028,3.2,0.0,0.005,4.9,162,210,276,320,252,337,0.8,48,44,85
OceanDNA-b45813,470,1.4,0.0,0.0093,10.0,162,194,295,326,285,336,0.8,32,31,51
OceanDNA-b6501,201,0.4,0.0,0.053,9.1,196,230,222,257,194,293,0.8,34,35,99
OceanDNA-b22174,57,11.3,0.0,8.8e-06,0.0052,104,157,504,559,493,565,0.8,53,55,72
OceanDNA-b34663,386,2.0,0.0,0.017,4.8,105,144,481,521,445,531,0.8,39,40,86
OceanDNA-b19896,68,19.5,0.0,2.7e-08,1.1e-05,109,156,295,342,266,362,0.8,47,47,96
OceanDNA-b44368,64,11.3,0.0,8.4e-06,0.0019,116,149,169,202,138,215,0.8,33,33,77
OceanDNA-b4346,36,29.0,0.0,6.7e-11,8.3e-09,117,206,144,235,132,246,0.8,89,91,114
OceanDNA-b24005,575,1.6,0.0,0.0077,14.0,105,155,492,542,485,557,0.8,50,50,72
OceanDNA-b36577,573,11.7,0.0,1.3e-05,0.013,104,144,82,120,71,132,0.8,40,38,61
OceanDNA-b46625,322,16.8,0.0,5.5e-07,0.00017,109,153,113,160,104,167,0.8,44,47,63
OceanDNA-b12085,434,43.9,0.1,1e-15,4.7e-13,74,209,86,226,44,235,0.8,135,140,191
OceanDNA-b20979,1809,29.2,0.0,6.1e-11,7.7e-08,31,151,204,325,191,332,0.8,120,121,141
OceanDNA-b2828,2148,-3.1,0.0,0.43,770.0,158,183,186,211,171,214,0.8,25,25,43
OceanDNA-b41223,916,11.7,0.0,6.7e-06,0.013,86,174,113,200,40,246,0.8,88,87,206
OceanDNA-b3681,100,6.2,0.0,0.00031,0.46,126,153,122,149,42,162,0.8,27,27,120
OceanDNA-b3407,1043,11.3,0.0,8.7e-06,0.013,58,134,107,186,101,195,0.8,76,79,94
OceanDNA-b35286,34,12.0,0.0,5.3e-06,0.0036,121,146,146,171,123,189,0.8,25,25,66
OceanDNA-b16046,1508,12.5,0.1,3.8e-06,0.011,42,151,54,167,38,174,0.8,109,113,136
OceanDNA-b20129,312,34.9,0.0,5.5e-13,1.9e-10,115,211,135,241,71,249,0.8,96,106,178
OceanDNA-b33195,96,-0.3,0.0,0.029,21.0,197,229,230,263,201,264,0.8,32,33,63
OceanDNA-b30970,2355,2.6,0.0,0.012,9.5,196,231,222,258,188,280,0.8,35,36,92
OceanDNA-b40474,484,28.1,0.0,1.3e-10,6.1e-08,118,210,145,243,100,262,0.8,92,98,162
OceanDNA-b937,2162,-1.4,0.0,0.065,140.0,120,145,93,118,79,128,0.8,25,25,49
OceanDNA-b41583,245,8.8,0.3,5.1e-05,0.033,118,151,162,195,42,213,0.8,33,33,171
OceanDNA-b35232,255,13.7,0.0,1.6e-06,0.0011,71,142,34,112,13,140,0.8,71,78,127
OceanDNA-b22220,1,25.6,0.0,7.6e-10,6.6e-07,118,191,83,157,73,180,0.8,73,74,107
OceanDNA-b20991,1080,17.2,0.0,2.7e-07,0.00025,118,193,254,335,231,359,0.8,75,81,128
OceanDNA-b22498,2435,13.0,0.0,5.4e-06,0.0083,114,154,151,192,135,201,0.8,40,41,66
OceanDNA-b40474,364,12.9,0.0,5.6e-06,0.0027,108,155,108,157,96,177,0.8,47,49,81
OceanDNA-b29381,649,17.3,0.0,1.3e-07,0.00012,56,144,103,198,95,210,0.8,88,95,115
OceanDNA-b3867,56,10.2,0.0,1.9e-05,0.03,139,227,193,278,187,279,0.8,88,85,92
OceanDNA-b265,134,27.7,0.0,1.7e-10,1.5e-07,113,209,150,247,110,254,0.8,96,97,144
OceanDNA-b3242,329,4.2,0.0,0.0012,1.0,158,210,250,302,239,314,0.8,52,52,75
OceanDNA-b41523,206,-0.7,0.0,0.039,42.0,162,184,241,263,200,276,0.8,22,22,76
OceanDNA-b20977,2184,12.1,0.0,1.5e-05,0.019,115,154,207,246,147,253,0.8,39,39,106
OceanDNA-b3419,139,1.3,0.0,0.0097,13.0,90,109,209,228,202,249,0.8,19,19,47
OceanDNA-b39756,146,-2.3,0.0,0.24,51.0,53,83,186,216,178,221,0.8,30,30,43
OceanDNA-b3975,475,17.2,0.0,4.1e-07,0.00011,104,152,137,186,120,195,0.8,48,49,75
OceanDNA-b2854,2986,-1.3,0.0,0.18,210.0,163,195,245,276,224,292,0.8,32,31,68
OceanDNA-b3656,205,12.4,0.1,7.9e-06,0.0021,98,146,116,163,76,179,0.8,48,47,103
OceanDNA-b18642,124,23.6,0.0,1.5e-09,5.4e-07,102,152,118,167,98,196,0.8,50,49,98
OceanDNA-b30043,1162,4.1,0.1,0.0027,2.7,164,231,195,260,183,263,0.8,67,65,80
OceanDNA-b30641,995,5.3,0.2,0.0012,0.65,164,231,231,296,219,300,0.8,67,65,81
OceanDNA-b6744,363,12.9,0.0,2.8e-06,0.0017,163,208,228,269,219,281,0.8,45,41,62
OceanDNA-b33525,417,2.2,0.0,0.0052,19.0,160,216,282,335,271,350,0.8,56,53,79
OceanDNA-b23976,1658,12.6,0.0,6.8e-06,0.006,70,153,63,145,36,164,0.8,83,82,128
OceanDNA-b45271,128,16.0,0.0,3.2e-07,0.00016,55,145,168,261,154,279,0.8,90,93,125
OceanDNA-b6211,233,15.5,0.0,4.6e-07,0.00017,105,150,110,155,96,169,0.8,45,45,73
OceanDNA-b27448,73,17.9,0.0,8.3e-08,2.2e-05,153,230,307,386,293,389,0.8,77,79,96
OceanDNA-b22806,2866,-2.1,0.0,0.32,490.0,86,119,122,158,112,162,0.8,33,36,50
OceanDNA-b31948,631,12.1,0.1,9.5e-06,0.011,96,137,287,327,244,344,0.8,41,40,100
OceanDNA-b45686,408,21.7,0.0,5.7e-09,3.1e-06,106,154,151,199,135,255,0.8,48,48,120
OceanDNA-b4002,353,12.3,0.0,4.3e-06,0.0058,73,141,575,649,474,673,0.8,68,74,199
OceanDNA-b21042,1174,15.9,0.5,3.5e-07,0.00087,50,150,315,414,293,419,0.8,100,99,126
OceanDNA-b29589,1432,10.8,0.1,2.5e-05,0.04,50,150,78,182,55,197,0.8,100,104,142
OceanDNA-b35333,154,17.0,0.0,1.6e-07,5.2e-05,42,147,41,152,20,161,0.8,105,111,141
OceanDNA-b2829,365,-1.5,0.0,0.14,220.0,163,192,144,173,127,183,0.8,29,29,56
OceanDNA-b13249,71,21.4,0.1,2.1e-08,6.4e-06,105,175,54,128,13,164,0.8,70,74,151
OceanDNA-b2829,365,11.3,0.0,1.8e-05,0.027,105,151,57,104,45,117,0.8,46,47,72
OceanDNA-b7395,173,15.0,0.0,6.4e-07,0.00017,114,159,140,186,122,219,0.8,45,46,97
OceanDNA-b46839,919,12.5,0.0,7.2e-06,0.0046,118,153,203,239,177,256,0.8,35,36,79
OceanDNA-b9171,380,15.2,0.0,1.1e-06,0.00023,121,160,112,152,94,159,0.8,39,40,65
OceanDNA-b22256,248,19.4,0.0,3e-08,5.7e-05,103,152,144,188,129,256,0.8,49,44,127
OceanDNA-b23145,1394,0.4,0.0,0.037,39.0,51,86,67,102,60,108,0.8,35,35,48
OceanDNA-b28083,1033,5.9,0.0,0.00075,0.64,197,236,223,261,196,278,0.8,39,38,82
OceanDNA-b9687,373,10.7,0.0,2.6e-05,0.012,162,232,198,266,187,273,0.8,70,68,86
OceanDNA-b28040,422,2.2,0.1,0.0052,3.3,119,154,136,172,125,195,0.8,35,36,70
OceanDNA-b37593,2183,1.7,0.0,0.0075,19.0,103,140,153,191,137,212,0.8,37,38,75
OceanDNA-b6771,803,14.3,0.0,3.2e-06,0.001,116,193,124,205,113,222,0.8,77,81,109
OceanDNA-b31056,401,7.5,0.0,0.00038,0.39,126,164,144,186,74,195,0.8,38,42,121
OceanDNA-b33104,283,20.0,0.0,3.7e-08,6.2e-05,42,142,75,181,53,192,0.8,100,106,139
OceanDNA-b23850,7,4.4,0.0,0.0032,1.6,198,231,231,266,224,271,0.8,33,35,47
OceanDNA-b29385,284,0.9,0.0,0.039,43.0,73,107,47,80,41,90,0.8,34,33,49
OceanDNA-b22306,1201,-1.4,0.0,0.066,110.0,69,88,183,202,146,207,0.8,19,19,61
OceanDNA-b15769,787,27.3,0.0,3.4e-10,2e-07,45,169,27,160,12,196,0.8,124,133,184
OceanDNA-b46553,591,14.4,0.0,9.7e-07,0.0014,118,154,143,180,114,204,0.8,36,37,90
OceanDNA-b36587,1116,7.5,0.0,0.00012,0.21,157,188,274,305,237,317,0.8,31,31,80
OceanDNA-b29385,2659,-1.5,0.0,0.2,230.0,216,252,580,618,573,620,0.8,36,38,47
OceanDNA-b2508,837,5.5,0.0,0.00052,0.57,116,150,327,361,310,368,0.8,34,34,58
OceanDNA-b24623,456,9.5,0.0,3.1e-05,0.019,103,151,85,131,39,164,0.8,48,46,125
OceanDNA-b32,528,10.7,0.0,2.6e-05,0.0081,112,142,132,162,67,169,0.8,30,30,102
OceanDNA-b3696,1147,0.2,0.0,0.021,52.0,119,148,194,224,178,242,0.8,29,30,64
OceanDNA-b32135,345,3.9,0.0,0.0015,4.0,158,215,211,269,194,275,0.8,57,58,81
OceanDNA-b41233,2246,0.7,0.0,0.015,43.0,119,139,98,118,84,134,0.8,20,20,50
OceanDNA-b21004,811,6.0,0.0,0.0011,0.69,159,187,155,183,129,214,0.8,28,28,85
OceanDNA-b34793,517,11.4,0.1,7.8e-06,0.0064,121,150,149,178,129,186,0.8,29,29,57
OceanDNA-b40445,1103,10.9,0.1,1.1e-05,0.018,33,103,3,72,1,127,0.8,70,69,126
OceanDNA-b43651,721,16.0,0.0,3.3e-07,0.00032,88,221,97,228,31,241,0.8,133,131,210
OceanDNA-b32628,251,11.0,0.0,1.1e-05,0.0035,56,146,55,149,47,166,0.8,90,94,119
OceanDNA-b11002,150,12.2,0.0,4.5e-06,0.0012,115,190,148,224,138,247,0.8,75,76,109
OceanDNA-b6424,365,4.0,0.0,0.0045,0.92,196,230,220,255,190,258,0.8,34,35,68
OceanDNA-b38692,169,11.5,0.0,7.7e-06,0.0047,121,150,147,176,120,225,0.8,29,29,105
OceanDNA-b6288,386,14.5,0.0,9.1e-07,0.00043,100,231,28,160,14,164,0.8,131,132,150
OceanDNA-b20995,1937,14.7,0.2,1.6e-06,0.004,115,180,386,454,359,485,0.8,65,68,126
OceanDNA-b30854,1876,21.0,0.1,1.9e-08,2.1e-05,47,148,106,214,81,227,0.8,101,108,146
OceanDNA-b23165,145,0.1,0.0,0.023,70.0,54,86,135,167,114,178,0.8,32,32,64
OceanDNA-b22406,2419,12.9,0.0,1.1e-05,0.008,113,154,442,484,408,516,0.8,41,42,108
OceanDNA-b9777,817,14.5,0.0,9.2e-07,0.0011,57,145,63,146,58,155,0.8,88,83,97
OceanDNA-b17091,30,3.3,0.0,0.0048,2.6,122,145,141,164,115,177,0.8,23,23,62
OceanDNA-b33388,2196,-0.1,0.0,0.13,100.0,160,184,206,229,196,242,0.8,24,23,46
OceanDNA-b46252,1934,11.7,0.0,2.6e-05,0.015,117,151,231,266,214,277,0.8,34,35,63
OceanDNA-b34630,236,18.1,0.0,1.5e-07,6.9e-05,73,167,102,193,74,208,0.8,94,91,134
OceanDNA-b46697,119,13.0,0.0,5.2e-06,0.0052,119,165,145,192,130,246,0.8,46,47,116
OceanDNA-b23315,272,14.4,0.0,1e-06,0.0041,74,145,130,198,119,210,0.8,71,68,91
OceanDNA-b35857,444,7.7,0.0,0.00011,0.049,157,228,233,300,220,302,0.8,71,67,82
OceanDNA-b42863,284,0.3,0.0,0.019,5.9,62,84,48,70,24,79,0.8,22,22,55
OceanDNA-b22353,82,12.2,0.0,9e-06,0.0051,115,168,155,209,134,231,0.8,53,54,97
OceanDNA-b40444,1625,13.5,0.0,7.6e-06,0.0035,40,133,80,174,75,187,0.8,93,94,112
OceanDNA-b32385,103,9.0,0.0,4.4e-05,0.014,145,182,177,215,164,229,0.8,37,38,65
OceanDNA-b22893,2192,-0.4,0.0,0.096,75.0,6,46,142,182,137,192,0.8,40,40,55
OceanDNA-b44662,1421,21.4,0.3,1.4e-08,1.9e-05,56,145,584,679,573,685,0.8,89,95,112
OceanDNA-b44496,119,16.8,0.0,1.9e-07,6.8e-05,112,150,131,171,117,181,0.8,38,40,64
OceanDNA-b35828,625,3.8,0.1,0.0017,1.5,124,145,122,143,59,156,0.8,21,21,97
OceanDNA-b22965,160,15.4,0.0,9.9e-07,0.0022,57,136,94,172,59,182,0.8,79,78,123
OceanDNA-b23561,1571,-0.8,0.0,0.042,96.0,72,100,157,186,140,198,0.8,28,29,58
OceanDNA-b36473,1282,11.5,0.4,7.3e-06,0.023,117,152,91,125,66,131,0.8,35,34,65
OceanDNA-b33096,702,14.3,0.0,3.2e-06,0.0014,118,146,162,190,147,222,0.8,28,28,75
OceanDNA-b40232,803,18.9,0.1,1.2e-07,9.5e-05,118,155,158,195,138,252,0.8,37,37,114
OceanDNA-b22654,724,18.5,0.0,2.7e-07,6.7e-05,95,182,45,128,12,159,0.8,87,83,147
OceanDNA-b30346,1949,7.0,0.0,0.00018,0.38,114,153,102,141,78,160,0.8,39,39,82
OceanDNA-b17633,332,12.4,0.0,3.9e-06,0.0029,156,195,233,271,220,301,0.8,39,38,81
OceanDNA-b46722,1229,12.5,0.0,1.1e-05,0.0059,42,135,74,169,69,183,0.8,93,95,114
OceanDNA-b3865,332,14.4,0.0,9.5e-07,0.00033,119,198,146,230,123,243,0.8,79,84,120
OceanDNA-b23655,661,5.6,0.0,0.00049,0.91,112,145,133,166,103,179,0.8,33,33,76
OceanDNA-b17068,1832,4.6,0.0,0.00098,1.9,122,148,158,184,139,209,0.8,26,26,70
OceanDNA-b11397,196,10.1,0.0,2e-05,0.013,104,152,99,149,71,161,0.8,48,50,90
OceanDNA-b6750,317,15.9,0.0,1.1e-06,0.00026,48,154,157,265,152,296,0.8,106,108,144
OceanDNA-b23038,420,12.5,0.0,3.7e-06,0.0087,101,155,556,608,551,615,0.8,54,52,64
OceanDNA-b17083,134,13.1,0.0,2.5e-06,0.0024,38,151,26,143,9,150,0.8,113,117,141
OceanDNA-b27289,163,15.0,0.0,6.6e-07,0.00015,108,153,89,132,79,143,0.8,45,43,64
OceanDNA-b21018,732,8.2,0.0,7.4e-05,0.25,122,146,144,168,106,178,0.8,24,24,72
OceanDNA-b17091,30,9.9,0.0,4.5e-05,0.025,163,208,208,251,187,257,0.8,45,43,70
OceanDNA-b9784,27,-3.7,0.0,0.67,400.0,99,131,304,336,300,347,0.8,32,32,47
OceanDNA-b8264,293,12.0,0.0,1.1e-05,0.0039,102,150,118,165,107,179,0.8,48,47,72
OceanDNA-b20340,342,11.6,0.0,7e-06,0.0029,106,141,154,189,138,204,0.8,35,35,66
OceanDNA-b14889,138,12.3,0.0,4.3e-06,0.00099,54,146,26,114,14,130,0.8,92,88,116
OceanDNA-b30408,365,7.2,0.0,0.00031,0.35,131,194,283,348,275,369,0.8,63,65,94
OceanDNA-b44384,279,12.1,0.0,4.9e-06,0.0049,153,227,328,402,286,406,0.8,74,74,120
OceanDNA-b34923,521,12.8,0.0,3e-06,0.0023,164,213,222,271,206,289,0.8,49,49,83
OceanDNA-b22998,423,12.7,0.0,3.1e-06,0.0031,104,157,326,379,316,391,0.8,53,53,75
OceanDNA-b13103,184,11.4,0.0,1.6e-05,0.0073,118,167,148,197,140,222,0.8,49,49,82
OceanDNA-b4489,579,-0.8,0.0,0.042,27.0,223,256,7,40,5,45,0.8,33,33,40
OceanDNA-b11316,235,13.4,0.0,4e-06,0.00066,117,197,171,251,147,280,0.8,80,80,133
OceanDNA-a3737,266,7.3,0.0,0.00015,0.042,148,182,157,194,151,206,0.8,34,37,55
OceanDNA-b16140,391,8.9,0.0,9.3e-05,0.043,112,154,216,258,190,275,0.8,42,42,85
OceanDNA-b22830,763,13.7,0.0,3.1e-06,0.0072,119,179,165,224,100,233,0.8,60,59,133
OceanDNA-b12220,283,40.7,0.0,9.3e-15,3.8e-12,109,215,26,142,11,147,0.8,106,116,136
OceanDNA-b15630,121,24.1,0.1,1e-09,4.9e-07,45,154,26,143,15,157,0.79,109,117,142
OceanDNA-b17764,2398,16.0,0.0,3.2e-07,0.0015,72,150,128,216,112,236,0.79,78,88,124
OceanDNA-b19603,348,13.3,0.0,2.1e-06,0.00081,44,136,34,127,3,145,0.79,92,93,142
OceanDNA-b20988,1849,10.9,0.0,1.1e-05,0.022,49,150,279,386,242,453,0.79,101,107,211
OceanDNA-b46557,237,14.5,0.0,1.8e-06,0.00044,117,159,142,187,129,202,0.79,42,45,73
OceanDNA-b1510,849,10.8,0.1,1.2e-05,0.012,94,155,94,150,81,170,0.79,61,56,89
OceanDNA-b9761,970,19.8,0.0,2.2e-08,2.4e-05,40,177,94,242,80,295,0.79,137,148,215
OceanDNA-b13654,77,2.8,0.0,0.0035,2.0,122,140,94,112,67,139,0.79,18,18,72
OceanDNA-b37122,207,0.6,0.0,0.015,15.0,160,192,201,233,193,250,0.79,32,32,57
OceanDNA-b45634,308,12.9,0.0,8.2e-06,0.002,116,153,227,264,186,274,0.79,37,37,88
OceanDNA-b27525,1050,4.0,0.0,0.0059,4.0,134,211,330,412,322,424,0.79,77,82,102
OceanDNA-b9724,486,10.4,0.2,1.7e-05,0.0081,139,208,196,262,190,280,0.79,69,66,90
OceanDNA-b22518,396,-2.5,0.0,0.14,510.0,92,127,387,426,383,437,0.79,35,39,54
OceanDNA-b33419,741,11.7,0.0,6.7e-06,0.01,120,143,142,165,113,185,0.79,23,23,72
OceanDNA-b14831,96,-1.9,0.0,0.095,26.0,191,220,72,101,54,111,0.79,29,29,57
OceanDNA-b30174,1996,2.1,0.1,0.0055,12.0,165,229,290,352,278,354,0.79,64,62,76
OceanDNA-b9746,56,-1.9,0.0,0.095,65.0,125,137,148,160,136,171,0.79,12,12,35
OceanDNA-b8073,260,11.9,0.0,5.7e-06,0.0015,104,152,129,179,119,212,0.79,48,50,93
OceanDNA-b22991,2903,19.7,0.0,4.8e-08,0.00011,45,154,273,388,261,418,0.79,109,115,157
OceanDNA-b20922,5902,10.5,0.0,4.6e-05,0.11,105,160,445,501,427,511,0.79,55,56,84
OceanDNA-b22193,201,12.8,0.0,2.9e-06,0.0039,100,152,303,357,288,413,0.79,52,54,125
OceanDNA-b35292,446,14.3,0.1,1.1e-06,0.001,40,159,87,211,69,227,0.79,119,124,158
OceanDNA-b22926,1352,15.6,0.0,4.3e-07,0.002,100,155,172,226,166,239,0.79,55,54,73
OceanDNA-b22991,4364,13.6,0.0,3.4e-06,0.0077,157,231,204,276,197,281,0.79,74,72,84
OceanDNA-b7431,155,10.4,0.0,1.6e-05,0.0058,124,195,127,204,119,218,0.79,71,77,99
OceanDNA-b26935,170,8.5,0.0,6.2e-05,0.016,162,227,329,396,307,401,0.79,65,67,94
OceanDNA-b23525,1023,3.7,0.0,0.0018,3.6,162,233,200,269,187,282,0.79,71,69,95
OceanDNA-b16227,471,7.7,0.0,0.00031,0.11,98,148,367,418,360,425,0.79,50,51,65
OceanDNA-b38157,181,7.7,0.0,0.00021,0.076,116,149,159,194,138,209,0.79,33,35,71
OceanDNA-b33298,1568,3.5,0.1,0.002,4.0,165,233,207,273,193,288,0.79,68,66,95
OceanDNA-b42263,77,15.0,0.0,6.6e-07,0.0001,49,140,73,168,49,178,0.79,91,95,129
OceanDNA-b30225,956,11.5,0.0,1.5e-05,0.019,119,144,147,172,140,210,0.79,25,25,70
OceanDNA-b23394,910,15.3,0.0,5.2e-07,0.0013,116,155,825,864,786,895,0.79,39,39,109
OceanDNA-b15465,164,1.1,0.0,0.033,12.0,122,143,144,165,115,174,0.79,21,21,59
OceanDNA-b37527,1378,11.9,0.1,1.1e-05,0.013,69,143,82,160,56,171,0.79,74,78,115
OceanDNA-b29530,932,11.5,0.1,7.6e-06,0.025,117,156,104,144,97,172,0.79,39,40,75
OceanDNA-b18150,166,23.7,0.0,1.4e-09,2.4e-07,112,157,238,283,219,311,0.79,45,45,92
OceanDNA-b41418,435,5.1,0.0,0.00067,0.58,162,183,237,258,222,302,0.79,21,21,80
OceanDNA-b45663,568,7.4,0.0,0.00027,0.12,161,226,184,246,176,250,0.79,65,62,74
OceanDNA-b36161,572,10.6,0.0,1.4e-05,0.028,110,146,194,232,171,242,0.79,36,38,71
OceanDNA-b30483,397,10.6,0.1,1.4e-05,0.033,120,162,105,151,44,163,0.79,42,46,119
OceanDNA-b423,584,10.8,0.0,1.2e-05,0.012,160,220,341,399,310,408,0.79,60,58,98
OceanDNA-b6944,24,11.7,0.0,6.6e-06,0.0016,116,206,143,235,118,248,0.79,90,92,130
OceanDNA-b23918,382,10.8,0.0,2.4e-05,0.023,69,152,74,156,50,172,0.79,83,82,122
OceanDNA-b939,1621,13.4,0.0,2e-06,0.0041,113,153,92,132,80,174,0.79,40,40,94
OceanDNA-b26433,1379,19.3,0.0,3e-08,5e-05,54,144,56,150,42,168,0.79,90,94,126
OceanDNA-b22890,202,1.6,0.0,0.016,17.0,158,197,255,294,245,329,0.79,39,39,84
OceanDNA-b22890,202,14.9,0.0,1.4e-06,0.0015,113,145,181,214,143,235,0.79,32,33,92
OceanDNA-b23108,1029,20.6,0.0,2.6e-08,2.6e-05,102,160,390,448,343,481,0.79,58,58,138
OceanDNA-b33283,2262,12.6,0.0,3.6e-06,0.012,59,142,45,126,34,138,0.79,83,81,104
OceanDNA-b40713,137,-1.0,0.0,0.099,40.0,16,45,183,211,176,217,0.79,29,28,41
OceanDNA-b960,417,37.4,0.1,9.2e-14,1.9e-10,56,210,256,417,237,437,0.79,154,161,200
OceanDNA-b37042,570,12.2,0.2,4.5e-06,0.0045,75,154,54,129,12,160,0.79,79,75,148
OceanDNA-b9656,512,18.0,0.0,7.9e-08,5.6e-05,62,177,111,235,77,271,0.79,115,124,194
OceanDNA-b22324,3930,23.7,0.0,7.3e-09,6e-06,25,177,73,238,56,279,0.79,152,165,223
OceanDNA-b17084,288,9.0,0.0,4.3e-05,0.047,161,201,211,250,196,261,0.79,40,39,65
OceanDNA-b22324,2449,-2.8,0.0,0.87,710.0,155,194,359,397,355,400,0.79,39,38,45
OceanDNA-b30874,1412,16.6,0.0,2.1e-07,0.0005,49,148,63,170,50,187,0.79,99,107,137
OceanDNA-b26917,1112,3.3,0.0,0.0049,3.8,164,234,204,272,189,285,0.79,70,68,96
OceanDNA-b13084,1039,11.7,0.1,1.3e-05,0.016,34,133,47,147,20,160,0.79,99,100,140
OceanDNA-b34300,355,12.4,0.0,8.3e-06,0.0036,78,152,68,134,18,190,0.79,74,66,172
OceanDNA-b17623,2903,-0.9,0.0,0.092,140.0,16,45,191,219,184,226,0.79,29,28,42
OceanDNA-a485,127,33.8,0.0,1.2e-12,3.8e-10,40,183,158,309,129,342,0.79,143,151,213
OceanDNA-b32306,131,10.0,0.0,2.1e-05,0.0085,144,187,174,218,151,256,0.79,43,44,105
OceanDNA-b31130,128,5.9,0.0,0.00039,0.22,164,222,331,387,303,398,0.79,58,56,95
OceanDNA-b26825,261,10.3,0.0,1.7e-05,0.018,126,152,120,146,16,162,0.79,26,26,146
OceanDNA-b3635,2176,10.2,0.0,3.7e-05,0.049,121,153,141,174,124,179,0.79,32,33,55
OceanDNA-b23584,2007,17.6,0.0,2.1e-07,0.00026,101,148,185,229,119,240,0.79,47,44,121
OceanDNA-b37118,444,16.6,0.1,2.1e-07,0.00018,40,139,72,181,50,197,0.79,99,109,147
OceanDNA-b41307,1384,6.6,0.0,0.00023,0.95,139,184,203,246,169,262,0.79,45,43,93
OceanDNA-b40959,1116,-1.4,0.0,0.063,200.0,212,255,82,123,71,127,0.79,43,41,56
OceanDNA-b38976,861,17.7,0.1,1.9e-07,0.00012,24,154,34,175,13,242,0.79,130,141,229
OceanDNA-b27416,97,0.9,0.0,0.013,3.4,163,213,305,352,292,368,0.79,50,47,76
OceanDNA-b6759,143,10.7,0.0,1.3e-05,0.0098,110,155,134,179,86,187,0.79,45,45,101
OceanDNA-b24935,1054,12.7,0.1,3.3e-06,0.0084,100,160,119,184,92,215,0.79,60,65,123
OceanDNA-b42274,30,14.6,0.1,8.3e-07,0.00017,49,140,86,181,50,190,0.79,91,95,140
OceanDNA-b45222,860,-1.5,0.0,0.072,180.0,108,143,4,39,2,53,0.79,35,35,51
OceanDNA-b11616,217,3.1,0.0,0.0028,2.8,230,248,322,340,285,350,0.79,18,18,65
OceanDNA-b36886,1428,-3.5,0.0,0.29,520.0,203,226,28,50,22,57,0.79,23,22,35
OceanDNA-b22394,801,15.0,0.0,1.3e-06,0.0012,112,153,124,168,111,176,0.79,41,44,65
OceanDNA-b18796,201,26.7,0.1,1.8e-10,5e-08,89,156,266,337,253,397,0.79,67,71,144
OceanDNA-b22827,2769,11.4,0.0,3.2e-05,0.039,112,144,177,209,115,259,0.79,32,32,144
OceanDNA-b38966,1203,11.0,0.0,1.1e-05,0.023,71,151,266,357,243,389,0.79,80,91,146
OceanDNA-b16143,250,3.6,0.0,0.0038,1.6,148,210,398,460,382,464,0.79,62,62,82
OceanDNA-b6768,369,18.0,0.0,8e-08,5.9e-05,115,192,113,194,102,212,0.79,77,81,110
OceanDNA-b45444,359,7.9,0.0,9.4e-05,0.05,122,158,13,50,4,61,0.79,36,37,57
OceanDNA-b22394,92,25.4,0.0,8.8e-10,8.7e-07,114,209,204,303,190,311,0.79,95,99,121
OceanDNA-b38932,129,12.9,0.0,2.7e-06,0.0016,90,151,90,143,75,173,0.79,61,53,98
OceanDNA-b40439,284,10.0,0.0,4.4e-05,0.044,139,208,264,338,257,365,0.79,69,74,108
OceanDNA-b3626,407,7.1,0.0,0.00016,0.2,116,145,101,130,87,200,0.79,29,29,113
OceanDNA-b26126,494,6.1,0.0,0.00034,0.23,114,152,72,110,51,116,0.79,38,38,65
OceanDNA-b23148,1734,12.7,0.0,6.6e-06,0.0086,114,154,164,205,143,220,0.79,40,41,77
OceanDNA-b4060,782,11.0,0.0,2.1e-05,0.0082,119,150,142,173,53,183,0.79,31,31,130
OceanDNA-b12606,355,10.6,0.0,1.4e-05,0.0071,91,150,85,147,69,154,0.79,59,62,85
OceanDNA-b46299,304,9.6,0.3,8.8e-05,0.14,91,150,238,294,194,304,0.79,59,56,110
OceanDNA-b114,76,21.7,1.2,5.8e-09,2.6e-06,32,154,261,394,236,400,0.79,122,133,164
OceanDNA-b288,2663,29.0,0.0,3.5e-11,1.1e-07,93,210,204,317,150,327,0.79,117,113,177
OceanDNA-b26823,1130,23.7,0.1,1.4e-09,5.3e-06,46,140,124,229,104,239,0.79,94,105,135
OceanDNA-b10059,343,5.4,0.0,0.00055,0.25,116,155,39,78,24,90,0.79,39,39,66
OceanDNA-b29510,997,-2.4,0.0,0.39,320.0,47,62,206,221,201,233,0.79,15,15,32
OceanDNA-b46505,99,12.4,0.1,8e-06,0.0086,118,154,264,301,249,310,0.79,36,37,61
OceanDNA-b27545,1368,5.3,0.1,0.00059,1.3,167,231,194,256,184,259,0.79,64,62,75
OceanDNA-b31005,2016,8.1,0.1,8.3e-05,0.23,115,152,162,198,108,216,0.79,37,36,108
OceanDNA-b39181,167,11.7,0.0,6.3e-06,0.0028,118,148,150,180,121,194,0.79,30,30,73
OceanDNA-b31131,267,12.3,0.0,8.6e-06,0.0029,124,201,80,158,26,212,0.79,77,78,186
OceanDNA-b10018,226,11.7,0.0,6.4e-06,0.0045,136,190,149,205,131,241,0.79,54,56,110
OceanDNA-b46925,462,10.6,0.0,1.4e-05,0.027,118,148,246,276,229,293,0.79,30,30,64
OceanDNA-b18620,306,17.5,0.0,2.2e-07,4.6e-05,99,152,115,167,108,195,0.79,53,52,87
OceanDNA-b13087,1025,11.1,0.2,9.8e-06,0.017,33,139,151,256,138,268,0.79,106,105,130
OceanDNA-b15459,1164,9.3,0.0,3.5e-05,0.042,152,183,202,233,181,263,0.79,31,31,82
OceanDNA-b31304,96,11.8,0.1,6.2e-06,0.0071,116,150,77,111,30,117,0.79,34,34,87
OceanDNA-b17068,1832,5.6,0.0,0.00047,0.91,162,208,224,268,212,272,0.79,46,44,60
OceanDNA-b16182,508,9.1,0.0,3.9e-05,0.025,30,85,129,192,118,195,0.79,55,63,77
OceanDNA-b11344,671,39.1,0.0,2.8e-14,2e-11,41,205,58,238,31,253,0.79,164,180,222
OceanDNA-b46641,1672,-3.9,0.0,0.37,720.0,164,188,181,205,180,208,0.79,24,24,28
OceanDNA-b3315,1347,10.7,0.0,2.6e-05,0.047,54,151,44,139,34,158,0.79,97,95,124
OceanDNA-b9322,239,12.5,0.0,3.7e-06,0.00098,114,154,93,134,77,176,0.79,40,41,99
OceanDNA-b3681,100,6.2,0.0,0.00032,0.47,168,230,209,269,199,275,0.79,62,60,76
OceanDNA-b15286,254,11.2,0.0,1.8e-05,0.0023,112,152,108,146,96,152,0.79,40,38,56
OceanDNA-b32913,49,27.3,0.0,2.2e-10,2.1e-07,69,147,142,228,123,234,0.79,78,86,111
OceanDNA-b36722,553,7.7,0.0,0.00011,0.11,124,146,145,167,117,176,0.79,22,22,59
OceanDNA-b26770,298,29.2,0.0,3e-11,4.3e-08,46,141,569,675,563,689,0.79,95,106,126
OceanDNA-b40768,338,15.1,0.0,1.2e-06,0.00037,120,146,160,186,139,206,0.79,26,26,67
OceanDNA-b33096,1031,8.6,0.0,0.00017,0.073,152,183,185,216,138,224,0.79,31,31,86
OceanDNA-b41510,1344,13.6,0.0,1.7e-06,0.003,42,133,71,163,66,188,0.79,91,92,122
OceanDNA-b46625,176,15.2,0.0,1.7e-06,0.00051,104,158,292,346,280,356,0.79,54,54,76
OceanDNA-b17034,755,12.9,0.0,5.8e-06,0.0027,113,141,186,214,174,239,0.79,28,28,65
OceanDNA-b34789,327,11.2,0.0,9.3e-06,0.0069,123,150,155,182,125,198,0.79,27,27,73
OceanDNA-b37060,975,-3.6,0.0,0.3,310.0,165,185,266,285,263,293,0.79,20,19,30
OceanDNA-b44168,3,10.3,0.0,1.7e-05,0.0091,114,150,78,114,36,151,0.79,36,36,115
OceanDNA-b19307,78,16.3,0.0,2.7e-07,7.4e-05,116,154,356,395,333,443,0.79,38,39,110
OceanDNA-b3909,235,14.9,0.0,1.4e-06,0.00088,116,151,159,194,144,243,0.79,35,35,99
OceanDNA-b30224,1631,17.0,0.0,1.6e-07,0.00029,49,138,105,201,96,213,0.79,89,96,117
OceanDNA-b3624,700,4.9,0.0,0.00076,0.61,156,185,229,258,196,276,0.79,29,29,80
OceanDNA-b36153,427,3.3,0.0,0.0024,2.8,157,230,188,259,173,267,0.79,73,71,94
OceanDNA-b4003,552,10.9,0.0,1.2e-05,0.01,62,142,69,147,48,164,0.79,80,78,116
OceanDNA-b24103,2439,13.3,0.1,2.1e-06,0.0055,105,147,12,56,2,69,0.79,42,44,67
OceanDNA-b37543,1719,13.0,0.1,2.6e-06,0.0064,39,154,56,175,28,244,0.79,115,119,216
OceanDNA-b21002,2996,19.6,0.1,5e-08,0.00014,48,146,184,295,158,306,0.79,98,111,148
OceanDNA-b1749,43,5.7,0.0,0.00045,0.83,160,186,211,237,203,271,0.79,26,26,68
OceanDNA-b45114,282,11.2,0.0,9.5e-06,0.011,161,214,174,223,155,240,0.79,53,49,85
OceanDNA-b29612,2274,11.2,0.2,9e-06,0.024,120,158,129,167,125,205,0.79,38,38,80
OceanDNA-b22383,3202,11.5,0.7,1.5e-05,0.026,125,153,134,162,63,178,0.79,28,28,115
OceanDNA-b13091,1267,12.8,0.0,2.9e-06,0.0079,118,180,177,241,164,250,0.79,62,64,86
OceanDNA-b3975,243,14.9,0.0,2.1e-06,0.00059,90,151,117,179,84,205,0.79,61,62,121
OceanDNA-b44627,133,10.3,0.0,5.1e-05,0.016,121,145,148,172,128,193,0.79,24,24,65
OceanDNA-b24623,456,5.6,0.0,0.00049,0.31,164,231,189,254,171,263,0.79,67,65,92
OceanDNA-b41265,427,-0.1,0.0,0.027,37.0,126,144,40,58,32,105,0.79,18,18,73
OceanDNA-b4442,33,15.6,0.0,4.2e-07,9.1e-05,163,229,608,676,589,678,0.79,66,68,89
OceanDNA-b39122,1487,15.7,0.0,3.9e-07,0.00091,69,154,80,176,5,247,0.79,85,96,242
OceanDNA-b23455,677,10.3,0.0,1.7e-05,0.041,112,144,164,197,153,219,0.79,32,33,66
OceanDNA-b4053,69,15.3,0.0,1e-06,0.00036,118,206,98,192,68,208,0.79,88,94,140
OceanDNA-b46693,1129,31.9,0.0,4.6e-12,1.1e-08,118,208,263,356,240,367,0.79,90,93,127
OceanDNA-b41011,471,5.0,0.0,0.00073,1.8,156,227,238,308,214,315,0.79,71,70,101
OceanDNA-b17030,137,4.9,0.0,0.00078,0.3,156,224,178,243,150,247,0.79,68,65,97
OceanDNA-b18640,3,21.9,0.0,1e-08,1.6e-06,97,153,113,168,90,203,0.79,56,55,113
OceanDNA-b42307,214,16.9,0.1,1.7e-07,3.9e-05,47,141,62,160,48,178,0.79,94,98,130
OceanDNA-b22460,3065,11.0,0.0,2.1e-05,0.037,73,142,84,154,73,169,0.79,69,70,96
OceanDNA-b13296,356,-1.1,0.0,0.053,54.0,144,183,295,334,289,353,0.79,39,39,64
OceanDNA-b19679,279,10.9,0.0,1.2e-05,0.004,119,192,137,211,121,243,0.79,73,74,122
OceanDNA-b6508,355,17.3,0.0,1.3e-07,0.00012,43,134,111,205,98,241,0.79,91,94,143
OceanDNA-b20094,30,0.5,0.0,0.052,6.6,53,85,141,173,131,187,0.79,32,32,56
OceanDNA-b30493,1068,12.9,0.1,2.8e-06,0.0041,134,219,242,327,219,334,0.79,85,85,115
OceanDNA-b22548,1091,-0.1,0.0,0.08,34.0,69,87,154,172,102,177,0.79,18,18,75
OceanDNA-b22999,1727,13.8,0.0,1.5e-06,0.003,118,151,136,169,120,201,0.79,33,33,81
OceanDNA-b44612,1129,6.4,0.0,0.00026,0.67,111,143,494,526,444,543,0.79,32,32,99
OceanDNA-b46558,138,16.5,0.0,4.5e-07,0.00014,104,155,39,90,23,103,0.79,51,51,80
OceanDNA-b41233,2246,8.2,0.0,7.8e-05,0.22,147,186,208,247,183,270,0.79,39,39,87
OceanDNA-b36726,158,13.9,0.0,1.3e-06,0.0011,119,150,146,177,123,193,0.79,31,31,70
OceanDNA-b26926,1267,21.4,0.1,7e-09,2e-05,49,147,127,232,115,237,0.79,98,105,122
OceanDNA-b1435,542,-0.9,0.0,0.092,39.0,163,193,256,285,250,291,0.79,30,29,41
OceanDNA-b10921,32,-0.3,0.0,0.029,6.2,114,155,443,484,431,492,0.79,41,41,61
OceanDNA-b10305,433,1.5,0.0,0.0085,3.8,116,155,261,300,247,311,0.79,39,39,64
OceanDNA-b23984,818,13.6,0.1,1.7e-06,0.0031,65,119,49,102,5,108,0.79,54,53,103
OceanDNA-b282,778,-2.8,0.0,0.34,250.0,178,207,22,51,19,58,0.79,29,29,39
OceanDNA-b29589,161,20.4,0.0,2.9e-08,4.7e-05,48,140,129,228,115,236,0.79,92,99,121
OceanDNA-b13256,114,34.4,0.0,5.3e-12,1.5e-09,15,190,98,275,87,295,0.79,175,177,208
OceanDNA-b34671,566,9.1,0.0,4.2e-05,0.031,132,222,308,402,281,413,0.79,90,94,132
OceanDNA-b22823,1208,-0.7,0.0,0.078,160.0,56,75,266,286,222,290,0.79,19,20,68
OceanDNA-b45854,1983,9.6,0.1,5.8e-05,0.061,119,144,44,69,20,79,0.79,25,25,59
OceanDNA-b22231,1126,11.2,0.0,9.3e-06,0.012,29,65,14,50,2,70,0.79,36,36,68
OceanDNA-b20819,330,17.2,0.1,2.7e-07,9.1e-05,119,157,238,276,196,283,0.79,38,38,87
OceanDNA-b37047,313,-1.2,0.0,0.058,41.0,71,86,105,120,62,126,0.79,15,15,64
OceanDNA-b45796,2024,19.7,0.0,2.4e-08,5.4e-05,116,182,153,221,138,251,0.79,66,68,113
OceanDNA-b18400,31,11.1,0.0,9.8e-06,0.0039,119,168,91,140,23,150,0.79,49,49,127
OceanDNA-b30927,17,17.2,0.0,2.8e-07,0.00029,49,141,120,219,104,227,0.79,92,99,123
OceanDNA-b13590,599,-3.5,0.0,0.85,820.0,213,246,476,509,472,511,0.79,33,33,39
OceanDNA-b13590,1708,10.3,0.0,5.1e-05,0.049,96,149,139,193,127,201,0.79,53,54,74
OceanDNA-b27517,135,10.2,0.1,3.8e-05,0.082,116,151,104,140,84,192,0.79,35,36,108
OceanDNA-b27517,3792,5.9,0.0,0.00076,1.6,197,243,225,272,207,286,0.79,46,47,79
OceanDNA-b20819,330,3.4,0.0,0.0043,1.5,49,86,135,172,122,215,0.79,37,37,93
OceanDNA-b32152,821,18.1,0.1,1.5e-07,0.00025,72,151,154,232,95,309,0.79,79,78,214
OceanDNA-b22333,591,11.0,0.0,1.1e-05,0.031,88,154,149,213,143,268,0.79,66,64,125
OceanDNA-b21017,221,12.3,0.1,8.4e-06,0.01,126,158,53,85,25,100,0.79,32,32,75
OceanDNA-b21017,1453,30.2,0.0,2.9e-11,3.5e-08,56,147,112,210,89,218,0.79,91,98,129
OceanDNA-b38090,66,12.8,0.0,3e-06,0.0021,163,217,321,373,316,388,0.79,54,52,72
OceanDNA-b17506,254,25.5,0.0,4.1e-10,3.2e-07,118,190,410,483,390,511,0.79,72,73,121
OceanDNA-b40527,277,11.8,0.0,1.2e-05,0.0048,149,228,107,182,97,185,0.79,79,75,88
OceanDNA-b30785,605,9.6,0.0,2.9e-05,0.04,45,151,519,622,509,644,0.79,106,103,135
OceanDNA-b36430,1104,14.2,0.0,1.1e-06,0.0024,63,149,56,145,22,153,0.79,86,89,131
OceanDNA-b22850,2445,14.7,0.0,1.6e-06,0.0023,115,146,323,354,303,370,0.79,31,31,67
OceanDNA-b33393,2785,10.1,0.2,2e-05,0.083,43,151,44,160,6,253,0.79,108,116,247
OceanDNA-b4473,31,15.0,0.0,1.3e-06,0.00018,163,229,604,672,585,674,0.79,66,68,89
OceanDNA-b30917,1286,17.7,0.0,9.9e-08,0.00022,47,145,56,162,31,170,0.79,98,106,139
OceanDNA-b30970,1170,9.5,0.0,8.9e-05,0.072,156,186,187,217,130,239,0.79,30,30,109
OceanDNA-b4498,474,10.5,0.0,4.6e-05,0.015,116,153,135,173,124,178,0.79,37,38,54
OceanDNA-b36151,1469,12.2,0.1,9.4e-06,0.011,56,150,136,234,99,241,0.79,94,98,142
OceanDNA-b23093,1592,-1.1,0.1,0.16,330.0,149,176,6,33,4,51,0.79,27,27,47
OceanDNA-b10034,204,-3.7,0.0,0.67,160.0,158,178,212,232,209,238,0.79,20,20,29
OceanDNA-b40250,557,-3.3,0.0,0.49,170.0,117,135,71,89,65,92,0.79,18,18,27
OceanDNA-b47085,317,13.4,0.0,3.9e-06,0.0018,117,150,148,181,97,192,0.79,33,33,95
OceanDNA-b40437,63,10.7,0.0,1.3e-05,0.011,110,142,373,404,282,412,0.79,32,31,130
OceanDNA-b22022,855,-2.1,0.0,0.22,370.0,160,227,596,661,588,663,0.79,67,65,75
OceanDNA-b466,104,14.4,0.0,2.9e-06,0.0028,78,164,51,135,12,149,0.79,86,84,137
OceanDNA-b20703,336,15.6,0.0,4.3e-07,0.00017,95,157,216,281,208,302,0.79,62,65,94
OceanDNA-b1719,179,13.0,0.0,5.4e-06,0.0081,157,233,292,366,281,390,0.79,76,74,109
OceanDNA-b12668,103,8.4,0.0,6.9e-05,0.031,113,158,101,149,57,154,0.79,45,48,97
OceanDNA-b22660,756,10.6,0.2,1.4e-05,0.026,111,142,162,193,149,210,0.79,31,31,61
OceanDNA-b6218,393,2.5,0.0,0.0041,2.2,119,142,151,174,134,189,0.79,23,23,55
OceanDNA-b15272,62,1.9,0.0,0.0065,2.0,158,210,198,246,183,256,0.79,52,48,73
OceanDNA-b46656,816,-1.7,0.1,0.32,270.0,110,127,2,19,1,34,0.79,17,17,33
OceanDNA-b46638,597,26.4,0.0,2.1e-10,3.4e-07,103,209,160,266,148,294,0.79,106,106,146
OceanDNA-b15991,1008,14.5,0.1,9e-07,0.0013,106,154,185,234,121,250,0.79,48,49,129
OceanDNA-b22022,855,10.3,0.1,3.5e-05,0.06,117,154,523,560,467,567,0.79,37,37,100
OceanDNA-b46208,3,11.4,0.0,1.6e-05,0.0085,118,145,94,121,78,138,0.79,27,27,60
OceanDNA-b3641,44,16.1,0.0,5.9e-07,0.00015,98,148,121,170,45,184,0.79,50,49,139
OceanDNA-b41655,231,19.2,0.0,3.3e-08,7.7e-06,51,140,68,161,33,183,0.79,89,93,150
OceanDNA-b34946,337,9.4,0.2,3.2e-05,0.023,169,233,213,275,186,278,0.79,64,62,92
OceanDNA-b38499,23,2.9,0.0,0.0032,3.2,162,210,306,353,271,368,0.79,48,47,97
OceanDNA-b46229,394,10.7,0.0,2.6e-05,0.019,117,158,257,299,241,307,0.79,41,42,66
OceanDNA-b46647,2053,16.2,0.0,5.4e-07,0.00062,104,154,140,187,113,224,0.78,50,47,111
OceanDNA-b36406,164,12.8,0.0,2.9e-06,0.0032,103,143,159,196,151,222,0.78,40,37,71
OceanDNA-b39458,463,29.9,0.1,1.9e-11,9.9e-09,50,139,144,247,127,261,0.78,89,103,134
OceanDNA-b12396,228,30.2,0.0,1.4e-11,5.6e-09,119,197,141,223,118,252,0.78,78,82,134
OceanDNA-b35825,979,15.3,0.0,5.2e-07,0.00052,43,161,18,142,11,168,0.78,118,124,157
OceanDNA-b13870,479,14.0,0.0,1.3e-06,0.00067,116,150,124,158,104,192,0.78,34,34,88
OceanDNA-b19575,372,19.6,0.1,2.5e-08,9.6e-06,18,152,23,149,17,156,0.78,134,126,139
OceanDNA-b35333,154,11.7,0.0,6.3e-06,0.0021,156,230,239,313,223,314,0.78,74,74,91
OceanDNA-b2811,1320,7.4,0.0,0.00013,0.2,120,149,255,283,237,292,0.78,29,28,55
OceanDNA-b4022,184,29.3,0.0,5.7e-11,3.5e-08,46,141,135,242,109,247,0.78,95,107,138
OceanDNA-b47086,2846,4.4,0.0,0.0034,4.7,159,196,225,261,205,289,0.78,37,36,84
OceanDNA-b16127,558,-1.3,0.0,0.12,37.0,158,188,234,264,222,275,0.78,30,30,53
OceanDNA-b19697,279,22.5,0.0,3.4e-09,1.1e-06,92,172,271,359,263,362,0.78,80,88,99
OceanDNA-b11514,128,12.1,0.0,4.8e-06,0.0013,118,197,133,212,107,242,0.78,79,79,135
OceanDNA-b26071,297,12.8,0.0,3.1e-06,0.00097,119,145,147,173,132,200,0.78,26,26,68
OceanDNA-b23417,1401,12.0,0.1,1e-05,0.015,45,138,191,284,187,326,0.78,93,93,139
OceanDNA-b17381,628,16.9,0.0,1.7e-07,0.00018,40,178,255,404,237,462,0.78,138,149,225
OceanDNA-b16147,120,13.8,0.0,3.1e-06,0.0011,43,143,254,370,251,387,0.78,100,116,136
OceanDNA-b22397,2136,14.3,0.0,4.1e-06,0.0027,114,150,225,261,210,280,0.78,36,36,70
OceanDNA-b4324,224,19.5,0.0,2.7e-08,6.3e-06,53,141,77,170,36,180,0.78,88,93,144
OceanDNA-b46819,1594,13.1,0.0,2.4e-06,0.0086,109,153,240,286,222,297,0.78,44,46,75
OceanDNA-b39756,146,9.5,0.0,6e-05,0.013,95,142,292,340,280,366,0.78,47,48,86
OceanDNA-b37076,208,13.3,0.0,2.1e-06,0.0023,90,158,217,287,214,298,0.78,68,70,84
OceanDNA-b29612,2274,0.0,0.1,0.024,65.0,12,46,30,62,24,79,0.78,34,32,55
OceanDNA-b15420,152,12.1,0.1,4.8e-06,0.0017,145,195,184,237,176,260,0.78,50,53,84
OceanDNA-b22099,382,15.8,0.0,3.7e-07,0.00076,118,173,181,238,164,253,0.78,55,57,89
OceanDNA-b11955,249,36.4,0.1,1.9e-13,2.6e-10,44,209,55,225,50,233,0.78,165,170,183
OceanDNA-b44376,357,11.2,0.0,9.1e-06,0.0047,77,150,141,210,128,217,0.78,73,69,89
OceanDNA-b35665,56,14.9,0.0,7.1e-07,0.00015,40,183,63,218,47,234,0.78,143,155,187
OceanDNA-b17033,808,9.7,0.0,5.2e-05,0.041,144,206,230,293,198,333,0.78,62,63,135
OceanDNA-b20627,234,0.4,0.0,0.018,5.8,49,86,134,171,123,209,0.78,37,37,86
OceanDNA-b3623,67,13.2,0.0,2.2e-06,0.0016,69,165,373,476,357,484,0.78,96,103,127
OceanDNA-b31945,387,-3.1,0.0,0.21,400.0,197,214,229,246,199,261,0.78,17,17,62
OceanDNA-b17188,474,19.7,0.1,2.3e-08,1.5e-05,53,147,45,145,20,153,0.78,94,100,133
OceanDNA-b36166,1695,16.4,0.0,2.3e-07,0.00052,113,151,135,173,108,180,0.78,38,38,72
OceanDNA-b26769,766,0.9,0.0,0.013,25.0,124,152,130,158,107,166,0.78,28,28,59
OceanDNA-b328,1573,8.6,0.0,5.9e-05,0.13,116,147,127,158,109,168,0.78,31,31,59
OceanDNA-b3608,2049,-0.4,0.0,0.033,68.0,123,139,122,138,108,154,0.78,16,16,46
OceanDNA-b46557,381,-1.2,0.0,0.11,27.0,162,189,210,236,209,259,0.78,27,26,50
OceanDNA-b3608,2049,10.7,0.0,1.4e-05,0.029,146,230,228,309,216,310,0.78,84,81,94
OceanDNA-b29555,2035,8.4,0.2,6.4e-05,0.16,119,152,121,155,104,167,0.78,33,34,63
OceanDNA-b26680,1903,11.8,0.0,6e-06,0.015,75,138,174,235,157,269,0.78,63,61,112
OceanDNA-b33288,263,13.2,0.1,4.5e-06,0.0065,46,154,50,163,38,198,0.78,108,113,160
OceanDNA-b19934,261,20.8,0.0,1.1e-08,3.9e-06,90,157,267,338,260,359,0.78,67,71,99
OceanDNA-b32974,2789,5.4,0.0,0.0011,1.7,161,183,246,268,230,301,0.78,22,22,71
OceanDNA-b24086,214,11.7,0.0,1.3e-05,0.004,115,152,233,270,149,275,0.78,37,37,126
OceanDNA-b9187,286,11.2,0.0,9e-06,0.003,117,153,140,179,131,183,0.78,36,39,52
OceanDNA-b23393,328,10.6,0.0,1.5e-05,0.029,125,153,171,200,162,220,0.78,28,29,58
OceanDNA-b33329,1259,0.9,0.0,0.013,20.0,173,215,75,116,48,126,0.78,42,41,78
OceanDNA-b30215,1666,12.3,0.0,1.3e-05,0.0078,49,151,48,156,34,175,0.78,102,108,141
OceanDNA-b46982,639,22.9,0.0,1e-08,1.7e-06,118,153,164,200,145,239,0.78,35,36,94
OceanDNA-b16133,287,31.4,0.0,1.9e-11,7.2e-09,32,142,226,347,203,359,0.78,110,121,156
OceanDNA-b1588,529,4.0,0.0,0.0015,1.2,161,220,227,283,209,289,0.78,59,56,80
OceanDNA-b20036,199,30.2,0.0,4.4e-11,5.6e-09,37,139,97,204,77,229,0.78,102,107,152
OceanDNA-b40254,458,13.5,0.1,1.8e-06,0.0012,115,154,167,206,122,222,0.78,39,39,100
OceanDNA-b35874,16,13.9,0.0,1.4e-06,0.00041,114,180,109,174,84,220,0.78,66,65,136
OceanDNA-b30869,2097,13.2,0.1,2.3e-06,0.0051,54,143,146,242,122,248,0.78,89,96,126
OceanDNA-b19297,251,13.9,0.0,1.4e-06,0.00046,104,161,152,213,147,233,0.78,57,61,86
OceanDNA-b29482,1279,25.2,0.1,4.9e-10,1.5e-06,45,152,112,227,97,247,0.78,107,115,150
OceanDNA-b23153,73,0.1,0.0,0.023,59.0,50,86,126,162,106,167,0.78,36,36,61
OceanDNA-b20491,67,-3.8,0.1,0.68,110.0,217,231,15,29,8,38,0.78,14,14,30
OceanDNA-b41234,828,18.3,0.0,1.3e-07,0.00012,62,191,85,210,62,220,0.78,129,125,158
OceanDNA-b4392,8,20.2,0.1,1.6e-08,4.9e-06,53,141,77,170,36,196,0.78,88,93,160
OceanDNA-b42807,820,13.4,0.1,1.9e-06,0.0029,24,120,32,127,15,134,0.78,96,95,119
OceanDNA-b9161,66,10.8,0.0,1.2e-05,0.0028,124,159,100,135,82,171,0.78,35,35,89
OceanDNA-b20955,963,21.4,0.2,7e-09,5e-05,20,139,494,616,489,622,0.78,119,122,133
OceanDNA-b9605,71,14.1,0.0,1.2e-06,0.00033,118,164,210,257,192,287,0.78,46,47,95
OceanDNA-b3643,751,-0.6,0.0,0.037,32.0,43,83,22,64,19,77,0.78,40,42,58
OceanDNA-b37260,40,20.8,0.0,1.1e-08,9e-06,118,160,138,181,119,242,0.78,42,43,123
OceanDNA-a3351,125,14.1,0.0,1.2e-06,0.00051,118,178,199,265,181,297,0.78,60,66,116
OceanDNA-b4027,527,21.3,0.0,1.6e-08,6.4e-06,62,178,128,254,95,303,0.78,116,126,208
OceanDNA-b4594,274,16.5,0.0,4.6e-07,0.00011,94,218,137,258,59,276,0.78,124,121,217
OceanDNA-b24304,149,6.3,0.0,0.0003,0.63,116,152,98,134,79,139,0.78,36,36,60
OceanDNA-b33521,2359,20.0,0.0,3.8e-08,5.4e-05,49,139,137,239,129,256,0.78,90,102,127
OceanDNA-b23143,43,16.5,0.0,4.4e-07,0.0006,118,160,156,199,131,251,0.78,42,43,120
OceanDNA-b9486,252,12.4,0.0,4.1e-06,0.0014,116,153,134,174,122,184,0.78,37,40,62
OceanDNA-b31716,2338,-0.4,0.0,0.033,80.0,57,96,84,127,32,135,0.78,39,43,103
OceanDNA-b31716,2338,-2.8,0.0,0.17,410.0,118,145,18,44,14,81,0.78,27,26,67
OceanDNA-b34824,164,12.4,0.0,4e-06,0.0024,116,150,88,123,24,139,0.78,34,35,115
OceanDNA-b19607,22,17.0,0.0,1.5e-07,4.7e-05,117,192,137,213,125,235,0.78,75,76,110
OceanDNA-b30938,2151,21.4,0.1,2.2e-08,1.8e-05,51,147,96,199,82,203,0.78,96,103,121
OceanDNA-b31195,338,-0.8,0.0,0.044,27.0,118,144,146,172,136,187,0.78,26,26,51
OceanDNA-b22976,1905,23.2,0.0,2e-09,9.2e-06,117,211,185,283,162,289,0.78,94,98,127
OceanDNA-b33284,2828,-4.0,0.0,0.4,2000.0,35,49,26,40,18,43,0.78,14,14,25
OceanDNA-b13585,163,14.4,0.1,4e-06,0.0015,98,172,149,227,80,275,0.78,74,78,195
OceanDNA-b27523,751,23.6,0.0,1.6e-09,2.1e-06,45,147,112,222,100,228,0.78,102,110,128
OceanDNA-b28166,2674,7.1,0.0,0.00017,0.46,131,206,229,303,208,319,0.78,75,74,111
OceanDNA-b37535,76,27.9,0.0,1.5e-10,1.3e-07,40,209,118,305,75,318,0.78,169,187,243
OceanDNA-b35167,513,12.6,0.0,7e-06,0.0029,98,182,90,180,64,211,0.78,84,90,147
OceanDNA-b26844,1735,3.7,0.0,0.0018,5.8,163,229,200,264,186,274,0.78,66,64,88
OceanDNA-b20972,2572,26.6,0.0,3.6e-10,5.1e-07,41,139,76,180,58,187,0.78,98,104,129
OceanDNA-b46921,995,20.0,0.0,3.7e-08,4.4e-05,112,183,146,220,118,249,0.78,71,74,131
OceanDNA-b30,835,8.9,0.1,4.8e-05,0.18,110,145,187,222,156,232,0.78,35,35,76
OceanDNA-b36411,1312,10.3,0.0,5.3e-05,0.035,122,145,142,165,117,181,0.78,23,23,64
OceanDNA-b41152,1030,8.1,0.1,0.00025,0.19,123,158,93,132,77,139,0.78,35,39,62
OceanDNA-b357,456,-0.4,0.0,0.033,18.0,157,183,242,268,223,316,0.78,26,26,93
OceanDNA-b35712,101,11.8,0.0,5.9e-06,0.0062,113,188,22,100,8,107,0.78,75,78,99
OceanDNA-b28110,1919,18.0,0.0,8.1e-08,0.00018,34,150,250,366,229,402,0.78,116,116,173
OceanDNA-b29,3604,10.9,0.0,4.4e-05,0.056,100,141,181,223,172,234,0.78,41,42,62
OceanDNA-b22423,1899,20.9,0.0,2.1e-08,2.4e-05,108,185,123,202,107,219,0.78,77,79,112
OceanDNA-b27590,561,10.5,0.0,3e-05,0.035,124,150,129,155,101,162,0.78,26,26,61
OceanDNA-b26776,660,15.4,0.0,4.8e-07,0.0011,118,160,30,73,18,87,0.78,42,43,69
OceanDNA-b20668,73,1.3,0.0,0.019,2.5,29,86,112,166,91,181,0.78,57,54,90
OceanDNA-b32055,868,14.6,0.0,8.3e-07,0.0017,111,151,185,225,157,233,0.78,40,40,76
OceanDNA-b36158,1500,16.3,0.0,5.3e-07,0.00049,114,151,161,198,133,205,0.78,37,37,72
OceanDNA-b7194,42,20.4,0.0,4.5e-08,1.3e-05,44,177,102,246,85,259,0.78,133,144,174
OceanDNA-b7194,370,15.3,0.2,1.5e-06,0.00043,124,215,132,224,127,263,0.78,91,92,136
OceanDNA-b20705,111,41.2,0.1,6.6e-15,1.6e-12,20,140,61,188,57,211,0.78,120,127,154
OceanDNA-b6509,444,8.5,0.0,6.1e-05,0.063,122,155,194,228,178,234,0.78,33,34,56
OceanDNA-a3195,798,-2.9,0.0,0.19,220.0,168,195,260,287,251,300,0.78,27,27,49
OceanDNA-b22554,122,11.5,0.1,2.2e-05,0.0089,99,156,97,155,88,162,0.78,57,58,74
OceanDNA-b27533,2244,19.4,0.4,3e-08,7.8e-05,45,144,89,195,72,201,0.78,99,106,129
OceanDNA-b17396,1318,21.1,0.0,9e-09,1.6e-05,107,218,197,314,182,321,0.78,111,117,139
OceanDNA-b16777,178,12.8,0.0,9e-06,0.0088,59,147,351,441,333,460,0.78,88,90,127
OceanDNA-b30022,468,12.6,0.0,6.8e-06,0.011,27,150,83,213,74,226,0.78,123,130,152
OceanDNA-b46252,2090,11.6,0.0,2.8e-05,0.016,115,150,175,210,153,223,0.78,35,35,70
OceanDNA-b10728,419,7.0,0.0,0.00018,0.13,168,230,216,276,203,283,0.78,62,60,80
OceanDNA-b9705,341,1.9,0.0,0.0065,5.4,196,233,234,272,193,283,0.78,37,38,90
OceanDNA-b31685,2065,0.9,0.0,0.013,31.0,117,153,181,219,159,239,0.78,36,38,80
OceanDNA-b20744,16,65.5,0.0,2.5e-22,6.6e-20,17,245,77,332,65,343,0.78,228,255,278
OceanDNA-b4060,640,12.6,0.0,7e-06,0.0028,119,155,152,189,122,194,0.78,36,37,72
OceanDNA-b45984,1104,18.1,0.0,7.4e-08,8.3e-05,150,210,39,102,24,108,0.78,60,63,84
OceanDNA-b30852,1197,20.0,0.0,3.9e-08,3.8e-05,48,148,71,179,44,189,0.78,100,108,145
OceanDNA-b22828,2364,10.8,0.0,2.4e-05,0.051,113,144,355,386,341,396,0.78,31,31,55
OceanDNA-b40047,199,14.8,0.0,7.6e-07,0.0002,63,149,33,113,16,157,0.78,86,80,141
OceanDNA-b15461,1544,12.9,0.0,2.8e-06,0.0052,144,210,209,278,117,286,0.78,66,69,169
OceanDNA-b3654,348,5.7,0.0,0.00045,0.58,137,213,277,358,266,383,0.78,76,81,117
OceanDNA-b17054,10,11.3,0.0,8.9e-06,0.0026,53,86,135,169,127,193,0.78,33,34,66
OceanDNA-b30139,843,13.4,0.1,3.9e-06,0.0049,40,151,85,202,65,215,0.78,111,117,150
OceanDNA-b24965,1095,16.6,0.0,4.3e-07,0.00042,37,154,24,145,5,173,0.78,117,121,168
OceanDNA-b43700,166,7.5,0.2,0.00013,0.14,123,152,28,57,8,62,0.78,29,29,54
OceanDNA-b32723,1251,10.9,0.0,1.1e-05,0.023,113,149,233,269,141,274,0.78,36,36,133
OceanDNA-b31200,1026,12.3,0.0,4.4e-06,0.007,96,154,63,115,47,169,0.78,58,52,122
OceanDNA-b45351,1188,28.1,0.0,6.4e-11,8.2e-08,116,210,156,253,139,260,0.78,94,97,121
OceanDNA-a4078,317,5.3,0.0,0.00061,0.21,36,95,90,154,82,155,0.78,59,64,73
OceanDNA-b32645,804,1.6,0.0,0.0079,6.5,119,155,133,170,111,191,0.78,36,37,80
OceanDNA-b30970,2355,9.1,0.1,0.00013,0.1,116,152,101,136,80,153,0.78,36,35,73
OceanDNA-b46298,1400,-3.5,0.0,0.56,1300.0,26,54,608,636,605,642,0.78,28,28,37
OceanDNA-b25045,394,-1.2,0.0,0.056,50.0,160,184,269,293,262,311,0.78,24,24,49
OceanDNA-b10114,161,16.0,0.0,3.3e-07,0.00014,47,205,26,181,15,204,0.78,158,155,189
OceanDNA-b45251,120,12.4,0.0,3.9e-06,0.0044,120,215,162,264,142,272,0.78,95,102,130
OceanDNA-b20349,336,4.1,0.0,0.0014,0.57,185,240,251,307,220,320,0.78,55,56,100
OceanDNA-b36917,708,11.4,0.0,8.2e-06,0.008,103,175,86,164,75,166,0.78,72,78,91
OceanDNA-b23003,2097,20.1,0.5,5.4e-08,4.5e-05,35,139,325,435,308,445,0.78,104,110,137
OceanDNA-b32869,464,10.7,0.0,1.3e-05,0.024,118,143,74,99,55,140,0.78,25,25,85
OceanDNA-b30854,1685,16.3,0.0,5.1e-07,0.00058,50,145,85,188,76,202,0.78,95,103,126
OceanDNA-b28040,422,11.8,0.1,6.2e-06,0.004,158,214,260,313,241,325,0.78,56,53,84
OceanDNA-b36076,862,1.6,0.0,0.016,20.0,114,140,198,224,165,233,0.78,26,26,68
OceanDNA-b24040,1710,8.5,0.1,6.1e-05,0.11,118,141,6,29,1,43,0.78,23,23,42
OceanDNA-b17056,36,19.0,0.0,3.9e-08,1.1e-05,103,155,125,177,101,189,0.78,52,52,88
OceanDNA-b38636,415,-1.9,0.0,0.092,48.0,36,63,33,60,23,65,0.78,27,27,42
OceanDNA-b22314,3718,-2.2,0.0,0.11,530.0,206,241,314,353,311,364,0.78,35,39,53
OceanDNA-b11387,576,15.3,0.0,1e-06,0.00031,104,173,302,370,277,406,0.78,69,68,129
OceanDNA-b38499,23,28.0,0.1,6.8e-11,6.9e-08,46,137,137,240,122,249,0.78,91,103,127
OceanDNA-b6558,89,15.1,0.0,6.1e-07,0.00064,112,183,131,205,112,217,0.78,71,74,105
OceanDNA-b5274,115,1.4,0.0,0.0092,6.1,215,250,679,714,658,719,0.78,35,35,61
OceanDNA-b34924,232,1.3,0.0,0.02,10.0,144,211,272,344,264,356,0.78,67,72,92
OceanDNA-b36666,959,3.5,0.0,0.0042,2.6,163,218,619,674,605,687,0.78,55,55,82
OceanDNA-b36076,1735,13.1,0.0,4.9e-06,0.0063,117,186,535,608,520,635,0.78,69,73,115
OceanDNA-b27556,997,14.6,0.0,1.7e-06,0.0018,88,162,94,167,71,196,0.78,74,73,125
OceanDNA-b3717,1233,19.8,0.0,2.2e-08,3e-05,114,209,138,236,121,255,0.78,95,98,134
OceanDNA-b23634,108,11.3,0.0,2.6e-05,0.021,160,202,259,300,243,325,0.78,42,41,82
OceanDNA-b46704,996,12.8,0.0,9.1e-06,0.0058,119,154,133,169,84,211,0.78,35,36,127
OceanDNA-b22398,1431,-3.6,0.0,0.91,900.0,91,120,322,352,318,354,0.78,29,30,36
OceanDNA-b35376,2203,5.3,0.0,0.0011,1.5,144,176,248,280,237,292,0.78,32,32,55
OceanDNA-b3599,614,19.4,0.0,6e-08,2.3e-05,44,154,90,209,79,226,0.78,110,119,147
OceanDNA-b36303,17,12.4,0.0,3.9e-06,0.0026,75,140,90,152,74,183,0.78,65,62,109
OceanDNA-b3457,390,12.9,0.0,2.8e-06,0.0012,109,147,77,115,54,131,0.78,38,38,77
OceanDNA-b24005,575,-4.0,0.0,0.39,700.0,49,69,335,355,330,360,0.78,20,20,30
OceanDNA-b6778,256,0.5,0.0,0.017,10.0,118,142,142,166,126,180,0.78,24,24,54
OceanDNA-b18519,68,13.6,0.0,5e-06,0.00052,104,175,76,155,6,170,0.78,71,79,164
OceanDNA-b34735,604,11.7,0.1,2e-05,0.0044,27,150,73,194,63,204,0.78,123,121,141
OceanDNA-b34301,471,6.5,0.1,0.00025,0.19,105,155,242,295,233,308,0.78,50,53,75
OceanDNA-b34610,170,13.1,0.2,4.9e-06,0.0032,49,155,102,212,89,306,0.78,106,110,217
OceanDNA-b17217,1754,21.0,0.0,9.3e-09,1.7e-05,115,230,176,298,157,301,0.78,115,122,144
OceanDNA-b20977,1358,22.3,0.0,1.1e-08,1.4e-05,36,151,186,302,156,309,0.78,115,116,153
OceanDNA-b24705,1141,12.2,0.0,4.7e-06,0.01,118,178,213,275,182,286,0.78,60,62,104
OceanDNA-b3594,247,-0.9,0.1,0.046,49.0,33,79,389,434,372,438,0.78,46,45,66
OceanDNA-b46181,281,15.0,0.0,6.3e-07,0.0005,62,139,84,159,59,181,0.78,77,75,122
OceanDNA-b2668,146,-0.6,0.0,0.037,15.0,165,187,119,141,108,154,0.78,22,22,46
OceanDNA-b9977,293,13.0,0.0,2.6e-06,0.00097,67,176,123,242,108,254,0.78,109,119,146
OceanDNA-b35330,190,15.6,0.1,4.2e-07,8.7e-05,102,155,92,141,35,153,0.78,53,49,118
OceanDNA-b38906,131,-3.6,0.0,0.3,350.0,148,166,13,31,9,34,0.78,18,18,25
OceanDNA-b20902,2959,11.1,0.0,1e-05,0.043,115,151,157,192,142,224,0.78,36,35,82
OceanDNA-b30151,698,13.2,0.0,2.2e-06,0.0067,122,193,80,152,66,163,0.78,71,72,97
OceanDNA-b13250,3119,17.4,0.2,1.2e-06,0.00049,41,156,186,300,169,374,0.78,115,114,205
OceanDNA-b3621,155,14.2,0.0,1.1e-06,0.00096,100,177,288,368,280,383,0.78,77,80,103
OceanDNA-b23523,1367,11.9,0.0,5.5e-06,0.01,115,152,129,167,112,182,0.78,37,38,70
OceanDNA-b22893,2288,10.4,0.0,4.9e-05,0.038,73,139,174,244,163,256,0.78,66,70,93
OceanDNA-b22131,554,18.3,0.0,1.3e-07,5.6e-05,100,153,147,198,136,262,0.78,53,51,126
OceanDNA-b6447,204,3.3,0.0,0.0023,1.1,194,230,216,253,179,260,0.78,36,37,81
OceanDNA-b22917,1949,11.1,0.0,3.1e-05,0.029,73,139,172,242,164,254,0.78,66,70,90
OceanDNA-b11479,73,14.8,0.0,7.4e-07,0.00038,40,151,24,136,5,152,0.78,111,112,147
OceanDNA-b23952,586,-1.9,0.0,0.09,240.0,212,232,176,197,171,213,0.78,20,21,42
OceanDNA-b12878,37,11.5,0.0,7.7e-06,0.0043,62,137,68,141,51,162,0.78,75,73,111
OceanDNA-b20092,192,0.4,0.0,0.018,4.3,54,85,146,177,137,192,0.78,31,31,55
OceanDNA-b40639,13,11.2,0.0,1.9e-05,0.0067,54,146,23,109,2,118,0.78,92,86,116
OceanDNA-b1820,904,15.8,0.1,7.6e-07,0.00081,40,156,10,130,3,147,0.78,116,120,144
OceanDNA-b25052,124,15.1,0.1,5.8e-07,0.00059,121,228,91,200,62,225,0.78,107,109,163
OceanDNA-b16517,491,1.6,0.0,0.0076,6.8,153,183,364,394,332,460,0.78,30,30,128
OceanDNA-b35935,1408,6.4,0.0,0.00055,0.73,162,211,215,260,191,272,0.78,49,45,81
OceanDNA-b16125,732,10.8,0.0,1.2e-05,0.0091,144,209,388,456,380,461,0.78,65,68,81
OceanDNA-b23549,551,12.0,0.0,1.6e-05,0.01,67,177,192,312,155,336,0.78,110,120,181
OceanDNA-b19592,319,28.2,0.1,6.1e-11,2.4e-08,48,146,72,175,58,193,0.78,98,103,135
OceanDNA-b11963,1108,0.4,0.0,0.018,35.0,218,234,318,334,303,354,0.78,16,16,51
OceanDNA-b3969,389,20.6,0.0,1.2e-08,1e-05,44,177,95,238,71,269,0.78,133,143,198
OceanDNA-b45289,1816,11.8,0.0,1.9e-05,0.016,39,150,27,143,11,158,0.78,111,116,147
OceanDNA-b6846,218,-0.7,0.0,0.04,24.0,118,141,139,162,128,173,0.78,23,23,45
OceanDNA-b36732,2751,26.9,0.1,1.5e-10,5.2e-07,49,141,149,251,134,257,0.78,92,102,123
OceanDNA-b40471,15,55.6,0.0,2.6e-19,4.7e-16,42,234,115,308,106,324,0.78,192,193,218
OceanDNA-b9797,260,7.3,0.0,0.00015,0.074,156,184,211,239,196,270,0.78,28,28,74
OceanDNA-b28576,324,7.3,0.0,0.00014,0.071,86,141,74,125,47,152,0.78,55,51,105
OceanDNA-b6424,505,-0.5,0.0,0.1,22.0,157,180,166,189,137,205,0.78,23,23,68
OceanDNA-b13621,88,13.3,0.0,6.4e-06,0.00064,118,208,126,215,83,231,0.78,90,89,148
OceanDNA-b40669,443,29.8,0.0,3.9e-11,1.2e-08,118,209,160,258,108,275,0.78,91,98,167
OceanDNA-b24875,724,13.2,0.0,2.3e-06,0.0039,109,143,118,152,67,249,0.78,34,34,182
OceanDNA-b15171,138,18.7,0.0,4.7e-08,1.3e-05,52,176,31,163,11,209,0.78,124,132,198
OceanDNA-b33411,1017,12.2,0.0,8.9e-06,0.0058,161,212,369,416,358,432,0.78,51,47,74
OceanDNA-b36948,1090,3.6,0.0,0.0019,2.2,56,86,139,169,127,183,0.78,30,30,56
OceanDNA-b15853,1523,14.5,0.0,1.8e-06,0.0017,70,173,119,235,45,273,0.78,103,116,228
OceanDNA-b6666,393,15.9,0.1,3.4e-07,0.00026,20,88,20,88,5,94,0.78,68,68,89
OceanDNA-b22393,1546,13.5,0.0,3.6e-06,0.0029,118,149,20,51,3,67,0.78,31,31,64
OceanDNA-b18031,140,21.2,0.0,8.1e-09,1.3e-06,107,154,125,174,112,212,0.78,47,49,100
OceanDNA-b23298,1775,14.7,0.0,8.1e-07,0.0016,75,153,108,184,72,189,0.78,78,76,117
OceanDNA-b7466,301,18.6,0.0,5.2e-08,2.6e-05,48,105,108,167,102,181,0.78,57,59,79
OceanDNA-b4004,18,3.9,0.0,0.0048,1.8,163,231,142,208,132,228,0.78,68,66,96
OceanDNA-b40467,458,14.2,0.0,3.4e-06,0.0018,56,157,76,174,48,205,0.78,101,98,157
OceanDNA-b36330,589,12.3,0.0,4.4e-06,0.003,76,145,115,181,97,203,0.78,69,66,106
OceanDNA-b31056,2923,15.1,0.2,1.8e-06,0.0019,35,154,129,257,104,277,0.78,119,128,173
OceanDNA-b22461,3942,16.3,0.0,5.1e-07,0.0012,100,154,168,217,155,235,0.78,54,49,80
OceanDNA-b498,308,4.0,0.0,0.0014,4.0,155,232,254,329,240,342,0.78,77,75,102
OceanDNA-b17743,2586,-0.3,0.0,0.029,110.0,178,200,271,292,255,302,0.78,22,21,47
OceanDNA-b22926,1352,-0.0,0.0,0.025,120.0,166,229,280,343,276,346,0.78,63,63,70
OceanDNA-b20657,47,11.6,0.0,1.4e-05,0.0021,185,237,261,313,235,335,0.78,52,52,100
OceanDNA-b27563,76,7.5,0.0,0.00012,0.19,157,212,165,216,146,228,0.78,55,51,82
OceanDNA-b24091,193,12.3,0.0,4.3e-06,0.0043,115,161,217,263,148,286,0.78,46,46,138
OceanDNA-b19612,423,13.1,0.0,5e-06,0.0015,91,173,215,302,205,321,0.78,82,87,116
OceanDNA-b38353,422,10.7,0.0,2.7e-05,0.032,66,135,141,208,124,231,0.78,69,67,107
OceanDNA-b4587,117,-0.4,0.1,0.033,23.0,126,149,110,133,87,153,0.78,23,23,66
OceanDNA-b30681,143,4.0,0.1,0.0015,1.0,154,229,182,255,158,263,0.78,75,73,105
OceanDNA-b16210,288,11.1,0.0,2.1e-05,0.012,112,150,89,129,76,137,0.78,38,40,61
OceanDNA-b23064,375,37.1,0.0,2.4e-13,1.7e-10,48,209,93,267,66,298,0.77,161,174,232
OceanDNA-b46830,927,20.0,0.0,1.9e-08,4e-05,115,184,70,143,44,150,0.77,69,73,106
OceanDNA-b15879,586,27.1,0.0,2.6e-10,2.3e-07,44,166,44,175,29,189,0.77,122,131,160
OceanDNA-b31120,158,11.6,0.0,2e-05,0.0074,73,148,117,193,97,222,0.77,75,76,125
OceanDNA-b46933,1709,11.2,0.0,1.9e-05,0.037,118,150,276,308,261,328,0.77,32,32,67
OceanDNA-b26737,1207,10.6,0.0,2.8e-05,0.033,120,144,152,176,132,197,0.77,24,24,65
OceanDNA-b18470,311,16.5,0.0,4.4e-07,7.2e-05,112,154,290,335,265,349,0.77,42,45,84
OceanDNA-b15515,1821,17.8,0.0,1.8e-07,0.00018,72,155,122,217,117,257,0.77,83,95,140
OceanDNA-b23944,1715,10.4,0.1,1.7e-05,0.029,69,153,54,137,37,152,0.77,84,83,115
OceanDNA-b16227,919,16.6,0.0,6.2e-07,0.00022,53,154,52,164,32,169,0.77,101,112,137
OceanDNA-b44624,60,10.1,0.0,2e-05,0.041,110,146,131,169,113,187,0.77,36,38,74
OceanDNA-b30001,346,19.4,0.0,2.9e-08,4.7e-05,27,144,90,217,76,227,0.77,117,127,151
OceanDNA-b13585,50,11.5,0.0,3e-05,0.011,111,144,145,180,132,199,0.77,33,35,67
OceanDNA-b17590,334,14.4,0.0,1e-06,0.0035,116,188,146,218,122,240,0.77,72,72,118
OceanDNA-b35901,22,3.0,0.0,0.0058,1.7,117,138,96,117,47,143,0.77,21,21,96
OceanDNA-b15137,533,14.2,0.0,2.2e-06,0.0023,122,186,141,206,124,243,0.77,64,65,119
OceanDNA-b30174,1996,7.0,0.1,0.00018,0.39,126,162,206,246,138,254,0.77,36,40,116
OceanDNA-b13261,8,9.3,0.0,7.1e-05,0.042,152,228,188,260,164,262,0.77,76,72,98
OceanDNA-b23333,822,21.6,0.1,1.9e-08,1e-05,40,209,65,236,43,250,0.77,169,171,207
OceanDNA-b42676,46,22.1,0.0,4.3e-09,8.9e-07,43,141,47,153,16,196,0.77,98,106,180
OceanDNA-b46894,843,16.6,0.0,4.1e-07,0.00025,97,163,84,150,36,163,0.77,66,66,127
OceanDNA-b20491,297,6.4,0.0,0.00053,0.088,165,229,225,292,213,314,0.77,64,67,101
OceanDNA-b24145,1148,4.8,0.1,0.00084,1.5,120,149,168,197,94,206,0.77,29,29,112
OceanDNA-b31172,1603,6.1,0.0,0.00034,0.56,163,214,292,340,281,356,0.77,51,48,75
OceanDNA-b19612,371,16.3,0.0,5.1e-07,0.00016,115,154,115,155,104,204,0.77,39,40,100
OceanDNA-b6574,177,15.8,0.0,7.1e-07,0.00032,43,176,118,262,100,302,0.77,133,144,202
OceanDNA-b39489,22,0.1,0.0,0.022,15.0,111,154,570,613,560,624,0.77,43,43,64
OceanDNA-b6748,244,14.7,0.0,8.1e-07,0.00066,37,177,88,238,57,275,0.77,140,150,218
OceanDNA-b22548,17,18.9,0.0,1.2e-07,5.1e-05,93,178,91,181,53,199,0.77,85,90,146
OceanDNA-b4487,698,16.2,0.0,5.5e-07,0.00044,52,177,118,253,98,301,0.77,125,135,203
OceanDNA-b23396,1251,18.4,0.0,1.2e-07,0.00012,74,154,103,180,82,222,0.77,80,77,140
OceanDNA-b16229,52,35.4,0.0,1.1e-12,5e-10,42,145,248,370,241,376,0.77,103,122,135
OceanDNA-b20533,45,4.0,0.0,0.0014,0.38,120,151,122,154,100,163,0.77,31,32,63
OceanDNA-b9808,424,10.9,0.1,3.3e-05,0.0063,102,158,138,188,89,296,0.77,56,50,207
OceanDNA-b40444,1787,53.3,0.0,5.2e-18,2.4e-15,57,229,114,285,87,304,0.77,172,171,217
OceanDNA-b40444,376,24.0,0.1,4.6e-09,2.1e-06,48,138,144,245,124,254,0.77,90,101,130
OceanDNA-b4002,353,-4.0,0.0,0.39,520.0,26,60,303,337,290,339,0.77,34,34,49
OceanDNA-b46741,194,29.0,0.0,6.8e-11,6.1e-08,118,208,147,240,133,252,0.77,90,93,119
OceanDNA-b22380,1283,25.8,0.0,1e-09,5.3e-07,118,180,216,282,193,289,0.77,62,66,96
OceanDNA-b17374,593,16.9,0.0,1.7e-07,0.00031,113,197,222,308,177,332,0.77,84,86,155
OceanDNA-b24923,2035,12.4,0.0,4e-06,0.01,101,160,116,180,100,213,0.77,59,64,113
OceanDNA-b22490,1092,15.2,0.0,5.7e-07,0.0017,117,183,176,244,164,254,0.77,66,68,90
OceanDNA-b13263,277,0.3,0.0,0.06,20.0,149,195,365,408,353,420,0.77,46,43,67
OceanDNA-b23088,3754,20.5,0.0,2.8e-08,5.5e-05,74,159,178,269,165,280,0.77,85,91,115
OceanDNA-b38527,545,2.0,0.0,0.0059,3.9,148,186,195,233,177,238,0.77,38,38,61
OceanDNA-b9746,56,9.9,0.0,2.3e-05,0.016,156,212,220,272,211,282,0.77,56,52,71
OceanDNA-b15189,2228,10.6,0.0,1.4e-05,0.037,54,142,46,134,22,145,0.77,88,88,123
OceanDNA-b3547,369,9.5,0.0,3e-05,0.022,121,148,105,132,84,145,0.77,27,27,61
OceanDNA-b310,105,27.1,0.0,2.7e-10,1.9e-07,112,209,129,228,79,241,0.77,97,99,162
OceanDNA-b34122,1429,10.8,0.0,1.2e-05,0.027,28,129,67,167,57,170,0.77,101,100,113
OceanDNA-b723,366,0.1,0.0,0.023,11.0,123,147,480,504,464,513,0.77,24,24,49
OceanDNA-b22450,507,12.9,0.0,5.5e-06,0.0038,93,150,171,227,140,236,0.77,57,56,96
OceanDNA-b35376,2203,4.5,0.0,0.0021,2.7,97,146,131,179,94,187,0.77,49,48,93
OceanDNA-b30747,684,16.3,0.0,2.6e-07,0.00033,59,158,42,137,28,158,0.77,99,95,130
OceanDNA-b30157,926,3.0,0.0,0.003,6.3,161,231,203,271,191,274,0.77,70,68,83
OceanDNA-b23312,2294,-1.8,0.0,0.083,230.0,34,48,78,92,72,110,0.77,14,14,38
OceanDNA-b1008,2019,14.3,0.0,1.1e-06,0.0022,104,154,63,112,48,152,0.77,50,49,104
OceanDNA-b46308,138,11.1,0.0,2e-05,0.02,43,135,49,142,35,158,0.77,92,93,123
OceanDNA-b4491,657,2.9,0.0,0.0062,2.2,143,214,277,353,270,359,0.77,71,76,89
OceanDNA-b41301,4206,9.6,0.0,5.7e-05,0.14,49,147,80,186,63,191,0.77,98,106,128
OceanDNA-b40185,13,9.9,0.0,2.3e-05,0.021,62,145,81,162,75,213,0.77,83,81,138
OceanDNA-b3457,390,-2.2,0.0,0.11,47.0,163,181,179,197,172,223,0.77,18,18,51
OceanDNA-b30938,1427,18.8,0.0,1.3e-07,0.00011,49,146,66,171,55,182,0.77,97,105,127
OceanDNA-b16117,600,5.7,0.0,0.00087,0.33,101,145,82,125,63,137,0.77,44,43,74
OceanDNA-b19701,291,18.0,0.0,1.6e-07,3.2e-05,95,156,294,359,283,379,0.77,61,65,96
OceanDNA-b35916,2259,12.3,0.0,8.4e-06,0.01,116,212,196,295,95,315,0.77,96,99,220
OceanDNA-b1522,751,10.8,0.1,2.5e-05,0.013,67,150,62,142,5,185,0.77,83,80,180
OceanDNA-b22449,551,14.1,0.0,2.4e-06,0.0019,118,182,85,153,72,163,0.77,64,68,91
OceanDNA-b42513,128,5.0,0.0,0.00073,0.19,116,145,125,154,111,168,0.77,29,29,57
OceanDNA-b30938,1427,9.3,0.0,0.00011,0.088,156,210,231,283,185,296,0.77,54,52,111
OceanDNA-b4064,515,10.9,0.0,3.4e-05,0.012,113,148,118,153,99,171,0.77,35,35,72
OceanDNA-b46252,1757,13.6,0.0,6.8e-06,0.0039,114,153,165,205,144,209,0.77,39,40,65
OceanDNA-b28170,1463,10.8,0.0,1.2e-05,0.032,28,129,104,213,95,252,0.77,101,109,157
OceanDNA-b31521,1422,16.2,0.1,5.6e-07,0.00058,57,152,39,135,6,189,0.77,95,96,183
OceanDNA-b41808,115,18.6,0.0,5.2e-08,1.2e-05,98,176,95,169,76,187,0.77,78,74,111
OceanDNA-b9784,27,21.8,0.0,1.1e-08,6.5e-06,51,155,157,264,143,278,0.77,104,107,135
OceanDNA-b38376,703,3.7,0.0,0.0055,4.6,163,218,268,320,260,335,0.77,55,52,75
OceanDNA-b7184,483,20.9,0.0,2.1e-08,5.4e-06,49,178,99,238,56,289,0.77,129,139,233
OceanDNA-b24712,366,1.2,0.1,0.01,6.2,197,230,221,256,189,257,0.77,33,35,68
OceanDNA-b10747,400,-3.7,0.0,0.33,190.0,161,184,228,251,221,256,0.77,23,23,35
OceanDNA-b6569,486,7.0,0.0,0.00036,0.16,163,230,191,256,169,267,0.77,67,65,98
OceanDNA-b43987,160,5.0,0.0,0.0015,0.16,159,210,124,181,113,220,0.77,51,57,107
OceanDNA-b9243,342,12.8,0.0,3.1e-06,0.0011,115,159,146,191,125,231,0.77,44,45,106
OceanDNA-b20036,199,-2.1,0.0,0.32,41.0,92,115,353,375,335,383,0.77,23,22,48
OceanDNA-b46299,304,-2.5,0.0,0.42,690.0,207,229,380,402,362,404,0.77,22,22,42
OceanDNA-b6427,652,-3.2,0.0,0.23,180.0,217,235,417,435,408,444,0.77,18,18,36
OceanDNA-b4045,852,21.1,0.0,8.7e-09,7.8e-06,37,156,51,177,22,184,0.77,119,126,162
OceanDNA-b22610,773,4.9,0.0,0.00076,0.75,112,154,120,162,100,173,0.77,42,42,73
OceanDNA-b42,3294,2.8,0.0,0.0033,19.0,116,155,367,406,351,416,0.77,39,39,65
OceanDNA-b32084,1484,19.1,0.0,7.5e-08,0.00012,97,142,254,296,245,311,0.77,45,42,66
OceanDNA-b21043,56,-2.4,0.0,0.26,230.0,161,183,178,200,171,215,0.77,22,22,44
OceanDNA-b22487,2098,-2.0,0.0,0.19,240.0,67,88,217,237,214,246,0.77,21,20,32
OceanDNA-b10103,273,11.1,0.0,9.6e-06,0.0039,96,155,26,85,17,101,0.77,59,59,84
OceanDNA-b40453,184,4.8,0.0,0.0017,1.0,144,191,277,330,270,354,0.77,47,53,84
OceanDNA-b31005,2016,2.7,0.0,0.0037,10.0,195,234,283,323,249,343,0.77,39,40,94
OceanDNA-b33411,1017,1.9,0.0,0.012,8.1,102,152,235,287,213,308,0.77,50,52,95
OceanDNA-b15777,1620,3.2,0.0,0.0075,4.3,158,183,214,239,206,280,0.77,25,25,74
OceanDNA-b20096,228,17.6,0.1,1e-07,3.2e-05,53,140,101,193,83,203,0.77,87,92,120
OceanDNA-b41272,1357,9.3,0.0,3.4e-05,0.078,147,184,208,244,200,271,0.77,37,36,71
OceanDNA-b7128,140,14.1,0.1,1.2e-06,0.00049,107,221,134,249,121,256,0.77,114,115,135
OceanDNA-b41152,26,49.8,0.3,4.6e-17,3.5e-14,55,237,125,307,86,325,0.77,182,182,239
OceanDNA-b17318,494,22.2,0.0,4e-09,9.8e-06,118,208,405,498,388,508,0.77,90,93,120
OceanDNA-b19689,47,23.0,0.0,2.3e-09,9.2e-07,112,205,122,217,110,227,0.77,93,95,117
OceanDNA-b37083,540,31.8,0.0,4.7e-12,3.2e-09,48,137,154,254,132,261,0.77,89,100,129
OceanDNA-b23515,947,7.7,0.0,0.00022,0.14,162,228,202,269,195,271,0.77,66,67,76
OceanDNA-b42311,113,12.4,0.0,3.9e-06,0.00076,49,140,67,162,44,180,0.77,91,95,136
OceanDNA-b6163,418,11.2,0.0,9e-06,0.0052,98,152,89,141,42,154,0.77,54,52,112
OceanDNA-b20910,5024,15.5,0.2,4.5e-07,0.0039,37,139,36,148,17,210,0.77,102,112,193
OceanDNA-b37023,40,-2.5,0.0,0.14,110.0,188,227,350,390,337,396,0.77,39,40,59
OceanDNA-b17201,332,21.0,0.0,9.8e-09,7.9e-06,40,141,161,273,155,280,0.77,101,112,125
OceanDNA-b22127,244,29.1,1.4,3.1e-11,5.3e-08,19,138,248,375,242,380,0.77,119,127,138
OceanDNA-b15167,1945,-3.0,0.0,0.21,420.0,163,182,247,267,238,273,0.77,19,20,35
OceanDNA-b24611,64,11.9,0.1,5.6e-06,0.0024,104,154,121,172,109,239,0.77,50,51,130
OceanDNA-b22872,1278,13.2,0.0,4.7e-06,0.0072,117,162,262,307,233,342,0.77,45,45,109
OceanDNA-b40685,499,18.6,0.1,1e-07,5.6e-05,152,226,217,289,188,294,0.77,74,72,106
OceanDNA-b3961,1871,13.0,0.0,2.6e-06,0.0052,90,168,297,376,285,377,0.77,78,79,92
OceanDNA-b17735,2830,-0.1,0.0,0.027,82.0,176,199,269,291,229,301,0.77,23,22,72
OceanDNA-b22859,810,13.4,0.0,4e-06,0.0056,95,147,144,201,130,245,0.77,52,57,115
OceanDNA-b22412,1479,12.4,0.0,8.1e-06,0.0099,74,153,541,619,527,647,0.77,79,78,120
OceanDNA-b8783,80,-1.9,0.0,0.095,17.0,44,69,22,47,18,64,0.77,25,25,46
OceanDNA-b46254,70,11.5,0.1,7.3e-06,0.015,77,141,32,94,20,119,0.77,64,62,99
OceanDNA-b10034,202,23.5,0.0,3.4e-09,7.9e-07,116,200,179,265,163,275,0.77,84,86,112
OceanDNA-b34299,1271,12.3,0.0,8.7e-06,0.0088,69,161,191,283,162,292,0.77,92,92,130
OceanDNA-b22378,1422,11.9,0.0,1.2e-05,0.012,115,169,230,284,213,357,0.77,54,54,144
OceanDNA-b2513,1391,12.8,0.4,6.2e-06,0.0045,122,192,187,260,171,280,0.77,70,73,109
OceanDNA-b11352,456,6.3,0.0,0.00029,0.18,162,229,198,263,180,271,0.77,67,65,91
OceanDNA-b46695,368,16.0,0.0,1.5e-06,0.00068,119,209,144,235,131,246,0.77,90,91,115
OceanDNA-b40467,425,-0.0,0.0,0.075,39.0,25,53,369,397,357,410,0.77,28,28,53
OceanDNA-b20998,1644,-1.9,0.0,0.091,350.0,38,50,296,308,269,320,0.77,12,12,51
OceanDNA-b33388,2494,17.4,0.0,6e-07,0.00046,67,225,174,343,146,349,0.77,158,169,203
OceanDNA-b22827,3848,-1.6,0.0,0.3,370.0,67,89,241,263,221,273,0.77,22,22,52
OceanDNA-b45587,130,2.4,0.0,0.0046,4.2,160,225,192,254,183,260,0.77,65,62,77
OceanDNA-b29532,1267,13.8,0.0,1.5e-06,0.0043,54,145,241,330,208,345,0.77,91,89,137
OceanDNA-b23015,1474,12.4,0.0,4e-06,0.025,112,150,182,221,160,226,0.77,38,39,66
OceanDNA-b40967,187,28.9,0.0,3.7e-11,1.2e-07,69,188,96,217,53,268,0.77,119,121,215
OceanDNA-b276,205,31.6,0.0,1.6e-11,1.2e-08,70,209,93,228,62,241,0.77,139,135,179
OceanDNA-b20922,2978,5.8,0.0,0.0012,2.9,125,158,109,146,84,162,0.77,33,37,78
OceanDNA-b35796,702,10.0,0.0,2.2e-05,0.023,107,153,125,171,52,183,0.77,46,46,131
OceanDNA-b32143,845,-2.2,0.0,0.35,240.0,116,148,47,79,40,94,0.77,32,32,54
OceanDNA-b16039,280,5.1,0.0,0.0007,0.84,112,143,365,396,345,409,0.77,31,31,64
OceanDNA-b13250,2981,35.8,0.4,3e-12,1.2e-09,40,234,69,262,56,278,0.77,194,193,222
OceanDNA-b13250,780,28.5,0.0,4.8e-10,2e-07,66,236,213,374,169,388,0.77,170,161,219
OceanDNA-b32143,267,11.2,0.0,2.7e-05,0.019,98,143,139,182,122,192,0.77,45,43,70
OceanDNA-b11479,73,5.1,0.0,0.00069,0.36,163,233,193,261,183,272,0.77,70,68,89
OceanDNA-b258,486,10.5,0.0,1.5e-05,0.016,116,149,423,456,365,466,0.77,33,33,101
OceanDNA-b40943,23,11.5,0.0,1.5e-05,0.0069,69,146,38,109,21,119,0.77,77,71,98
OceanDNA-b37510,372,-3.2,0.0,0.46,370.0,122,154,544,576,540,583,0.77,32,32,43
OceanDNA-b18640,271,2.4,0.0,0.009,1.4,113,141,108,138,90,156,0.77,28,30,66
OceanDNA-b276,693,24.2,0.0,3e-09,2.3e-06,65,183,62,190,22,232,0.77,118,128,210
OceanDNA-b13138,651,-0.7,0.0,0.04,27.0,190,209,193,212,179,228,0.77,19,19,49
OceanDNA-b23258,83,16.2,0.0,2.7e-07,8.4e-05,112,152,230,272,201,293,0.77,40,42,92
OceanDNA-b229,508,21.0,0.0,9.3e-09,8.6e-06,116,187,118,191,87,219,0.77,71,73,132
OceanDNA-b35325,133,4.3,0.0,0.0012,0.63,146,184,192,230,187,262,0.77,38,38,75
OceanDNA-b30061,1447,10.9,0.1,1.2e-05,0.027,37,152,51,174,35,182,0.77,115,123,147
OceanDNA-b22995,1529,5.1,0.0,0.002,1.4,49,87,463,501,447,528,0.77,38,38,81
OceanDNA-b15283,256,19.1,0.1,3.6e-08,1.1e-05,21,152,7,146,3,167,0.77,131,139,164
OceanDNA-b40613,87,-3.5,0.0,0.84,210.0,165,184,220,239,208,243,0.77,19,19,35
OceanDNA-b22250,1966,13.7,0.0,1.6e-06,0.0051,115,156,136,178,109,185,0.77,41,42,76
OceanDNA-b46823,662,16.8,0.0,3.6e-07,0.00032,118,182,138,204,118,231,0.77,64,66,113
OceanDNA-b33315,39,32.5,0.0,3e-12,1.3e-08,64,177,128,251,87,304,0.77,113,123,217
OceanDNA-b33558,856,14.9,0.5,1.4e-06,0.00063,91,142,134,182,75,192,0.77,51,48,117
OceanDNA-b1825,1867,3.3,0.0,0.0049,9.0,163,233,577,649,548,657,0.77,70,72,109
OceanDNA-b27579,40,6.4,0.0,0.00054,0.79,136,209,213,285,202,298,0.77,73,72,96
OceanDNA-b23289,1196,11.3,0.1,8.7e-06,0.016,100,182,153,232,141,291,0.77,82,79,150
OceanDNA-b31334,15,13.5,0.0,1.8e-06,0.00028,104,162,105,165,87,169,0.77,58,60,82
OceanDNA-b46887,583,12.4,0.0,3.9e-06,0.0027,96,143,133,180,109,229,0.77,47,47,120
OceanDNA-b22893,2192,10.8,0.0,3.6e-05,0.028,101,154,211,265,198,273,0.77,53,54,75
OceanDNA-b30641,77,12.2,0.1,9.1e-06,0.0049,119,150,81,110,21,138,0.77,31,29,117
OceanDNA-b6447,204,13.2,0.0,2.2e-06,0.0011,45,150,24,130,13,149,0.77,105,106,136
OceanDNA-b15473,124,23.9,0.0,1.2e-09,6.5e-07,49,167,39,166,19,182,0.77,118,127,163
OceanDNA-b30447,350,4.9,0.0,0.00076,2.0,124,194,257,331,239,352,0.77,70,74,113
OceanDNA-b11888,925,28.7,0.2,4.2e-11,6.4e-08,54,208,158,318,150,325,0.77,154,160,175
OceanDNA-b17240,117,17.4,0.0,1.2e-07,5.9e-05,40,142,122,235,104,242,0.77,102,113,138
OceanDNA-b9171,194,-0.3,0.0,0.06,12.0,49,84,71,110,62,117,0.77,35,39,55
OceanDNA-b26955,261,10.1,0.1,2e-05,0.0063,124,161,159,199,140,215,0.77,37,40,75
OceanDNA-b44039,156,7.0,0.2,0.00035,0.053,111,138,161,188,69,196,0.77,27,27,127
OceanDNA-b36577,1192,18.6,0.1,1.1e-07,0.0001,32,152,25,151,2,164,0.77,120,126,162
OceanDNA-b15333,114,7.5,0.0,0.00013,0.039,116,145,132,161,79,170,0.77,29,29,91
OceanDNA-b45444,359,3.4,0.0,0.0022,1.2,162,228,94,158,85,162,0.77,66,64,77
OceanDNA-b11306,47,16.5,0.0,2.3e-07,6.2e-05,115,184,144,215,115,235,0.77,69,71,120
OceanDNA-b2829,55,-0.9,0.0,0.093,140.0,114,136,93,115,84,180,0.77,22,22,96
OceanDNA-b34949,622,11.5,0.0,2.3e-05,0.0074,121,146,147,172,119,187,0.77,25,25,68
OceanDNA-b3700,1479,23.8,0.0,1.3e-09,3.5e-06,50,176,207,335,188,342,0.77,126,128,154
OceanDNA-b202,123,15.0,0.0,1.3e-06,0.0014,112,180,453,523,427,551,0.77,68,70,124
OceanDNA-b45123,193,10.5,0.0,1.5e-05,0.014,161,226,174,235,152,240,0.77,65,61,88
OceanDNA-b41512,504,3.3,0.0,0.0024,4.8,110,143,134,167,111,187,0.77,33,33,76
OceanDNA-b33061,911,16.4,0.0,4.7e-07,0.00074,72,142,116,191,67,202,0.77,70,75,135
OceanDNA-b22261,1742,17.0,0.0,1.6e-07,0.00032,88,150,160,221,155,253,0.77,62,61,98
OceanDNA-b9096,35,39.2,0.0,5.2e-14,9e-12,44,142,128,237,90,252,0.77,98,109,162
OceanDNA-b20911,5136,5.6,0.4,0.00093,3.3,5,48,14,58,10,64,0.77,43,44,54
OceanDNA-b23399,1369,12.9,0.2,2.8e-06,0.0066,112,157,129,173,81,192,0.77,45,44,111
OceanDNA-b206,390,10.5,0.0,1.6e-05,0.0077,99,152,336,390,253,395,0.77,53,54,142
OceanDNA-b40066,15,15.0,0.0,6.2e-07,0.00017,63,151,33,115,16,151,0.77,88,82,135
OceanDNA-b15471,102,26.9,0.2,1.5e-10,8.1e-08,45,156,32,151,24,170,0.77,111,119,146
OceanDNA-b38975,199,32.1,0.1,4e-12,8.6e-09,34,236,102,293,71,309,0.77,202,191,238
OceanDNA-b12523,276,30.8,0.0,9.8e-12,3e-09,42,208,56,238,49,248,0.77,166,182,199
OceanDNA-b22397,543,12.1,0.0,1.9e-05,0.013,92,150,112,169,102,184,0.77,58,57,82
OceanDNA-b9758,999,14.0,0.0,1.3e-06,0.0015,113,154,168,211,156,246,0.77,41,43,90
OceanDNA-b36071,125,3.3,0.0,0.0024,5.0,164,231,198,263,164,271,0.77,67,65,107
OceanDNA-b20909,5248,15.6,0.0,4.3e-07,0.0031,77,159,231,316,225,322,0.77,82,85,97
OceanDNA-b3631,550,8.1,0.0,8e-05,0.081,195,231,222,259,183,270,0.77,36,37,87
OceanDNA-b30927,693,15.8,0.0,7.2e-07,0.00075,47,148,56,165,44,180,0.77,101,109,136
OceanDNA-b32861,681,2.9,0.0,0.0064,4.0,132,194,244,310,241,337,0.77,62,66,96
OceanDNA-b46897,281,11.8,0.0,6e-06,0.0052,114,180,176,244,156,251,0.77,66,68,95
OceanDNA-b35108,62,-4.1,0.0,0.43,280.0,35,54,366,385,362,395,0.77,19,19,33
OceanDNA-b44744,465,9.6,0.0,2.9e-05,0.023,55,151,46,140,32,168,0.77,96,94,136
OceanDNA-b38872,355,5.7,0.0,0.00044,0.29,159,233,183,255,173,273,0.77,74,72,100
OceanDNA-b11611,607,11.1,0.0,1e-05,0.0089,118,181,179,244,173,272,0.77,63,65,99
OceanDNA-b17761,2082,15.9,0.0,3.5e-07,0.001,69,159,192,281,168,312,0.77,90,89,144
OceanDNA-b40631,559,27.1,0.0,2.7e-10,7.5e-08,50,137,135,233,121,240,0.77,87,98,119
OceanDNA-b13561,806,-2.1,0.0,0.11,88.0,158,182,216,241,211,260,0.77,24,25,49
OceanDNA-b22130,1424,19.7,0.0,2.3e-08,5.8e-05,53,142,272,363,256,373,0.77,89,91,117
OceanDNA-b10700,95,12.3,0.0,4.4e-06,0.0013,117,157,127,167,115,196,0.77,40,40,81
OceanDNA-b6749,448,15.1,0.0,5.8e-07,0.00038,50,154,144,251,134,258,0.77,104,107,124
OceanDNA-b7010,63,2.3,0.0,0.0099,2.1,116,154,528,566,514,579,0.77,38,38,65
OceanDNA-b22882,788,-3.5,0.0,0.29,1200.0,70,87,167,184,159,187,0.77,17,17,28
OceanDNA-b13256,77,12.2,0.0,3.2e-05,0.0091,115,143,146,174,126,187,0.77,28,28,61
OceanDNA-b27525,756,4.8,0.2,0.0033,2.2,165,231,262,326,249,334,0.77,66,64,85
OceanDNA-b9789,34,18.3,0.0,6.1e-08,4.4e-05,114,208,136,233,115,251,0.77,94,97,136
OceanDNA-b22108,719,18.8,0.0,8.7e-08,8.8e-05,102,159,148,205,118,229,0.77,57,57,111
OceanDNA-b22876,1950,9.6,0.0,2.9e-05,0.11,104,150,154,200,138,214,0.77,46,46,76
OceanDNA-b39186,25,16.7,0.0,2e-07,0.00011,112,149,137,176,123,185,0.77,37,39,62
OceanDNA-b4473,86,26.6,0.0,3.8e-10,5.3e-08,117,194,151,228,126,250,0.77,77,77,124
OceanDNA-b23850,1393,10.2,0.4,5.7e-05,0.028,97,222,194,324,185,331,0.77,125,130,146
OceanDNA-b22443,289,10.8,0.0,1.2e-05,0.031,104,149,550,592,511,614,0.77,45,42,103
OceanDNA-b26769,766,-0.1,0.0,0.025,50.0,167,197,271,301,266,307,0.77,30,30,41
OceanDNA-b40450,841,15.6,0.0,4.2e-07,0.00067,52,156,89,189,56,222,0.77,104,100,166
OceanDNA-b17208,311,23.6,0.0,1.6e-09,1.4e-06,40,141,141,253,135,260,0.77,101,112,125
OceanDNA-b16215,916,17.8,0.2,1.8e-07,0.00011,116,153,52,89,10,101,0.77,37,37,91
OceanDNA-b9767,735,21.1,0.0,8.6e-09,9e-06,48,154,173,282,164,289,0.76,106,109,125
OceanDNA-b20986,2603,19.0,0.0,3.8e-08,0.00012,53,139,161,258,126,271,0.76,86,97,145
OceanDNA-b9654,484,12.3,0.1,4.2e-06,0.0024,138,227,200,286,195,287,0.76,89,86,92
OceanDNA-b23169,959,-0.5,0.0,0.034,77.0,56,86,132,162,122,167,0.76,30,30,45
OceanDNA-b484,1486,20.8,0.0,1.1e-08,2.2e-05,85,208,258,394,205,400,0.76,123,136,195
OceanDNA-b2647,1155,15.0,0.0,1.3e-06,0.0018,41,145,13,121,3,134,0.76,104,108,131
OceanDNA-b37578,813,25.4,0.0,4.2e-10,1.1e-06,40,213,92,283,48,292,0.76,173,191,244
OceanDNA-b22554,202,11.5,0.0,2.3e-05,0.009,98,144,140,183,89,197,0.76,46,43,108
OceanDNA-b27565,2096,13.2,0.1,2.3e-06,0.0056,119,177,76,135,59,156,0.76,58,59,97
OceanDNA-b13539,479,11.9,0.0,1.2e-05,0.0089,70,145,113,193,97,201,0.76,75,80,104
OceanDNA-b15453,1335,21.1,0.0,1.7e-08,1.9e-05,71,173,133,248,129,282,0.76,102,115,153
OceanDNA-b18118,196,18.7,0.0,4.9e-08,9.9e-06,112,157,51,96,28,125,0.76,45,45,97
OceanDNA-b22406,759,18.2,0.0,2.6e-07,0.00019,73,156,169,259,163,268,0.76,83,90,105
OceanDNA-b34729,429,-3.6,0.0,0.3,260.0,146,162,36,52,30,59,0.76,16,16,29
OceanDNA-b21040,270,35.1,0.1,9.4e-13,2.2e-09,52,155,18,126,7,132,0.76,103,108,125
OceanDNA-b5721,663,4.0,0.0,0.0014,1.4,118,147,159,189,134,201,0.76,29,30,67
OceanDNA-b20657,149,8.0,0.0,0.00017,0.026,114,159,81,125,24,158,0.76,45,44,134
OceanDNA-b23003,1384,15.7,0.4,1.1e-06,0.00095,17,139,295,422,281,448,0.76,122,127,167
OceanDNA-b20565,177,54.8,0.0,4.7e-19,1.3e-16,31,245,70,309,46,319,0.76,214,239,273
OceanDNA-b9190,106,30.6,0.0,1.1e-11,4.3e-09,49,149,141,252,133,264,0.76,100,111,131
OceanDNA-b5580,188,40.5,0.1,2.1e-14,4.9e-12,51,209,71,237,35,246,0.76,158,166,211
OceanDNA-b22461,2712,8.4,0.1,0.00013,0.31,95,147,140,195,127,200,0.76,52,55,73
OceanDNA-b17591,1464,-2.2,0.0,0.11,180.0,176,199,287,309,271,313,0.76,23,22,42
OceanDNA-b20962,1837,18.7,0.6,4.9e-08,0.00025,33,145,378,494,370,518,0.76,112,116,148
OceanDNA-b17223,1759,12.0,0.0,1.6e-05,0.015,54,140,70,152,65,161,0.76,86,82,96
OceanDNA-b40473,146,2.1,0.0,0.011,6.0,33,76,17,65,5,103,0.76,43,48,98
OceanDNA-b22077,185,-1.4,0.0,0.064,85.0,162,189,245,272,231,292,0.76,27,27,61
OceanDNA-b15420,152,-1.5,0.0,0.069,25.0,118,141,92,115,69,135,0.76,23,23,66
OceanDNA-b27,3135,17.8,0.1,8.9e-08,0.0003,35,142,58,161,41,165,0.76,107,103,124
OceanDNA-b29510,1279,17.6,0.1,3.1e-07,0.00025,45,144,126,232,107,237,0.76,99,106,130
OceanDNA-b20902,2959,0.7,0.0,0.015,65.0,133,167,36,70,15,77,0.76,34,34,62
OceanDNA-b24712,366,8.7,0.0,5.2e-05,0.032,122,163,105,149,76,155,0.76,41,44,79
OceanDNA-b31510,187,25.1,0.0,1.6e-09,6e-07,45,148,224,338,215,346,0.76,103,114,131
OceanDNA-b46181,281,-3.9,0.0,0.38,310.0,165,186,229,249,224,259,0.76,21,20,35
OceanDNA-b25814,151,25.4,0.0,4.3e-10,8.9e-08,25,177,73,238,56,297,0.76,152,165,241
OceanDNA-b35246,714,12.7,0.0,3.3e-06,0.0024,67,91,68,92,43,104,0.76,24,24,61
OceanDNA-b4498,1017,27.4,0.0,3.1e-10,1.1e-07,47,141,152,257,147,269,0.76,94,105,122
OceanDNA-b26143,256,15.3,0.0,5.1e-07,0.00062,118,146,143,171,117,199,0.76,28,28,82
OceanDNA-b27517,3792,3.9,0.1,0.0031,6.8,126,152,112,138,88,157,0.76,26,26,69
OceanDNA-b41030,2010,11.1,0.1,3e-05,0.025,96,150,57,115,22,129,0.76,54,58,107
OceanDNA-b46766,1240,19.3,0.0,6.4e-08,5.7e-05,116,180,138,204,119,227,0.76,64,66,108
OceanDNA-b30739,776,20.4,0.0,1.4e-08,1.9e-05,29,177,88,248,74,254,0.76,148,160,180
OceanDNA-b31979,1189,32.5,0.1,3e-12,6.5e-09,50,191,39,191,12,213,0.76,141,152,201
OceanDNA-b22687,325,21.9,0.1,4.9e-09,4.9e-06,100,207,133,239,126,246,0.76,107,106,120
OceanDNA-b17622,995,12.4,0.0,3.9e-06,0.0052,56,152,63,157,38,167,0.76,96,94,129
OceanDNA-b46513,458,-3.3,0.0,0.49,140.0,212,229,33,50,29,60,0.76,17,17,31
OceanDNA-b20259,119,60.1,0.1,1.1e-20,3.7e-18,35,247,74,317,55,327,0.76,212,243,272
OceanDNA-b26049,90,13.3,0.0,2.2e-06,0.00065,120,145,8,33,2,61,0.76,25,25,59
OceanDNA-b22828,2407,21.6,0.0,1.2e-08,2.6e-05,94,226,132,262,120,273,0.76,132,130,153
OceanDNA-b41127,1967,50.2,0.3,1.2e-17,2.6e-14,48,236,110,298,77,313,0.76,188,188,236
OceanDNA-b33096,89,12.0,0.0,1.5e-05,0.0066,68,143,11,96,4,109,0.76,75,85,105
OceanDNA-b30938,1023,16.4,0.0,7e-07,0.00058,53,177,106,240,59,289,0.76,124,134,230
OceanDNA-b6750,637,14.0,0.0,4e-06,0.00098,112,153,136,178,118,238,0.76,41,42,120
OceanDNA-b45789,15,4.0,0.0,0.0015,0.82,155,228,172,243,161,246,0.76,73,71,85
OceanDNA-b22386,1905,11.2,0.0,2.8e-05,0.019,116,154,258,297,225,337,0.76,38,39,112
OceanDNA-b22386,1905,26.8,0.0,4.8e-10,3.3e-07,118,209,26,119,11,125,0.76,91,93,114
OceanDNA-b30238,288,1.5,0.0,0.0083,17.0,165,229,201,263,187,270,0.76,64,62,83
OceanDNA-b22905,549,10.4,0.0,3.3e-05,0.045,74,139,189,258,181,271,0.76,65,69,90
OceanDNA-b31076,1340,12.8,0.1,9.1e-06,0.009,118,178,279,346,250,369,0.76,60,67,119
OceanDNA-b40444,376,13.1,0.0,9.9e-06,0.0045,142,208,281,352,273,360,0.76,66,71,87
OceanDNA-b22823,1208,11.3,0.0,1.8e-05,0.038,121,180,107,165,78,173,0.76,59,58,95
OceanDNA-b22604,970,20.5,0.0,1.4e-08,1.7e-05,116,182,151,219,127,247,0.76,66,68,120
OceanDNA-b22108,67,15.5,0.0,9.2e-07,0.00094,118,176,138,196,116,208,0.76,58,58,92
OceanDNA-b22108,67,5.0,0.1,0.0014,1.4,165,225,209,267,197,273,0.76,60,58,76
OceanDNA-b46919,1465,11.9,0.0,1.2e-05,0.0092,117,144,316,343,286,354,0.76,27,27,68
OceanDNA-b34918,448,2.9,0.0,0.0061,3.2,147,219,316,393,303,414,0.76,72,77,111
OceanDNA-b4005,288,23.1,0.0,2.2e-09,2.5e-06,47,154,155,265,145,272,0.76,107,110,127
OceanDNA-b43986,170,4.1,0.0,0.0014,0.35,159,210,232,289,222,328,0.76,51,57,106
OceanDNA-b19691,328,15.5,0.3,4.7e-07,0.00018,20,151,24,148,19,154,0.76,131,124,135
OceanDNA-b41055,555,44.4,0.1,6.9e-16,1.5e-12,39,233,71,269,36,283,0.76,194,198,247
OceanDNA-b47105,25,0.8,0.0,0.013,4.2,125,146,137,158,111,170,0.76,21,21,59
OceanDNA-b43,3730,2.3,0.0,0.0095,32.0,107,155,558,607,543,617,0.76,48,49,74
OceanDNA-b26127,967,17.2,0.0,1.4e-07,0.00017,119,148,144,174,121,202,0.76,29,30,81
OceanDNA-b22850,622,14.3,0.0,2.1e-06,0.0029,74,156,346,435,289,443,0.76,82,89,154
OceanDNA-b11387,379,15.4,0.0,1e-06,0.0003,18,61,40,86,30,92,0.76,43,46,62
OceanDNA-b26229,11,10.9,0.1,1.2e-05,0.0067,79,157,106,184,93,191,0.76,78,78,98
OceanDNA-b26971,162,11.1,0.1,9.7e-06,0.002,123,162,158,200,137,217,0.76,39,42,80
OceanDNA-b4249,812,7.2,0.0,0.00015,0.21,112,160,109,160,66,168,0.76,48,51,102
OceanDNA-b147,45,19.6,0.1,2.5e-08,2.2e-05,39,139,87,196,73,206,0.76,100,109,133
OceanDNA-b25026,751,13.7,0.1,1.6e-06,0.0014,66,173,91,201,78,275,0.76,107,110,197
OceanDNA-b34551,738,6.1,0.1,0.001,0.3,132,183,252,309,227,340,0.76,51,57,113
OceanDNA-b5279,16,36.8,0.1,1.5e-13,7.6e-11,41,209,122,307,91,318,0.76,168,185,227
OceanDNA-b22412,1576,9.6,0.2,5.8e-05,0.07,116,145,189,218,179,324,0.76,29,29,145
OceanDNA-b24040,1710,2.4,0.0,0.0043,7.6,139,209,59,134,53,142,0.76,70,75,89
OceanDNA-b1358,1852,12.9,0.6,2.7e-06,0.008,117,176,106,163,39,186,0.76,59,57,147
OceanDNA-b26646,3259,16.3,0.0,5.1e-07,0.00092,113,208,157,255,87,276,0.76,95,98,189
OceanDNA-b32059,1567,20.0,0.0,2e-08,4.5e-05,50,153,117,229,72,233,0.76,103,112,161
OceanDNA-b30216,630,0.7,0.0,0.015,30.0,164,229,403,466,389,472,0.76,65,63,83
OceanDNA-b297,857,19.3,0.0,3.2e-08,4e-05,64,182,49,177,19,203,0.76,118,128,184
OceanDNA-b35108,62,1.1,0.0,0.011,6.9,105,150,522,567,512,585,0.76,45,45,73
OceanDNA-b13263,291,13.3,0.0,6.3e-06,0.0021,117,159,147,189,64,205,0.76,42,42,141
OceanDNA-b13256,418,20.4,0.4,1e-07,2.8e-05,35,211,164,332,153,371,0.76,176,168,218
OceanDNA-b61,724,-1.5,0.0,0.071,82.0,79,126,224,270,214,296,0.76,47,46,82
OceanDNA-b19419,260,22.5,0.0,3.2e-09,9.7e-07,66,154,102,187,70,237,0.76,88,85,167
OceanDNA-b26781,497,4.3,0.0,0.0024,2.1,150,193,275,320,252,327,0.76,43,45,75
OceanDNA-b22871,3196,17.8,0.0,9.1e-08,0.00036,53,163,72,183,51,200,0.76,110,111,149
OceanDNA-b36648,147,2.4,0.0,0.0045,2.5,118,140,504,526,498,547,0.76,22,22,49
OceanDNA-b22849,1144,12.5,0.0,7.4e-06,0.0074,100,154,200,254,164,280,0.76,54,54,116
OceanDNA-b30,835,5.8,0.0,0.0004,1.5,156,210,307,354,299,367,0.76,54,47,68
OceanDNA-b30226,1919,16.3,0.1,2.6e-07,0.00064,51,146,70,173,44,213,0.76,95,103,169
OceanDNA-b46505,115,11.5,0.0,1.5e-05,0.016,103,182,138,217,129,228,0.76,79,79,99
OceanDNA-b15230,234,27.7,0.0,1.8e-10,4.2e-08,38,179,32,181,19,220,0.76,141,149,201
OceanDNA-b3626,407,10.9,0.0,1.2e-05,0.015,141,194,209,262,201,293,0.76,53,53,92
OceanDNA-b40641,871,-3.0,0.0,0.81,270.0,57,70,17,30,12,36,0.76,13,13,24
OceanDNA-b44771,155,12.6,0.0,3.4e-06,0.0013,109,150,77,120,43,135,0.76,41,43,92
OceanDNA-b13294,1747,19.4,0.0,2.9e-08,5.1e-05,116,210,23,122,6,127,0.76,94,99,121
OceanDNA-b15507,1408,20.7,0.1,1.2e-08,2.3e-05,44,165,43,173,23,184,0.76,121,130,161
OceanDNA-b37054,2298,22.1,0.2,8.7e-09,1.4e-05,40,196,82,256,62,269,0.76,156,174,207
OceanDNA-b6556,429,6.4,0.0,0.00028,0.32,196,230,222,257,181,261,0.76,34,35,80
OceanDNA-b20974,1857,26.2,0.1,2.5e-10,7e-07,41,140,371,476,341,482,0.76,99,105,141
OceanDNA-b23037,640,12.9,0.0,2.7e-06,0.0049,115,180,33,100,20,119,0.76,65,67,99
OceanDNA-b34662,91,1.3,0.0,0.0095,8.4,43,68,11,36,8,53,0.76,25,25,45
OceanDNA-b28587,550,5.0,0.0,0.00072,0.61,117,152,119,154,84,160,0.76,35,35,76
OceanDNA-b46651,3775,10.7,0.0,4e-05,0.054,98,145,224,271,191,287,0.76,47,47,96
OceanDNA-b20923,2810,17.5,0.0,1.1e-07,0.00066,112,159,1218,1268,1195,1279,0.76,47,50,84
OceanDNA-b6503,557,1.6,0.0,0.016,5.2,122,142,96,116,82,192,0.76,20,20,110
OceanDNA-b35159,950,11.5,0.0,1.5e-05,0.013,99,153,138,189,122,249,0.76,54,51,127
OceanDNA-b18640,271,11.9,0.0,1.2e-05,0.0018,147,184,240,275,227,316,0.76,37,35,89
OceanDNA-b3385,1277,-1.0,0.0,0.049,170.0,163,182,327,346,315,380,0.76,19,19,65
OceanDNA-b22765,288,15.7,0.0,7.9e-07,0.00064,74,177,515,625,494,654,0.76,103,110,160
OceanDNA-b36995,376,-2.3,0.0,0.12,96.0,57,85,152,180,146,183,0.76,28,28,37
OceanDNA-b22993,1301,15.4,0.0,4.9e-07,0.00067,95,152,91,149,78,163,0.76,57,58,85
OceanDNA-b3921,473,11.0,0.0,1.1e-05,0.0075,121,151,147,177,54,199,0.76,30,30,145
OceanDNA-b112,1144,12.3,0.0,4.2e-06,0.0067,93,166,98,169,37,209,0.76,73,71,172
OceanDNA-b34219,1020,-2.0,0.0,0.095,240.0,159,182,306,329,284,357,0.76,23,23,73
OceanDNA-b36948,1090,22.9,0.1,2.4e-09,2.8e-06,59,157,192,282,176,293,0.76,98,90,117
OceanDNA-b6505,278,3.9,0.0,0.0015,1.3,163,229,186,250,176,258,0.76,66,64,82
OceanDNA-b32709,628,10.9,0.0,2.4e-05,0.02,54,144,174,267,165,285,0.76,90,93,120
OceanDNA-b35828,625,5.2,0.0,0.00061,0.53,184,230,262,305,232,309,0.76,46,43,77
OceanDNA-b23379,1414,-1.1,0.1,0.11,120.0,138,188,361,413,352,441,0.76,50,52,89
OceanDNA-b24081,88,10.1,0.0,2e-05,0.0078,115,162,222,270,147,275,0.76,47,48,128
OceanDNA-b4044,627,24.8,0.0,6.7e-10,6.4e-07,69,156,158,250,130,259,0.76,87,92,129
OceanDNA-b46906,628,15.1,0.0,5.9e-07,0.00046,96,143,146,193,126,243,0.76,47,47,117
OceanDNA-b34784,453,-1.0,0.0,0.048,26.0,105,154,525,574,519,584,0.76,49,49,65
OceanDNA-b9159,116,13.2,0.0,2.3e-06,0.00079,103,142,162,201,153,223,0.76,39,39,70
OceanDNA-b3607,1449,14.4,0.0,2e-06,0.0025,39,156,65,190,31,197,0.76,117,125,166
OceanDNA-b16229,53,0.1,0.0,0.067,29.0,99,131,694,729,678,735,0.76,32,35,57
OceanDNA-b13288,867,37.7,0.0,7.6e-14,8.2e-11,48,189,275,436,270,454,0.76,141,161,184
OceanDNA-b20036,199,9.2,0.0,0.00011,0.014,185,247,274,335,248,347,0.76,62,61,99
OceanDNA-b20036,313,15.1,0.0,1.8e-06,0.00022,118,190,130,203,115,229,0.76,72,73,114
OceanDNA-b15138,650,13.1,0.8,5e-06,0.0027,61,150,31,118,15,120,0.76,89,87,105
OceanDNA-b20629,17,18.2,0.0,6.6e-08,1.2e-05,92,172,206,293,196,298,0.76,80,87,102
OceanDNA-b47053,235,-2.3,0.0,0.13,83.0,121,134,30,43,8,57,0.76,13,13,49
OceanDNA-b40453,184,26.0,0.0,5.5e-10,3.3e-07,45,138,134,239,100,247,0.76,93,105,147
OceanDNA-b34611,71,-3.2,0.0,0.24,300.0,120,154,536,570,526,577,0.76,34,34,51
OceanDNA-b36158,534,12.9,0.2,5.5e-06,0.0051,110,173,33,99,19,127,0.76,63,66,108
OceanDNA-b40439,284,23.1,0.0,4.4e-09,4.4e-06,49,138,131,231,114,239,0.76,89,100,125
OceanDNA-b29,914,14.5,0.0,3.7e-06,0.0048,114,170,107,166,74,193,0.76,56,59,119
OceanDNA-b23345,103,14.7,0.0,8e-07,0.0016,112,151,683,722,619,733,0.76,39,39,114
OceanDNA-b26844,1735,10.4,0.1,1.7e-05,0.054,58,152,49,144,33,160,0.76,94,95,127
OceanDNA-b20511,29,7.3,0.0,0.00015,0.04,42,86,111,157,83,172,0.76,44,46,89
OceanDNA-b3610,1589,11.4,0.0,7.8e-06,0.026,49,141,96,187,71,201,0.76,92,91,130
OceanDNA-b22460,1842,13.8,0.0,3e-06,0.0051,74,176,677,782,664,799,0.76,102,105,135
OceanDNA-b35325,133,10.9,0.0,1.2e-05,0.0063,59,146,31,113,14,125,0.76,87,82,111
OceanDNA-b44160,136,12.1,0.1,5e-06,0.0032,82,149,46,108,21,154,0.76,67,62,133
OceanDNA-b6184,38,17.0,0.0,1.5e-07,0.00011,39,156,54,178,36,185,0.76,117,124,149
OceanDNA-b23918,1793,12.4,0.0,8.2e-06,0.0079,119,149,117,147,79,157,0.76,30,30,78
OceanDNA-b30852,157,-2.0,0.0,0.2,190.0,198,232,232,267,223,271,0.76,34,35,48
OceanDNA-b30852,157,10.2,0.0,3.7e-05,0.037,59,149,50,141,22,161,0.76,90,91,139
OceanDNA-b260,2646,21.3,0.0,1.5e-08,2.5e-05,81,209,114,238,91,245,0.76,128,124,154
OceanDNA-b41544,516,8.2,0.0,7.5e-05,0.083,103,138,138,171,125,178,0.76,35,33,53
OceanDNA-b41014,987,44.7,0.5,1.1e-15,1.2e-12,40,237,106,307,84,321,0.76,197,201,237
OceanDNA-b32047,1611,11.2,0.0,2.8e-05,0.033,70,155,545,640,497,648,0.76,85,95,151
OceanDNA-b22012,141,17.4,0.0,1.2e-07,3.5e-05,40,143,58,165,48,178,0.76,103,107,130
OceanDNA-b39,3911,9.8,0.1,5e-05,0.17,66,150,117,200,62,218,0.76,84,83,156
OceanDNA-b3627,388,16.6,0.0,2.2e-07,0.00016,100,182,126,204,121,220,0.76,82,78,99
OceanDNA-b27622,294,1.0,0.1,0.012,9.0,195,231,251,288,219,296,0.76,36,37,77
OceanDNA-b22858,1665,-3.2,0.2,0.45,770.0,91,125,126,157,116,160,0.76,34,31,44
OceanDNA-b41214,2347,-2.5,0.0,0.14,520.0,87,112,244,269,232,274,0.76,25,25,42
OceanDNA-b26901,1549,11.0,0.2,2.1e-05,0.04,30,152,55,171,31,204,0.76,122,116,173
OceanDNA-b24067,94,10.6,0.0,1.4e-05,0.033,100,161,241,297,176,305,0.76,61,56,129
OceanDNA-b17033,808,14.8,0.0,1.5e-06,0.0012,59,140,100,187,81,197,0.76,81,87,116
OceanDNA-b36401,140,16.4,0.0,4.9e-07,0.00028,111,156,100,145,5,169,0.76,45,45,164
OceanDNA-b26380,46,19.5,0.0,2.8e-08,2.2e-05,54,155,46,152,31,171,0.76,101,106,140
OceanDNA-b21019,1371,11.6,0.0,7.1e-06,0.021,85,152,91,160,85,165,0.76,67,69,80
OceanDNA-b38741,416,17.0,0.0,1.5e-07,7.8e-05,113,158,252,297,224,319,0.76,45,45,95
OceanDNA-b22616,3382,30.9,0.0,1.8e-11,3.9e-08,118,211,144,239,129,244,0.76,93,95,115
OceanDNA-b467,2682,-0.0,0.1,0.025,70.0,125,153,104,132,91,165,0.76,28,28,74
OceanDNA-a2885,877,11.7,0.0,6.7e-06,0.0096,93,141,77,125,28,138,0.76,48,48,110
OceanDNA-b30225,1397,0.2,0.0,0.041,52.0,115,143,93,121,30,131,0.76,28,28,101
OceanDNA-b3337,2399,2.8,0.0,0.0069,12.0,122,146,326,350,293,362,0.76,24,24,69
OceanDNA-b37161,189,-1.7,0.0,0.079,86.0,162,181,209,228,202,262,0.76,19,19,60
OceanDNA-b37023,40,11.3,0.0,8.7e-06,0.0065,49,148,142,243,103,255,0.76,99,101,152
OceanDNA-b34674,221,6.1,0.1,0.00034,0.21,133,222,290,383,260,393,0.76,89,93,133
OceanDNA-b2923,1425,12.0,0.0,5.1e-06,0.0099,44,145,32,130,4,146,0.76,101,98,142
OceanDNA-b8720,145,2.9,0.0,0.0032,0.88,160,218,201,259,196,266,0.76,58,58,70
OceanDNA-b16480,1016,-1.2,0.0,0.055,61.0,118,139,230,251,206,261,0.76,21,21,55
OceanDNA-b3920,492,14.2,0.0,3.4e-06,0.0022,118,182,365,431,348,446,0.76,64,66,98
OceanDNA-b23312,2294,13.2,0.2,2.3e-06,0.0063,99,180,125,207,82,217,0.76,81,82,135
OceanDNA-b13198,39,7.0,0.0,0.00018,0.091,161,231,188,256,157,297,0.76,70,68,140
OceanDNA-b9532,294,15.6,0.0,8.3e-07,0.00013,102,203,166,269,146,296,0.76,101,103,150
OceanDNA-b20967,119,17.5,0.0,1.1e-07,0.00016,50,142,142,243,127,266,0.76,92,101,139
OceanDNA-b26837,1569,-0.8,0.0,0.044,130.0,156,178,184,206,158,238,0.76,22,22,80
OceanDNA-b26935,170,19.8,0.0,2.2e-08,5.6e-06,42,158,156,277,151,287,0.76,116,121,136
OceanDNA-b26065,209,11.1,0.0,1e-05,0.0036,119,142,147,170,128,197,0.76,23,23,69
OceanDNA-b29385,1481,10.7,0.1,4e-05,0.045,117,153,130,167,103,172,0.76,36,37,69
OceanDNA-b23176,189,34.4,0.0,1.6e-12,5.8e-09,49,181,64,204,35,230,0.76,132,140,195
OceanDNA-b36161,572,-2.8,0.0,0.17,360.0,135,158,47,70,21,75,0.76,23,23,54
OceanDNA-b20674,70,11.7,0.0,6.4e-06,0.0019,184,238,266,320,238,337,0.76,54,54,99
OceanDNA-b16127,236,-0.5,0.0,0.067,21.0,186,215,223,254,211,262,0.76,29,31,51
OceanDNA-b22890,496,15.6,0.0,8.6e-07,0.00091,116,181,172,239,150,257,0.76,65,67,107
OceanDNA-b46530,745,10.7,0.0,2.7e-05,0.015,118,145,236,263,220,279,0.76,27,27,59
OceanDNA-b5857,282,-0.7,0.0,0.039,17.0,118,138,139,159,118,172,0.76,20,20,54
OceanDNA-b24073,156,18.2,0.1,7e-08,6.2e-05,98,152,103,152,90,163,0.76,54,49,73
OceanDNA-b35901,408,19.5,0.0,5.4e-08,1.6e-05,35,150,30,151,19,180,0.76,115,121,161
OceanDNA-b24641,274,13.5,0.0,1.8e-06,0.0006,60,150,38,129,5,158,0.76,90,91,153
OceanDNA-b6674,104,15.5,0.0,9.2e-07,0.0003,108,230,147,271,135,279,0.76,122,124,144
OceanDNA-b38499,23,-0.1,0.0,0.026,26.0,215,248,389,424,360,433,0.75,33,35,73
OceanDNA-b16143,19,12.9,0.0,5.6e-06,0.0024,42,147,255,376,251,392,0.75,105,121,141
OceanDNA-b26501,866,-2.8,0.0,0.17,270.0,158,186,296,325,291,339,0.75,28,29,48
OceanDNA-b41358,206,8.0,0.0,0.00018,0.11,158,190,325,360,311,381,0.75,32,35,70
OceanDNA-b19120,158,18.2,0.0,1.3e-07,2.2e-05,96,154,98,155,75,201,0.75,58,57,126
OceanDNA-b45520,838,23.3,0.0,3.7e-09,2.6e-06,98,154,155,211,104,269,0.75,56,56,165
OceanDNA-b23176,189,-1.7,0.0,0.16,610.0,210,231,275,296,263,303,0.75,21,21,40
OceanDNA-b6567,196,-3.1,0.0,0.21,210.0,122,154,319,351,308,359,0.75,32,32,51
OceanDNA-a1406,33,12.6,0.0,3.4e-06,0.00076,174,231,167,229,147,240,0.75,57,62,93
OceanDNA-b33325,189,0.0,0.0,0.024,38.0,221,249,261,290,228,292,0.75,28,29,64
OceanDNA-b30139,2064,15.0,0.0,1.3e-06,0.0017,34,169,26,173,10,231,0.75,135,147,221
OceanDNA-b41526,356,15.8,0.2,7.6e-07,0.00042,72,134,116,176,99,211,0.75,62,60,112
OceanDNA-b5270,260,48.7,0.6,3.4e-17,1.7e-14,41,209,59,244,31,253,0.75,168,185,222
OceanDNA-b22888,920,18.0,0.1,7.9e-08,0.00011,54,151,127,222,105,249,0.75,97,95,144
OceanDNA-b23417,1309,-3.8,0.0,0.7,1000.0,54,83,185,214,184,233,0.75,29,29,49
OceanDNA-b19590,449,21.4,0.0,7.4e-09,3.4e-06,108,183,119,197,111,223,0.75,75,78,112
OceanDNA-b37582,1979,23.8,0.0,2.6e-09,3.2e-06,40,209,92,279,78,292,0.75,169,187,214
OceanDNA-b34859,125,10.9,0.0,1.1e-05,0.0082,103,152,119,164,106,182,0.75,49,45,76
OceanDNA-b38575,589,18.3,0.0,6.1e-08,4.2e-05,42,151,27,140,20,154,0.75,109,113,134
OceanDNA-b36099,123,2.0,0.1,0.0058,12.0,50,76,84,109,59,115,0.75,26,25,56
OceanDNA-b46921,2201,18.9,0.0,8.3e-08,9.9e-05,117,150,448,481,421,495,0.75,33,33,74
OceanDNA-b46972,215,10.5,0.0,3.1e-05,0.012,115,155,312,352,298,368,0.75,40,40,70
OceanDNA-b9646,517,16.5,0.0,2.2e-07,0.00013,112,180,134,206,114,227,0.75,68,72,113
OceanDNA-b22944,383,-1.8,0.0,0.086,360.0,164,189,78,103,68,122,0.75,25,25,54
OceanDNA-b16138,515,3.1,0.0,0.0028,2.1,146,211,422,490,415,498,0.75,65,68,83
OceanDNA-b41853,159,-3.1,0.0,0.21,41.0,23,41,58,76,53,84,0.75,18,18,31
OceanDNA-b23104,1060,25.5,0.0,4e-10,1.6e-06,12,139,570,702,562,708,0.75,127,132,146
OceanDNA-b46913,578,10.8,0.0,1.3e-05,0.03,113,143,155,184,76,198,0.75,30,29,122
OceanDNA-b41178,255,51.5,0.4,4.7e-18,1e-14,54,237,121,304,81,318,0.75,183,183,237
OceanDNA-b19821,211,22.1,0.0,4.5e-09,1.6e-06,111,182,96,169,77,190,0.75,71,73,113
OceanDNA-b41003,1014,30.3,0.0,1.4e-11,3.9e-08,65,191,92,220,43,270,0.75,126,128,227
OceanDNA-b22215,297,12.3,0.0,4.3e-06,0.0042,98,180,62,146,52,159,0.75,82,84,107
OceanDNA-b15286,45,14.6,0.0,1.7e-06,0.00022,116,184,110,181,91,211,0.75,68,71,120
OceanDNA-b46644,141,28.5,0.0,4.8e-11,6.6e-08,108,159,140,193,122,242,0.75,51,53,120
OceanDNA-b22905,478,16.9,0.0,3.4e-07,0.00047,27,177,84,247,69,305,0.75,150,163,236
OceanDNA-b31981,881,19.3,0.0,3.2e-08,7.5e-05,127,179,141,196,119,246,0.75,52,55,127
OceanDNA-b289,2632,27.4,0.0,2.1e-10,4e-07,118,219,211,316,178,329,0.75,101,105,151
OceanDNA-b27110,284,11.8,0.0,5.9e-06,0.0018,93,141,95,148,32,198,0.75,48,53,166
OceanDNA-b15726,327,25.4,0.0,4.4e-10,3.9e-07,47,168,26,156,11,190,0.75,121,130,179
OceanDNA-b26748,560,11.6,0.1,7.1e-06,0.016,99,156,72,128,5,142,0.75,57,56,137
OceanDNA-b32974,1907,12.8,0.0,5.9e-06,0.0088,103,150,135,183,128,194,0.75,47,48,66
OceanDNA-b15777,1620,6.1,0.0,0.00098,0.56,117,145,106,134,94,159,0.75,28,28,65
OceanDNA-b23918,382,13.6,0.0,3.4e-06,0.0033,162,231,210,278,199,300,0.75,69,68,101
OceanDNA-b31523,1127,24.7,0.1,7.3e-10,1.1e-06,47,141,156,264,145,272,0.75,94,108,127
OceanDNA-b22378,991,10.6,0.0,2.9e-05,0.029,101,155,135,188,70,223,0.75,54,53,153
OceanDNA-b45582,707,5.5,0.0,0.00051,1.2,160,225,281,343,273,349,0.75,65,62,76
OceanDNA-b45502,684,24.2,0.0,1e-09,1.3e-06,116,208,163,269,150,276,0.75,92,106,126
OceanDNA-b9716,321,11.4,0.0,8e-06,0.004,59,148,20,104,13,148,0.75,89,84,135
OceanDNA-b33331,208,-0.9,0.0,0.09,71.0,174,214,76,115,59,131,0.75,40,39,72
OceanDNA-b401,641,2.2,0.0,0.01,5.1,126,174,27,79,21,83,0.75,48,52,62
OceanDNA-b19130,5,11.4,0.0,1.6e-05,0.0036,94,156,277,343,266,355,0.75,62,66,89
OceanDNA-b23049,1569,-1.2,0.1,0.057,130.0,124,152,116,144,97,159,0.75,28,28,62
OceanDNA-b30031,1886,12.2,0.0,9.5e-06,0.011,13,71,41,103,34,114,0.75,58,62,80
OceanDNA-b46200,96,14.2,0.0,1.1e-06,0.0016,69,153,145,230,106,251,0.75,84,85,145
OceanDNA-b23148,295,18.4,0.0,1.2e-07,0.00016,51,194,376,539,368,546,0.75,143,163,178
OceanDNA-b23331,1418,18.9,0.1,4.1e-08,7.7e-05,62,209,95,245,53,258,0.75,147,150,205
OceanDNA-b12554,71,43.9,0.1,9.9e-16,3.6e-13,40,200,62,238,36,257,0.75,160,176,221
OceanDNA-b5399,377,48.2,0.1,4.6e-17,2.4e-14,111,209,137,238,37,247,0.75,98,101,210
OceanDNA-b3545,477,35.7,0.0,3e-13,2.1e-10,42,205,49,228,30,238,0.75,163,179,208
OceanDNA-b32942,754,5.3,0.1,0.00059,0.66,131,182,170,222,137,244,0.75,51,52,107
OceanDNA-b17054,10,15.3,0.0,5.2e-07,0.00015,112,171,223,283,181,290,0.75,59,60,109
OceanDNA-b34760,599,6.2,0.0,0.00031,0.19,111,145,174,209,163,223,0.75,34,35,60
OceanDNA-b15420,152,-0.4,0.0,0.033,12.0,173,221,128,176,110,183,0.75,48,48,73
OceanDNA-b22797,381,19.6,0.2,5e-08,3.2e-05,27,163,215,361,196,365,0.75,136,146,169
OceanDNA-b3920,1177,13.8,0.0,4.5e-06,0.0029,64,156,129,230,93,276,0.75,92,101,183
OceanDNA-b13654,77,9.8,0.0,2.4e-05,0.014,153,211,194,248,179,260,0.75,58,54,81
OceanDNA-b15128,974,14.3,0.1,1.1e-06,0.0013,39,144,17,126,2,138,0.75,105,109,136
OceanDNA-b14626,616,11.8,0.3,6.1e-06,0.0055,33,140,5,109,1,126,0.75,107,104,125
OceanDNA-b22893,1361,16.5,0.0,6.8e-07,0.00053,50,176,505,641,494,669,0.75,126,136,175
OceanDNA-b24083,575,11.7,0.0,6.8e-06,0.0046,115,162,120,168,45,174,0.75,47,48,129
OceanDNA-b24003,416,11.9,0.0,1.1e-05,0.0083,70,145,112,184,94,192,0.75,75,72,98
OceanDNA-b35826,534,14.0,0.0,1.3e-06,0.0016,118,180,124,186,100,236,0.75,62,62,136
OceanDNA-b26923,1761,14.2,0.1,1.2e-06,0.0041,37,173,51,197,31,200,0.75,136,146,169
OceanDNA-b5198,106,10.5,0.0,1.5e-05,0.0054,122,147,80,105,19,124,0.75,25,25,105
OceanDNA-b15136,655,-0.6,0.0,0.036,24.0,106,154,523,572,519,583,0.75,48,49,64
OceanDNA-b3975,475,-3.6,0.0,0.9,250.0,177,196,30,49,27,74,0.75,19,19,47
OceanDNA-b41340,796,49.5,0.0,5.6e-17,2.7e-14,36,234,50,259,29,269,0.75,198,209,240
OceanDNA-b906,322,16.8,0.0,1.8e-07,7.6e-05,40,143,71,179,68,228,0.75,103,108,160
OceanDNA-b3622,626,11.5,0.1,7.3e-06,0.0079,81,150,18,88,6,108,0.75,69,70,102
OceanDNA-b34384,115,1.6,0.0,0.016,6.6,130,196,218,288,186,310,0.75,66,70,124
OceanDNA-b41340,879,1.1,0.0,0.034,16.0,163,191,228,259,219,277,0.75,28,31,58
OceanDNA-b41523,206,16.7,0.0,1.9e-07,0.00021,33,149,20,142,7,155,0.75,116,122,148
OceanDNA-b41688,10,-1.4,0.0,0.066,14.0,166,195,198,226,185,245,0.75,29,28,60
OceanDNA-b37573,1579,22.5,0.0,6.6e-09,9.1e-06,41,210,108,295,105,307,0.75,169,187,202
OceanDNA-b3338,800,1.4,0.0,0.018,32.0,121,148,290,317,285,327,0.75,27,27,42
OceanDNA-b42461,83,8.3,0.0,7.2e-05,0.022,159,232,213,282,207,283,0.75,73,69,76
OceanDNA-b45854,2076,12.3,0.0,8.6e-06,0.0091,103,169,38,104,4,131,0.75,66,66,127
OceanDNA-b9096,342,2.8,0.0,0.0066,1.1,106,154,201,243,182,254,0.75,48,42,72
OceanDNA-b2514,271,1.6,0.0,0.008,5.8,162,208,97,140,80,159,0.75,46,43,79
OceanDNA-b33194,434,2.9,0.0,0.0033,3.4,167,206,274,312,268,323,0.75,39,38,55
OceanDNA-b40228,134,22.6,0.3,3.1e-09,2e-06,49,141,70,167,30,174,0.75,92,97,144
OceanDNA-b1353,3339,11.3,0.0,2.6e-05,0.034,102,155,167,225,156,240,0.75,53,58,84
OceanDNA-b23333,518,11.3,0.0,2.6e-05,0.014,63,146,126,207,113,214,0.75,83,81,101
OceanDNA-b32144,752,13.3,0.1,4.3e-06,0.0059,69,178,53,168,32,216,0.75,109,115,184
OceanDNA-b40631,460,12.0,0.0,1e-05,0.0029,118,163,144,190,126,235,0.75,45,46,109
OceanDNA-b30224,1631,2.8,0.0,0.0034,6.1,142,189,237,290,212,317,0.75,47,53,105
OceanDNA-b27522,1516,9.5,0.0,3.1e-05,0.061,102,146,29,70,4,82,0.75,44,41,78
OceanDNA-a842,222,18.8,0.0,4.4e-08,1.6e-05,66,208,58,210,31,242,0.75,142,152,211
OceanDNA-b34949,338,10.4,0.1,5e-05,0.016,35,87,18,70,3,159,0.75,52,52,156
OceanDNA-b1353,1053,2.0,0.3,0.018,23.0,118,151,150,183,113,209,0.75,33,33,96
OceanDNA-b44,1285,-0.8,0.0,0.087,330.0,114,154,548,588,537,598,0.75,40,40,61
OceanDNA-b32834,486,11.2,0.0,1.8e-05,0.0074,120,154,176,211,153,218,0.75,34,35,65
OceanDNA-b13198,39,12.8,0.0,3.1e-06,0.0016,55,149,36,131,24,147,0.75,94,95,123
OceanDNA-b31581,1882,7.3,0.0,0.00014,0.34,66,134,124,190,101,201,0.75,68,66,100
OceanDNA-b31581,1882,8.0,0.0,8.7e-05,0.2,99,143,316,361,273,370,0.75,44,45,97
OceanDNA-b30134,407,5.3,0.0,0.00061,1.4,158,195,245,282,210,309,0.75,37,37,99
OceanDNA-b27525,1377,19.8,0.4,8.6e-08,5.8e-05,45,143,115,220,96,226,0.75,98,105,130
OceanDNA-b5500,93,-2.3,0.0,0.13,50.0,220,250,293,323,274,326,0.75,30,30,52
OceanDNA-b4487,412,-2.9,0.0,0.36,290.0,29,46,236,253,228,271,0.75,17,17,43
OceanDNA-b46553,591,-0.8,0.0,0.042,62.0,160,192,76,111,64,132,0.75,32,35,68
OceanDNA-b23324,307,16.6,0.0,2e-07,7.8e-05,51,153,43,145,14,161,0.75,102,102,147
OceanDNA-b17430,13,2.0,0.0,0.0061,13.0,150,192,230,271,186,284,0.75,42,41,98
OceanDNA-b22827,3848,12.5,0.0,1.5e-05,0.019,118,144,151,177,134,230,0.75,26,26,96
OceanDNA-b47086,2583,10.3,0.0,5.2e-05,0.073,103,145,249,291,214,304,0.75,42,42,90
OceanDNA-b21437,139,9.2,0.0,3.7e-05,0.0082,56,153,9,104,5,122,0.75,97,95,117
OceanDNA-b30221,1445,11.5,0.1,1.5e-05,0.017,79,147,54,116,19,156,0.75,68,62,137
OceanDNA-b4256,145,-0.8,0.0,0.043,11.0,119,154,149,184,139,194,0.75,35,35,55
OceanDNA-b22076,2870,26.8,0.1,1.6e-10,5.3e-07,40,140,187,296,164,304,0.75,100,109,140
OceanDNA-b19681,171,14.9,0.0,6.8e-07,0.00025,111,188,138,215,103,244,0.75,77,77,141
OceanDNA-a2373,193,10.4,0.0,1.7e-05,0.0064,55,155,106,208,64,213,0.75,100,102,149
OceanDNA-b33195,96,12.1,0.0,5e-06,0.0035,104,150,97,141,23,161,0.75,46,44,138
OceanDNA-b14104,138,-1.0,0.0,0.15,23.0,141,175,217,251,199,257,0.75,34,34,58
OceanDNA-b24312,350,11.9,0.0,5.7e-06,0.013,93,154,104,166,100,176,0.75,61,62,76
OceanDNA-b40250,557,6.8,0.0,0.0004,0.14,145,208,283,351,277,358,0.75,63,68,81
OceanDNA-b3980,64,12.3,0.0,8.9e-06,0.0053,62,150,74,160,50,166,0.75,88,86,116
OceanDNA-b40185,13,4.0,0.0,0.0014,1.3,164,229,266,327,249,337,0.75,65,61,88
OceanDNA-b15167,1945,11.6,0.1,7.1e-06,0.015,49,151,51,149,25,171,0.75,102,98,146
OceanDNA-b46918,47,11.5,0.1,7.4e-06,0.011,95,145,36,87,25,102,0.75,50,51,77
OceanDNA-b4027,604,12.7,0.0,6.3e-06,0.0026,39,154,118,241,103,246,0.75,115,123,143
OceanDNA-b41581,30,1.7,0.0,0.0074,4.4,165,205,238,279,230,293,0.75,40,41,63
OceanDNA-b15450,418,18.3,0.0,1.3e-07,0.00013,45,162,47,172,33,201,0.75,117,125,168
OceanDNA-b24965,1753,10.8,0.0,2.4e-05,0.023,40,138,53,157,38,179,0.75,98,104,141
OceanDNA-b41587,251,15.7,0.0,7.6e-07,0.00025,120,211,220,310,169,326,0.75,91,90,157
OceanDNA-b16227,471,-4.1,0.1,1.3,450.0,105,146,54,95,46,99,0.75,41,41,53
OceanDNA-b32139,904,7.2,0.0,0.0003,0.35,125,150,124,150,111,159,0.75,25,26,48
OceanDNA-b34735,66,0.2,0.0,0.064,14.0,111,154,534,577,492,590,0.75,43,43,98
OceanDNA-b26646,3094,16.5,0.0,4.6e-07,0.00084,137,219,184,263,176,270,0.75,82,79,94
OceanDNA-b32692,259,1.7,0.1,0.0071,17.0,118,143,77,102,43,120,0.75,25,25,77
OceanDNA-b34735,132,12.6,0.0,1.1e-05,0.0023,73,162,572,669,566,676,0.75,89,97,110
OceanDNA-b10082,290,17.8,0.0,9.1e-08,7e-05,44,177,94,237,77,272,0.75,133,143,195
OceanDNA-b23122,375,13.7,0.0,1.6e-06,0.0073,70,175,240,345,228,386,0.75,105,105,158
OceanDNA-b36151,655,19.9,0.0,4.2e-08,4.7e-05,24,145,38,160,27,169,0.75,121,122,142
OceanDNA-b33328,1067,2.0,0.0,0.0061,7.1,160,220,185,246,178,253,0.75,60,61,75
OceanDNA-b29589,161,3.4,0.0,0.0043,7.0,131,208,251,332,239,348,0.75,77,81,109
OceanDNA-b5607,732,11.2,0.0,9.3e-06,0.0071,106,148,70,115,50,128,0.75,42,45,78
OceanDNA-b40265,482,22.8,0.0,5.2e-09,2.5e-06,47,136,157,257,144,264,0.75,89,100,120
OceanDNA-b7018,34,2.5,0.0,0.0043,1.7,115,154,527,566,512,579,0.75,39,39,67
OceanDNA-b6561,331,11.7,0.0,1.3e-05,0.0085,62,178,118,243,86,292,0.75,116,125,206
OceanDNA-b23143,876,-1.6,0.0,0.15,210.0,208,244,347,383,341,389,0.75,36,36,48
OceanDNA-b30225,1397,11.6,0.0,1.4e-05,0.019,160,219,214,270,194,275,0.75,59,56,81
OceanDNA-b22917,474,22.0,0.0,1.4e-08,1.3e-05,60,149,91,174,78,192,0.75,89,83,114
OceanDNA-b2854,2002,-2.5,0.1,0.42,490.0,162,187,243,268,236,281,0.75,25,25,45
OceanDNA-b36456,1321,8.0,0.0,8.6e-05,0.19,151,187,266,302,232,313,0.75,36,36,81
OceanDNA-b13585,163,3.1,0.0,0.011,4.2,49,96,70,120,59,131,0.75,47,50,72
OceanDNA-b23458,1638,12.0,0.1,5.2e-06,0.015,93,149,239,289,180,334,0.75,56,50,154
OceanDNA-b21790,8,-3.5,0.0,0.29,77.0,88,113,369,393,365,401,0.75,25,24,36
OceanDNA-b22423,1643,13.9,0.0,2.8e-06,0.0033,77,150,164,235,155,252,0.75,73,71,97
OceanDNA-b7545,656,10.8,0.0,1.2e-05,0.013,74,135,84,145,67,156,0.75,61,61,89
OceanDNA-b3990,715,16.5,0.0,2.2e-07,0.0002,43,177,104,248,83,300,0.75,134,144,217
OceanDNA-b33317,1303,9.1,0.0,3.9e-05,0.11,118,145,118,145,80,157,0.75,27,27,77
OceanDNA-b33100,1191,18.2,0.0,6.9e-08,0.00016,27,167,44,191,35,198,0.75,140,147,163
OceanDNA-b1657,494,16.9,0.0,3.3e-07,0.00014,69,161,73,161,20,195,0.75,92,88,175
OceanDNA-b510,1351,16.6,0.0,2.1e-07,0.00045,104,147,100,143,16,161,0.75,43,43,145
OceanDNA-b43987,160,6.1,0.0,0.00067,0.074,93,141,37,87,30,99,0.75,48,50,69
OceanDNA-b16165,665,11.6,0.0,7e-06,0.0061,72,166,194,289,164,297,0.75,94,95,133
OceanDNA-b33070,487,20.8,0.0,1.1e-08,1e-05,44,161,30,153,15,161,0.75,117,123,146
OceanDNA-b23947,1061,11.5,0.0,7.3e-06,0.018,124,198,386,461,363,481,0.75,74,75,118
OceanDNA-b488,1656,9.5,0.4,3.1e-05,0.081,117,167,122,174,69,190,0.75,50,52,121
OceanDNA-b15896,152,18.5,0.0,5.5e-08,1.5e-05,40,150,25,141,15,148,0.75,110,116,133
OceanDNA-b22260,1342,21.2,0.0,8e-09,1.5e-05,101,180,203,281,186,297,0.75,79,78,111
OceanDNA-b22477,939,14.1,0.1,1.2e-06,0.0021,39,145,20,127,4,142,0.75,106,107,138
OceanDNA-b32791,286,2.9,0.1,0.0031,0.95,172,230,243,299,233,300,0.75,58,56,67
OceanDNA-b47083,923,13.7,0.0,1.6e-06,0.0026,116,182,208,276,181,306,0.75,66,68,125
OceanDNA-b16198,1641,4.6,0.0,0.00093,1.6,158,213,130,184,105,198,0.75,55,54,93
OceanDNA-b5580,87,22.1,0.0,8.5e-09,2e-06,118,208,148,242,125,262,0.75,90,94,137
OceanDNA-b35823,1092,15.0,0.0,1.3e-06,0.0029,32,154,13,141,4,151,0.75,122,128,147
OceanDNA-b40593,473,6.2,0.0,0.00031,0.16,144,208,124,193,111,199,0.75,64,69,88
OceanDNA-b34918,448,37.0,0.3,2.4e-13,1.3e-10,25,139,141,272,130,281,0.75,114,131,151
OceanDNA-b31513,460,14.6,0.0,8.3e-07,0.00046,86,177,155,239,96,258,0.75,91,84,162
OceanDNA-b36139,1255,10.7,0.0,1.3e-05,0.026,115,148,348,381,329,388,0.75,33,33,59
OceanDNA-b26842,552,1.0,0.0,0.012,27.0,215,249,417,453,385,460,0.75,34,36,75
OceanDNA-b1232,562,18.1,0.1,7.1e-08,0.00014,47,134,179,275,166,280,0.75,87,96,114
OceanDNA-b34892,191,38.1,0.2,5.9e-14,5.4e-11,47,139,164,272,134,282,0.75,92,108,148
OceanDNA-b46942,588,-3.4,0.0,0.26,190.0,36,59,61,84,54,96,0.75,23,23,42
OceanDNA-b466,1643,19.7,0.0,6.9e-08,6.7e-05,87,207,226,359,168,365,0.75,120,133,197
OceanDNA-b29,4639,18.1,0.3,2.9e-07,0.00037,33,140,39,142,23,160,0.75,107,103,137
OceanDNA-b22722,737,10.7,0.0,1.4e-05,0.015,118,151,147,181,125,194,0.75,33,34,69
OceanDNA-b10475,234,-2.8,0.0,0.17,81.0,122,141,159,178,148,188,0.75,19,19,40
OceanDNA-b40948,1787,11.3,0.0,8.9e-06,0.027,74,141,398,462,389,493,0.75,67,64,104
OceanDNA-b3983,284,11.4,0.1,8e-06,0.0083,65,114,13,62,2,68,0.75,49,49,66
OceanDNA-b3653,1280,6.0,0.0,0.001,0.79,115,150,114,147,4,167,0.75,35,33,163
OceanDNA-b13256,1664,-3.4,0.0,1.9,540.0,193,248,94,149,90,156,0.75,55,55,66
OceanDNA-b41014,1220,9.6,0.1,5.8e-05,0.063,121,158,91,132,77,139,0.75,37,41,62
OceanDNA-b38518,147,10.2,0.0,3.7e-05,0.017,40,153,60,177,35,193,0.75,113,117,158
OceanDNA-b16123,88,13.2,0.0,4.5e-06,0.0016,119,146,143,170,133,246,0.75,27,27,113
OceanDNA-b18463,143,13.1,0.0,2.4e-06,0.00075,107,152,117,156,14,176,0.75,45,39,162
OceanDNA-b20992,1880,12.2,0.0,4.5e-06,0.009,108,140,170,202,89,221,0.75,32,32,132
OceanDNA-b22394,92,8.5,0.0,0.00013,0.12,116,170,446,502,421,519,0.75,54,56,98
OceanDNA-b3315,305,17.4,0.1,2.4e-07,0.00042,40,151,438,561,420,570,0.75,111,123,150
OceanDNA-b20629,17,1.3,0.0,0.01,1.9,56,86,139,169,128,176,0.75,30,30,48
OceanDNA-b26901,3435,4.6,0.0,0.0019,3.6,163,234,222,291,211,298,0.75,71,69,87
OceanDNA-b12642,408,-0.7,0.0,0.039,23.0,159,178,200,220,187,232,0.75,19,20,45
OceanDNA-b328,1573,0.6,0.0,0.016,35.0,109,148,40,78,26,85,0.75,39,38,59
OceanDNA-b44744,465,1.5,0.0,0.0085,6.9,155,183,199,227,183,258,0.74,28,28,75
OceanDNA-b22613,197,6.1,0.2,0.00034,1.2,115,151,819,855,801,876,0.74,36,36,75
OceanDNA-b40439,1721,15.5,0.1,9.1e-07,0.00091,53,162,79,184,48,211,0.74,109,105,163
OceanDNA-b280,1608,20.7,0.0,1.2e-08,3.7e-05,60,183,59,192,19,228,0.74,123,133,209
OceanDNA-b45289,1404,12.1,0.0,1.5e-05,0.013,58,145,163,253,155,275,0.74,87,90,120
OceanDNA-b35208,909,8.3,0.0,7.1e-05,0.068,93,142,108,153,89,166,0.74,49,45,77
OceanDNA-b41688,10,17.9,0.0,8.4e-08,1.8e-05,70,170,60,159,26,163,0.74,100,99,137
OceanDNA-b16117,541,-0.4,0.0,0.064,24.0,161,190,218,246,206,269,0.74,29,28,63
OceanDNA-b3704,1601,0.5,0.0,0.017,48.0,41,95,39,97,8,111,0.74,54,58,103
OceanDNA-b20172,301,11.9,0.0,5.6e-06,0.0022,85,156,219,293,167,296,0.74,71,74,129
OceanDNA-b46695,285,12.4,0.0,2e-05,0.0086,49,135,73,160,62,171,0.74,86,87,109
OceanDNA-b37058,112,-2.7,0.0,0.16,100.0,57,85,192,220,188,222,0.74,28,28,34
OceanDNA-b11950,656,11.3,0.0,8.7e-06,0.012,114,171,199,259,171,330,0.74,57,60,159
OceanDNA-b1353,1053,10.4,0.1,4.9e-05,0.063,35,76,268,311,240,315,0.74,41,43,75
OceanDNA-b39,3911,2.0,0.0,0.012,41.0,167,231,262,325,253,332,0.74,64,63,79
OceanDNA-b20172,301,-1.5,0.0,0.068,27.0,55,85,156,186,147,199,0.74,30,30,52
OceanDNA-b32900,696,1.9,0.0,0.0063,10.0,154,193,194,232,138,252,0.74,39,38,114
OceanDNA-b23271,1794,16.2,0.0,5.7e-07,0.00072,49,177,119,257,79,308,0.74,128,138,229
OceanDNA-b1347,1187,-0.5,0.0,0.069,50.0,203,243,340,382,329,386,0.74,40,42,57
OceanDNA-b32900,696,8.9,0.1,4.5e-05,0.075,119,152,87,120,40,127,0.74,33,33,87
OceanDNA-b20820,150,0.8,0.0,0.013,7.6,59,86,147,174,132,215,0.74,27,27,83
OceanDNA-b12351,370,35.8,0.1,2.9e-13,1.2e-10,112,198,132,221,46,238,0.74,86,89,192
OceanDNA-b13635,603,19.6,0.0,2.5e-08,3e-05,101,183,127,210,114,263,0.74,82,83,149
OceanDNA-b3676,275,4.7,0.0,0.00092,2.8,172,230,226,282,208,288,0.74,58,56,80
OceanDNA-b34217,652,1.4,0.0,0.0091,12.0,145,195,148,198,140,228,0.74,50,50,88
OceanDNA-b6704,774,10.9,0.0,2.4e-05,0.01,113,150,144,181,128,188,0.74,37,37,60
OceanDNA-b10298,542,10.9,0.0,2.3e-05,0.0067,50,152,150,255,140,266,0.74,102,105,126
OceanDNA-b45832,975,18.9,0.0,4.1e-08,4.9e-05,22,140,82,208,72,224,0.74,118,126,152
OceanDNA-b40889,92,20.6,0.0,2.6e-08,8.3e-06,49,136,125,223,117,229,0.74,87,98,112
OceanDNA-b20975,3216,14.6,0.0,8.5e-07,0.0048,35,136,94,205,89,219,0.74,101,111,130
OceanDNA-b22654,1156,15.4,0.0,2.4e-06,0.00058,113,208,522,621,494,638,0.74,95,99,144
OceanDNA-b34939,348,0.7,0.0,0.014,12.0,108,154,539,586,527,596,0.74,46,47,69
OceanDNA-b23400,399,1.4,0.0,0.009,19.0,83,156,29,99,14,120,0.74,73,70,106
OceanDNA-b34924,232,27.1,0.0,2.7e-10,1.4e-07,48,140,135,239,123,250,0.74,92,104,127
OceanDNA-b22391,1470,10.6,0.0,4.3e-05,0.026,114,177,192,258,164,270,0.74,63,66,106
OceanDNA-b6503,577,14.1,0.0,2.4e-06,0.00079,99,153,103,156,25,167,0.74,54,53,142
OceanDNA-b6575,684,21.2,0.0,8.4e-09,8.5e-06,35,156,20,149,7,156,0.74,121,129,149
OceanDNA-b23515,947,7.9,0.0,0.00019,0.11,87,151,57,119,48,127,0.74,64,62,79
OceanDNA-b41176,1182,29.8,0.1,1.9e-11,4.3e-08,57,235,108,286,66,298,0.74,178,178,232
OceanDNA-b18639,90,50.2,0.5,2.4e-17,4.9e-15,35,247,100,340,79,352,0.74,212,240,273
OceanDNA-b26501,866,12.8,0.0,2.9e-06,0.0045,44,152,89,201,75,209,0.74,108,112,134
OceanDNA-b19692,224,14.3,0.0,1e-06,0.00034,52,140,62,155,48,166,0.74,88,93,118
OceanDNA-b34276,907,20.3,0.1,1.5e-08,1.7e-05,38,156,207,332,181,339,0.74,118,125,158
OceanDNA-b38590,329,15.1,0.0,6.1e-07,0.00042,34,179,21,169,7,183,0.74,145,148,176
OceanDNA-b39492,519,15.1,0.0,5.9e-07,0.00047,118,145,141,168,111,219,0.74,27,27,108
OceanDNA-b13203,166,4.5,0.0,0.001,1.1,175,230,206,259,187,269,0.74,55,53,82
OceanDNA-b36670,896,-2.5,0.0,0.14,190.0,163,181,241,259,238,282,0.74,18,18,44
OceanDNA-b47087,1306,15.6,0.0,8.3e-07,0.0011,110,156,232,279,217,315,0.74,46,47,98
OceanDNA-b1353,1714,11.0,0.1,3.1e-05,0.041,59,142,110,192,85,207,0.74,83,82,122
OceanDNA-b3425,433,15.1,0.1,1.2e-06,0.00046,115,159,193,240,179,262,0.74,44,47,83
OceanDNA-b45442,215,1.3,0.0,0.029,15.0,162,227,184,247,177,251,0.74,65,63,74
OceanDNA-b40207,335,24.4,0.4,9e-10,4.3e-07,13,141,31,166,24,199,0.74,128,135,175
OceanDNA-b40631,559,0.5,0.0,0.035,9.9,158,191,292,325,267,346,0.74,33,33,79
OceanDNA-b23976,324,11.1,0.1,2e-05,0.018,49,144,87,189,69,201,0.74,95,102,132
OceanDNA-b41214,2347,8.1,0.0,7.9e-05,0.3,151,183,191,222,179,234,0.74,32,31,55
OceanDNA-b23491,381,12.6,0.1,7.2e-06,0.0065,23,152,45,175,31,184,0.74,129,130,153
OceanDNA-b11187,15,12.4,0.0,7.9e-06,0.0019,101,145,29,70,16,91,0.74,44,41,75
OceanDNA-b24633,138,12.6,0.0,3.4e-06,0.0017,73,156,113,197,76,244,0.74,83,84,168
OceanDNA-b22765,1312,17.0,0.0,3.2e-07,0.00026,105,184,163,238,149,253,0.74,79,75,104
OceanDNA-b24128,1437,13.9,0.1,1.4e-06,0.0031,122,150,88,116,50,123,0.74,28,28,73
OceanDNA-b11343,100,16.3,0.0,2.6e-07,0.00012,102,156,156,210,137,245,0.74,54,54,108
OceanDNA-b31948,360,12.9,0.0,5.7e-06,0.0065,92,147,987,1045,984,1058,0.74,55,58,74
OceanDNA-b13138,651,11.3,0.0,8.5e-06,0.0056,75,167,18,109,7,119,0.74,92,91,112
OceanDNA-b33521,1386,11.7,0.0,1.3e-05,0.018,108,165,256,312,241,321,0.74,57,56,80
OceanDNA-b6771,301,12.5,0.0,1.1e-05,0.0035,94,145,135,186,57,195,0.74,51,51,138
OceanDNA-b1353,1053,-1.5,0.0,0.21,280.0,103,146,37,80,25,121,0.74,43,43,96
OceanDNA-b3934,51,15.2,0.0,1.1e-06,0.00039,48,154,151,260,139,267,0.74,106,109,128
OceanDNA-b22377,438,16.7,0.0,3.8e-07,0.00043,40,149,39,148,5,163,0.74,109,109,158
OceanDNA-b13561,806,10.1,0.0,2e-05,0.016,54,146,61,151,48,163,0.74,92,90,115
OceanDNA-b213,570,13.8,0.0,1.5e-06,0.0011,58,152,221,316,213,327,0.74,94,95,114
OceanDNA-b5403,585,10.8,0.0,1.2e-05,0.012,48,136,153,242,129,270,0.74,88,89,141
OceanDNA-b35159,950,-3.2,0.0,0.46,390.0,48,82,69,106,62,119,0.74,34,37,57
OceanDNA-b22607,683,17.2,0.0,2.7e-07,0.00012,117,157,152,193,134,247,0.74,40,41,113
OceanDNA-b36,1773,18.0,0.0,7.8e-08,0.00014,65,141,224,308,185,322,0.74,76,84,137
OceanDNA-b34663,655,12.2,0.0,1.3e-05,0.0036,98,147,57,103,37,115,0.74,49,46,78
OceanDNA-b7194,460,10.2,0.1,5.5e-05,0.015,65,150,74,158,22,169,0.74,85,84,147
OceanDNA-b20972,1685,10.3,0.0,3.4e-05,0.048,70,145,88,157,76,168,0.74,75,69,92
OceanDNA-b41267,1339,16.8,0.0,1.8e-07,0.00056,75,171,110,203,93,229,0.74,96,93,136
OceanDNA-b24081,88,-0.9,0.0,0.046,19.0,158,184,302,328,283,362,0.74,26,26,79
OceanDNA-b30013,171,14.7,0.0,8.1e-07,0.0019,56,155,135,243,101,320,0.74,99,108,219
OceanDNA-b17084,288,-0.1,0.0,0.026,28.0,120,143,144,167,111,179,0.74,23,23,68
OceanDNA-b37532,1746,28.1,0.0,6.4e-11,1.7e-07,40,191,91,263,87,278,0.74,151,172,191
OceanDNA-b45813,470,15.5,0.0,4.5e-07,0.00051,89,155,177,244,163,255,0.74,66,67,92
OceanDNA-b40527,138,7.4,0.0,0.00027,0.11,88,151,104,163,50,175,0.74,63,59,125
OceanDNA-b36934,678,27.6,0.1,9.1e-11,9.1e-08,47,138,188,290,160,306,0.74,91,102,146
OceanDNA-b9654,484,2.0,0.0,0.006,3.4,125,145,103,123,84,195,0.74,20,20,111
OceanDNA-b4143,174,26.1,0.0,8.2e-10,4.4e-07,49,160,137,250,129,259,0.74,111,113,130
OceanDNA-b30217,1058,21.4,0.4,7.1e-09,1.7e-05,46,141,129,235,119,249,0.74,95,106,130
OceanDNA-b24117,1926,16.3,0.1,5.3e-07,0.00069,39,155,19,142,3,151,0.74,116,123,148
OceanDNA-b33558,772,10.3,0.0,3.5e-05,0.016,116,155,74,113,49,131,0.74,39,39,82
OceanDNA-b20044,310,36.5,0.1,1.8e-13,6.8e-11,37,246,105,341,82,351,0.74,209,236,269
OceanDNA-b33570,565,18.2,0.0,6.9e-08,8.9e-05,43,152,39,154,11,163,0.74,109,115,152
OceanDNA-b10297,536,0.2,0.0,0.021,12.0,113,156,523,569,512,579,0.74,43,46,67
OceanDNA-b20510,60,6.0,0.0,0.00037,0.12,42,86,113,159,85,174,0.74,44,46,89
OceanDNA-b4608,125,14.2,0.0,2.2e-06,0.00059,94,155,131,186,59,261,0.74,61,55,202
OceanDNA-b23301,2305,12.8,0.1,3e-06,0.0087,133,197,22,86,8,105,0.74,64,64,97
OceanDNA-b35148,1840,-1.5,0.0,0.07,150.0,126,155,214,243,206,247,0.74,29,29,41
OceanDNA-b38572,538,16.5,0.0,2.3e-07,0.00013,42,151,27,140,18,152,0.74,109,113,134
OceanDNA-b38880,297,25.5,0.0,8.3e-10,3.9e-07,47,141,118,224,112,235,0.74,94,106,123
OceanDNA-b24965,1095,-2.2,0.0,0.23,230.0,143,180,214,251,209,264,0.74,37,37,55
OceanDNA-b26837,1569,9.5,0.1,3.1e-05,0.095,95,135,89,131,41,149,0.74,40,42,108
OceanDNA-b45845,955,15.8,0.1,3.7e-07,0.00042,26,140,76,198,67,214,0.74,114,122,147
OceanDNA-b41011,471,8.5,0.0,6.3e-05,0.16,56,162,60,165,51,170,0.74,106,105,119
OceanDNA-b17165,251,12.4,0.0,4.1e-06,0.0015,43,152,23,144,20,164,0.74,109,121,144
OceanDNA-b24146,108,10.2,0.0,1.8e-05,0.04,148,209,251,309,225,321,0.74,61,58,96
OceanDNA-b23417,1401,-2.4,0.0,0.27,390.0,136,166,407,438,404,462,0.74,30,31,58
OceanDNA-b28158,2580,10.8,0.3,1.3e-05,0.034,31,134,77,175,49,195,0.74,103,98,146
OceanDNA-b16182,508,18.2,0.0,6.9e-08,4.4e-05,95,182,233,325,210,342,0.74,87,92,132
OceanDNA-b20595,175,13.0,0.0,2.7e-06,0.00074,183,241,269,328,246,342,0.74,58,59,96
OceanDNA-b23396,1632,10.7,0.0,2.7e-05,0.028,60,148,89,175,72,180,0.74,88,86,108
OceanDNA-b20955,963,-3.3,0.0,0.24,1700.0,75,136,796,855,772,858,0.74,61,59,86
OceanDNA-b265,82,26.6,0.0,3.7e-10,3.3e-07,114,154,166,208,146,285,0.74,40,42,139
OceanDNA-b40250,557,26.7,0.0,3.4e-10,1.2e-07,49,137,144,243,133,249,0.74,88,99,116
OceanDNA-b36890,852,9.3,0.1,3.4e-05,0.053,54,148,70,164,62,177,0.74,94,94,115
OceanDNA-b15882,117,10.5,0.0,1.5e-05,0.0053,28,143,61,174,52,192,0.74,115,113,140
OceanDNA-b6425,553,13.9,0.0,1.4e-06,0.0012,72,161,92,184,30,189,0.74,89,92,159
OceanDNA-b37351,1051,0.0,0.0,0.024,30.0,117,154,540,577,524,590,0.74,37,37,66
OceanDNA-b47081,449,11.0,0.0,2.2e-05,0.0063,113,154,191,233,134,250,0.74,41,42,116
OceanDNA-b16213,512,19.9,0.0,4.2e-08,1.8e-05,49,147,273,391,256,407,0.74,98,118,151
OceanDNA-b36120,794,12.0,0.0,5.4e-06,0.012,62,149,130,215,101,223,0.74,87,85,122
OceanDNA-b44662,1421,4.1,0.1,0.0027,3.6,21,65,523,570,512,580,0.74,44,47,68
OceanDNA-b26051,249,15.4,0.0,5e-07,0.00018,119,146,19,46,7,76,0.74,27,27,69
OceanDNA-b16139,377,2.6,0.0,0.0079,3.2,161,188,431,459,424,493,0.74,27,28,69
OceanDNA-b38974,977,14.4,0.2,9.7e-07,0.0015,52,152,67,178,17,217,0.74,100,111,200
OceanDNA-b1657,50,11.9,0.0,1.1e-05,0.0046,94,157,93,151,49,181,0.74,63,58,132
OceanDNA-b10371,327,-2.9,0.0,0.19,69.0,122,154,225,257,222,267,0.74,32,32,45
OceanDNA-b1696,215,10.8,0.0,2.5e-05,0.0092,112,150,134,171,87,181,0.74,38,37,94
OceanDNA-b314,121,-0.8,0.0,0.042,35.0,161,184,329,353,311,368,0.74,23,24,57
OceanDNA-b34729,429,14.4,0.1,9.8e-07,0.00086,148,211,220,287,180,308,0.74,63,67,128
OceanDNA-b37447,293,7.4,0.1,0.00014,0.098,115,210,129,221,118,256,0.74,95,92,138
OceanDNA-b1738,534,-0.1,0.0,0.025,91.0,163,209,219,263,185,271,0.74,46,44,86
OceanDNA-b31149,177,10.8,0.0,1.2e-05,0.0073,40,148,141,252,127,266,0.74,108,111,139
OceanDNA-b35291,674,19.0,0.0,3.8e-08,6e-05,102,210,122,234,105,249,0.74,108,112,144
OceanDNA-b13250,1533,28.9,0.5,3.7e-10,1.5e-07,36,197,80,242,76,292,0.74,161,162,216
OceanDNA-b23165,145,20.1,0.0,1.8e-08,5.4e-05,110,182,212,280,197,316,0.74,72,68,119
OceanDNA-b19574,99,17.5,0.0,1.1e-07,4.3e-05,110,171,331,396,301,400,0.74,61,65,99
OceanDNA-b22798,1185,7.0,0.1,0.00017,0.72,42,108,80,148,76,305,0.74,66,68,229
OceanDNA-b3034,104,12.4,0.0,3.9e-06,0.00097,55,169,24,137,16,166,0.74,114,113,150
OceanDNA-b16514,942,14.9,0.1,7e-07,0.00071,52,142,205,308,171,335,0.74,90,103,164
OceanDNA-b3867,56,3.1,0.0,0.0027,4.3,117,142,88,113,17,136,0.74,25,25,119
OceanDNA-b34892,191,2.6,0.0,0.0038,3.5,146,190,315,362,306,399,0.74,44,47,93
OceanDNA-b38359,101,13.0,0.0,2.5e-06,0.003,105,216,119,239,86,258,0.74,111,120,172
OceanDNA-b45818,1062,17.3,0.1,6.2e-07,0.00018,24,136,63,183,54,206,0.74,112,120,152
OceanDNA-b21000,2867,22.9,0.0,2.6e-09,7.6e-06,62,137,178,265,170,278,0.74,75,87,108
OceanDNA-b3655,309,10.9,0.0,1.1e-05,0.0085,65,141,112,197,98,216,0.74,76,85,118
OceanDNA-b13088,1543,10.6,0.3,2.9e-05,0.053,66,150,57,140,22,173,0.74,84,83,151
OceanDNA-b20944,992,-2.4,0.0,0.13,230.0,210,240,164,194,153,213,0.74,30,30,60
OceanDNA-b4058,518,13.8,0.0,2.9e-06,0.001,67,147,303,394,269,406,0.74,80,91,137
OceanDNA-b3906,1521,17.3,0.0,1.3e-07,0.00023,39,157,186,311,165,317,0.74,118,125,152
OceanDNA-b33104,282,13.3,0.0,4.2e-06,0.0069,43,143,28,140,15,152,0.74,100,112,137
OceanDNA-b109,1050,-3.6,0.0,0.31,830.0,164,221,474,531,469,539,0.74,57,57,70
OceanDNA-b11418,498,6.8,0.0,0.0002,0.11,165,232,193,258,186,266,0.74,67,65,80
OceanDNA-b14149,56,10.4,0.0,1.6e-05,0.0076,117,183,126,195,112,199,0.74,66,69,87
OceanDNA-b1776,2429,23.1,0.1,2.2e-09,8.3e-06,46,151,164,277,148,315,0.74,105,113,167
OceanDNA-b6212,99,14.1,0.0,1.2e-06,0.00095,35,156,17,146,3,153,0.74,121,129,150
OceanDNA-b20343,316,10.0,0.0,2.1e-05,0.0079,115,136,153,174,126,178,0.74,21,21,52
OceanDNA-b33388,547,-0.6,0.0,0.18,140.0,197,225,220,249,209,254,0.74,28,29,45
OceanDNA-b46199,236,22.1,0.0,4.5e-09,6.7e-06,116,149,161,194,134,205,0.74,33,33,71
OceanDNA-b14516,393,4.9,0.0,0.00079,0.45,143,201,191,246,165,266,0.74,58,55,101
OceanDNA-b6168,140,8.9,0.0,4.5e-05,0.026,195,235,217,258,175,275,0.74,40,41,100
OceanDNA-b46894,172,10.8,0.0,2.4e-05,0.015,118,177,129,190,117,203,0.74,59,61,86
OceanDNA-b30627,591,25.6,0.1,3.8e-10,3.6e-07,49,143,147,251,132,270,0.74,94,104,138
OceanDNA-b22292,899,39.0,3.8,3.1e-14,5.9e-11,28,192,58,239,40,261,0.74,164,181,221
OceanDNA-b22637,1373,12.4,0.0,4e-06,0.012,116,146,113,145,102,163,0.74,30,32,61
OceanDNA-b9659,37,26.0,0.0,2.8e-10,1.5e-07,48,139,140,243,125,253,0.74,91,103,128
OceanDNA-b20343,316,-2.6,0.0,0.15,56.0,150,190,7,47,4,60,0.74,40,40,56
OceanDNA-b16784,1504,15.1,0.0,6.1e-07,0.001,56,145,72,163,39,170,0.74,89,91,131
OceanDNA-b3454,606,14.3,0.0,1.1e-06,0.00077,116,186,111,183,90,191,0.74,70,72,101
OceanDNA-b13590,1844,2.2,0.0,0.015,15.0,121,152,443,474,391,508,0.73,31,31,117
OceanDNA-b23139,2350,15.4,0.1,9.9e-07,0.0012,100,142,151,187,67,219,0.73,42,36,152
OceanDNA-b23825,1195,9.9,0.2,2.4e-05,0.037,15,86,46,116,41,206,0.73,71,70,165
OceanDNA-b13263,346,20.3,0.0,4.7e-08,1.5e-05,59,210,141,295,116,306,0.73,151,154,190
OceanDNA-b36401,961,13.5,0.0,3.6e-06,0.002,31,154,46,179,27,209,0.73,123,133,182
OceanDNA-b45647,130,9.1,0.0,4e-05,0.025,118,155,93,130,11,139,0.73,37,37,128
OceanDNA-b44390,296,14.0,0.0,2.7e-06,0.00092,40,161,26,154,7,158,0.73,121,128,151
OceanDNA-b31521,1422,3.6,0.1,0.004,4.1,162,227,190,254,181,257,0.73,65,64,76
OceanDNA-b31510,83,1.4,0.0,0.027,10.0,117,162,530,572,509,583,0.73,45,42,74
OceanDNA-b4004,826,12.7,0.0,9.6e-06,0.0036,41,137,68,171,42,195,0.73,96,103,153
OceanDNA-b36709,945,17.1,0.0,1.5e-07,0.00025,35,149,54,168,39,174,0.73,114,114,135
OceanDNA-b31510,971,8.6,0.0,0.00017,0.064,159,227,568,637,562,647,0.73,68,69,85
OceanDNA-b33510,1649,11.0,0.3,1.1e-05,0.028,87,146,24,84,4,93,0.73,59,60,89
OceanDNA-b32147,483,11.6,0.0,6.9e-06,0.019,91,150,151,203,127,213,0.73,59,52,86
OceanDNA-b30427,1176,11.4,0.0,1.6e-05,0.017,140,196,234,292,217,311,0.73,56,58,94
OceanDNA-b13261,8,9.6,0.0,5.7e-05,0.034,42,87,11,59,6,137,0.73,45,48,131
OceanDNA-b24051,228,21.6,0.0,6.4e-09,3.5e-06,44,161,21,144,10,225,0.73,117,123,215
OceanDNA-b34735,132,-0.3,0.0,0.087,19.0,18,49,491,522,476,542,0.73,31,31,66
OceanDNA-b27445,13,-0.6,0.0,0.038,8.4,163,212,300,346,289,362,0.73,49,46,73
OceanDNA-b36670,896,11.9,0.3,5.8e-06,0.0079,97,148,132,177,20,190,0.73,51,45,170
OceanDNA-b46405,630,10.8,0.0,2.5e-05,0.024,75,155,184,270,178,288,0.73,80,86,110
OceanDNA-b17424,328,25.0,0.0,5.7e-10,1e-06,72,208,117,261,108,275,0.73,136,144,167
OceanDNA-b32609,844,14.7,0.1,7.9e-07,0.00088,24,158,24,167,7,237,0.73,134,143,230
OceanDNA-b10079,394,20.8,0.0,1.1e-08,9.9e-06,112,155,175,219,162,254,0.73,43,44,92
OceanDNA-b10294,774,9.9,0.0,4.7e-05,0.02,64,150,53,138,30,157,0.73,86,85,127
OceanDNA-b35127,740,-3.6,0.0,0.31,300.0,119,153,543,577,541,586,0.73,34,34,45
OceanDNA-b9659,37,0.3,0.0,0.02,11.0,145,211,283,354,258,363,0.73,66,71,105
OceanDNA-b41002,133,23.4,0.0,1.8e-09,5e-06,70,233,102,266,75,281,0.73,163,164,206
OceanDNA-b46204,227,13.2,0.0,2.3e-06,0.0026,118,153,137,172,116,220,0.73,35,35,104
OceanDNA-b33397,92,17.8,0.0,8.9e-08,2.6e-05,43,160,29,156,11,215,0.73,117,127,204
OceanDNA-b20676,199,2.9,0.0,0.0064,1.1,184,237,262,318,234,339,0.73,53,56,105
OceanDNA-b7450,617,10.1,0.0,4.1e-05,0.027,57,150,38,132,6,148,0.73,93,94,142
OceanDNA-b22944,383,-2.2,0.0,0.11,460.0,42,82,668,715,662,732,0.73,40,47,70
OceanDNA-b28576,324,6.1,0.0,0.00034,0.17,157,228,218,287,195,298,0.73,71,69,103
OceanDNA-b34889,746,0.8,0.0,0.013,10.0,113,153,81,121,34,130,0.73,40,40,96
OceanDNA-b45818,242,16.4,0.0,1.2e-06,0.00035,24,136,67,187,57,201,0.73,112,120,144
OceanDNA-b22391,1632,23.4,0.0,5.5e-09,3.4e-06,115,176,169,236,150,244,0.73,61,67,94
OceanDNA-b16517,491,13.4,0.1,1.9e-06,0.0017,52,140,203,304,162,314,0.73,88,101,152
OceanDNA-b26893,2504,15.6,0.0,8.4e-07,0.0014,119,154,154,190,138,214,0.73,35,36,76
OceanDNA-b23064,1242,10.9,0.0,2.2e-05,0.016,61,118,204,255,179,272,0.73,57,51,93
OceanDNA-b1991,34,18.2,0.0,6.6e-08,3.9e-05,39,141,51,158,29,169,0.73,102,107,140
OceanDNA-b15333,114,3.4,0.0,0.0022,0.68,158,187,254,283,234,306,0.73,29,29,72
OceanDNA-b19603,348,0.3,0.0,0.02,8.0,156,215,217,274,208,288,0.73,59,57,80
OceanDNA-b24091,193,-1.9,0.0,0.094,93.0,159,180,297,318,273,346,0.73,21,21,73
OceanDNA-b30748,463,12.0,0.0,5.3e-06,0.0052,53,149,160,259,152,280,0.73,96,99,128
OceanDNA-b16117,541,16.8,0.0,3.6e-07,0.00014,61,150,92,181,73,191,0.73,89,89,118
OceanDNA-b23096,1267,-2.8,0.0,0.18,610.0,166,180,306,320,297,323,0.73,14,14,26
OceanDNA-b24083,575,0.1,0.0,0.022,15.0,156,184,198,226,176,263,0.73,28,28,87
OceanDNA-b38157,292,-1.1,0.0,0.11,38.0,105,155,554,604,549,625,0.73,50,50,76
OceanDNA-b19767,37,14.3,0.0,1.1e-06,0.00033,112,156,129,173,96,195,0.73,44,44,99
OceanDNA-b12096,376,10.5,0.0,1.5e-05,0.011,165,232,193,258,180,273,0.73,67,65,93
OceanDNA-b22917,1245,9.1,0.0,0.00013,0.12,85,210,132,278,122,289,0.73,125,146,167
OceanDNA-b23401,359,-2.8,0.0,0.17,370.0,164,208,646,690,632,706,0.73,44,44,74
OceanDNA-b46656,816,23.3,0.0,7.8e-09,6.6e-06,115,209,223,319,196,331,0.73,94,96,135
OceanDNA-b13167,165,15.5,0.0,4.7e-07,0.00018,154,194,113,153,105,179,0.73,40,40,74
OceanDNA-b16139,377,0.2,0.0,0.044,18.0,42,81,251,291,224,294,0.73,39,40,70
OceanDNA-b30970,1170,1.8,0.0,0.02,16.0,114,137,69,94,50,111,0.73,23,25,61
OceanDNA-b41301,4143,18.1,0.0,1.5e-07,0.00036,38,155,32,167,6,236,0.73,117,135,230
OceanDNA-b36658,243,12.0,0.0,1.1e-05,0.0048,103,182,188,263,114,292,0.73,79,75,178
OceanDNA-b22566,1178,17.8,0.0,9e-08,0.00011,118,201,151,239,136,254,0.73,83,88,118
OceanDNA-b14396,89,11.6,0.0,7e-06,0.0073,164,232,257,323,220,352,0.73,68,66,132
OceanDNA-b17301,1187,13.2,0.1,4.5e-06,0.0055,135,208,105,185,97,194,0.73,73,80,97
OceanDNA-b22461,2712,-3.9,0.0,0.73,1700.0,186,208,252,273,226,275,0.73,22,21,49
OceanDNA-b38049,473,0.1,0.0,0.023,19.0,106,150,531,576,494,589,0.73,44,45,95
OceanDNA-b109,1050,13.1,0.4,2.4e-06,0.0064,39,152,238,361,217,368,0.73,113,123,151
OceanDNA-b22872,3058,14.4,0.0,2e-06,0.0031,116,144,62,90,51,108,0.73,28,28,57
OceanDNA-b13295,2627,15.7,0.2,3.9e-07,0.0011,49,137,105,207,76,216,0.73,88,102,140
OceanDNA-b46919,1190,0.4,0.0,0.037,29.0,117,155,581,619,514,624,0.73,38,38,110
OceanDNA-b41044,685,39.4,0.2,4.6e-14,4.2e-11,38,228,72,266,38,284,0.73,190,194,246
OceanDNA-b1749,43,6.7,0.0,0.00022,0.41,65,135,40,106,29,117,0.73,70,66,88
OceanDNA-b6582,313,1.9,0.0,0.0062,3.9,122,142,97,117,87,191,0.73,20,20,104
OceanDNA-b41044,1573,16.0,0.4,6.5e-07,0.0006,46,158,27,145,9,175,0.73,112,118,166
OceanDNA-b32285,973,-3.0,0.0,0.2,200.0,59,95,62,102,50,110,0.73,36,40,60
OceanDNA-b202,1210,21.1,0.0,1.7e-08,2e-05,29,183,19,183,9,230,0.73,154,164,221
OceanDNA-b23952,586,12.1,0.1,4.9e-06,0.013,37,149,24,145,10,162,0.73,112,121,152
OceanDNA-b35385,206,15.5,0.0,4.5e-07,0.00035,104,211,104,219,70,232,0.73,107,115,162
OceanDNA-b42995,28,11.0,0.0,1.1e-05,0.0028,164,250,163,254,154,264,0.73,86,91,110
OceanDNA-b45835,44,16.6,0.1,4.1e-07,0.0002,26,139,57,178,50,196,0.73,113,121,146
OceanDNA-b40943,684,24.5,0.0,1.7e-09,7.9e-07,118,210,155,254,103,271,0.73,92,99,168
OceanDNA-b3982,297,10.5,0.0,2.9e-05,0.0088,125,152,106,133,19,153,0.73,27,27,134
OceanDNA-b21004,811,9.9,0.0,6.8e-05,0.043,113,144,28,60,9,77,0.73,31,32,68
OceanDNA-b33388,547,14.4,0.1,5e-06,0.0038,71,152,53,133,22,152,0.73,81,80,130
OceanDNA-b22324,2292,11.1,0.1,4.9e-05,0.04,118,194,182,265,144,290,0.73,76,83,146
OceanDNA-b29542,1230,1.3,0.0,0.02,22.0,196,231,355,391,324,394,0.73,35,36,70
OceanDNA-b30021,940,9.6,0.2,2.8e-05,0.053,126,161,127,166,47,173,0.73,35,39,126
OceanDNA-b21018,732,-3.1,0.0,0.22,720.0,184,212,34,62,29,68,0.73,28,28,39
OceanDNA-b32822,367,11.5,0.0,7.6e-06,0.0048,104,154,73,122,26,130,0.73,50,49,104
OceanDNA-b13299,796,12.7,0.0,6.3e-06,0.0034,16,149,16,163,7,182,0.73,133,147,175
OceanDNA-b30966,1378,10.2,0.0,1.9e-05,0.052,154,187,185,218,127,248,0.73,33,33,121
OceanDNA-b46651,2931,20.6,0.0,3.7e-08,5e-05,118,214,215,315,194,324,0.73,96,100,130
OceanDNA-b38495,572,0.1,0.0,0.023,19.0,157,209,265,317,243,321,0.73,52,52,78
OceanDNA-b30681,143,16.9,0.0,1.6e-07,0.00011,50,160,31,147,10,153,0.73,110,116,143
OceanDNA-b45,2039,10.6,0.0,1.4e-05,0.052,10,144,132,266,124,272,0.73,134,134,148
OceanDNA-b17273,796,16.8,0.0,3.6e-07,0.00044,118,208,186,279,167,289,0.73,90,93,122
OceanDNA-b37833,583,9.9,0.0,4.6e-05,0.024,125,154,97,127,79,148,0.73,29,30,69
OceanDNA-b7503,295,13.5,0.0,1.8e-06,0.0014,116,181,153,222,133,231,0.73,65,69,98
OceanDNA-b22513,1659,3.2,0.0,0.0052,7.4,112,154,541,583,530,593,0.73,42,42,63
OceanDNA-b20682,69,25.7,0.0,3.6e-10,1e-07,91,209,22,146,18,162,0.73,118,124,144
OceanDNA-b13249,460,15.5,1.1,1.3e-06,0.00041,36,251,130,340,125,346,0.73,215,210,221
OceanDNA-b31526,385,-1.4,0.0,0.19,65.0,119,142,237,260,218,274,0.73,23,23,56
OceanDNA-b45582,707,10.6,0.2,1.4e-05,0.033,39,153,116,233,108,241,0.73,114,117,133
OceanDNA-b21043,1056,26.6,0.0,3.7e-10,3.3e-07,41,159,56,177,17,249,0.73,118,121,232
OceanDNA-b19928,527,18.0,0.0,7.7e-08,4.6e-05,94,156,271,337,264,359,0.73,62,66,95
OceanDNA-b30043,702,14.6,0.1,1.7e-06,0.0017,108,144,91,127,69,141,0.73,36,36,72
OceanDNA-b16125,732,21.2,0.0,8.1e-09,6.2e-06,43,141,229,344,219,355,0.73,98,115,136
OceanDNA-b16133,287,14.6,0.0,2.6e-06,0.00095,137,210,385,458,360,462,0.73,73,73,102
OceanDNA-b23043,3744,16.2,0.0,5.7e-07,0.0011,103,208,146,249,127,261,0.73,105,103,134
OceanDNA-b15511,1392,12.5,0.0,3.7e-06,0.0068,35,137,18,127,10,156,0.73,102,109,146
OceanDNA-b22283,131,11.5,0.0,7.7e-06,0.011,116,149,133,166,108,178,0.73,33,33,70
OceanDNA-b30771,946,18.1,0.0,7.5e-08,0.00017,49,177,101,239,41,267,0.73,128,138,226
OceanDNA-b34860,267,-1.5,0.0,0.072,50.0,105,150,522,567,482,582,0.73,45,45,100
OceanDNA-b41046,1303,23.8,0.0,1.3e-09,1.9e-06,70,226,101,257,46,273,0.73,156,156,227
OceanDNA-b13250,4012,43.2,0.9,1.6e-14,6.5e-12,67,197,183,304,143,335,0.73,130,121,192
OceanDNA-b9390,184,-0.4,0.0,0.032,9.7,115,154,526,565,508,575,0.73,39,39,67
OceanDNA-b30235,805,19.2,0.1,3.3e-08,9.5e-05,49,140,158,260,149,270,0.73,91,102,121
OceanDNA-b36729,927,7.3,0.2,0.00015,0.33,40,117,130,209,97,222,0.73,77,79,125
OceanDNA-b20094,148,20.7,0.0,3.4e-08,4.3e-06,105,190,120,208,114,243,0.73,85,88,129
OceanDNA-b1333,679,14.6,0.1,8.7e-07,0.0014,92,155,89,147,6,164,0.73,63,58,158
OceanDNA-b40639,544,22.7,0.0,5.7e-09,2.1e-06,56,186,83,215,64,238,0.73,130,132,174
OceanDNA-b3975,486,12.1,0.0,1.4e-05,0.004,62,141,573,658,547,682,0.73,79,85,135
OceanDNA-b6424,365,11.7,0.0,2e-05,0.0041,58,151,39,133,13,151,0.73,93,94,138
OceanDNA-b36896,572,12.0,0.1,5.3e-06,0.0069,46,148,83,185,61,200,0.73,102,102,139
OceanDNA-b40245,298,4.9,0.0,0.0023,0.57,171,230,220,277,205,279,0.73,59,57,74
OceanDNA-b15516,151,-0.8,0.0,0.041,34.0,115,143,45,74,34,91,0.73,28,29,57
OceanDNA-b9808,396,10.7,0.0,3.9e-05,0.0075,112,154,145,188,126,224,0.73,42,43,98
OceanDNA-a3708,129,8.3,0.0,7.4e-05,0.024,57,140,227,323,215,336,0.73,83,96,121
OceanDNA-b31994,2391,16.8,0.0,1.8e-07,0.00058,58,135,73,164,58,179,0.73,77,91,121
OceanDNA-b7699,41,13.7,0.0,1.6e-06,0.00051,114,177,134,200,117,215,0.73,63,66,98
OceanDNA-b26613,119,-0.9,0.0,0.045,25.0,144,181,187,222,167,246,0.73,37,35,79
OceanDNA-b1435,542,19.0,0.1,7.6e-08,3.2e-05,102,147,114,158,77,166,0.73,45,44,89
OceanDNA-b6723,230,11.9,0.0,5.5e-06,0.0038,72,176,126,239,87,253,0.73,104,113,166
OceanDNA-b24136,3202,14.6,0.0,1.7e-06,0.0031,40,155,95,217,77,226,0.73,115,122,149
OceanDNA-b23817,324,5.6,0.0,0.00096,0.75,148,178,220,249,169,256,0.73,30,29,87
OceanDNA-b45789,15,11.6,0.0,6.9e-06,0.0038,115,155,92,132,19,141,0.73,40,40,122
OceanDNA-b30346,1949,5.5,0.0,0.00049,1.1,131,196,202,269,194,294,0.73,65,67,100
OceanDNA-b36767,303,18.6,0.0,5.1e-08,4.5e-05,95,158,208,273,199,294,0.73,63,65,95
OceanDNA-b44154,508,16.3,0.1,2.7e-07,0.00014,59,162,40,148,13,159,0.73,103,108,146
OceanDNA-b6750,437,9.8,0.0,7.4e-05,0.018,186,232,157,202,124,215,0.73,46,45,91
OceanDNA-b27622,294,16.2,0.0,2.8e-07,0.00021,59,153,72,167,34,188,0.73,94,95,154
OceanDNA-b34782,645,11.8,0.1,6.2e-06,0.0041,110,161,27,83,17,97,0.73,51,56,80
OceanDNA-b31995,2721,13.4,0.0,1.9e-06,0.0065,55,150,109,208,71,217,0.73,95,99,146
OceanDNA-b22398,1431,15.0,0.0,2e-06,0.002,101,176,568,646,535,682,0.73,75,78,147
OceanDNA-b37859,480,1.3,0.0,0.0099,9.4,116,156,623,666,608,676,0.73,40,43,68
OceanDNA-b47088,1051,21.1,0.1,8.8e-09,3.4e-05,45,220,150,323,136,372,0.73,175,173,236
OceanDNA-b7584,366,1.8,0.0,0.0066,2.5,118,142,155,179,130,194,0.73,24,24,64
OceanDNA-b46942,588,13.2,0.0,2.3e-06,0.0017,117,188,200,275,186,300,0.73,71,75,114
OceanDNA-b33331,1087,45.0,0.1,8.8e-16,7e-13,63,233,210,398,188,416,0.73,170,188,228
OceanDNA-b36885,333,-2.3,0.0,0.12,81.0,56,85,118,147,108,151,0.73,29,29,43
OceanDNA-b32753,11,1.1,0.0,0.011,5.4,163,186,298,321,283,354,0.73,23,23,71
OceanDNA-b26823,1130,1.6,0.0,0.0076,28.0,142,210,263,336,251,350,0.73,68,73,99
OceanDNA-b8408,166,-3.4,0.1,0.27,56.0,28,50,369,391,360,393,0.73,22,22,33
OceanDNA-b30927,17,-2.0,0.0,0.2,210.0,51,69,268,288,261,295,0.73,18,20,34
OceanDNA-b17331,550,10.9,0.1,1.1e-05,0.01,104,147,160,202,129,213,0.73,43,42,84
OceanDNA-b6569,486,8.4,0.0,0.00013,0.058,126,151,109,134,11,153,0.73,25,25,142
OceanDNA-b4061,892,14.0,0.0,1.3e-06,0.0012,59,177,111,239,78,244,0.73,118,128,166
OceanDNA-b44444,1331,19.6,0.0,2.5e-08,5.9e-05,54,135,127,219,122,233,0.73,81,92,111
OceanDNA-b11616,217,16.3,0.2,2.5e-07,0.00025,39,137,175,283,156,295,0.73,98,108,139
OceanDNA-b36771,228,18.3,0.0,6.1e-08,6.7e-05,95,158,208,273,200,294,0.73,63,65,94
OceanDNA-b15541,923,18.6,0.0,1.1e-07,0.0001,43,154,29,148,15,167,0.73,111,119,152
OceanDNA-b23549,463,3.7,0.0,0.0053,3.5,111,154,533,576,474,591,0.73,43,43,117
OceanDNA-b23176,6781,16.8,0.0,3.6e-07,0.0014,40,176,96,244,73,250,0.73,136,148,177
OceanDNA-b22991,4364,10.9,0.0,2.3e-05,0.052,60,150,62,153,47,168,0.73,90,91,121
OceanDNA-b16209,388,3.9,0.0,0.0016,2.0,159,185,453,479,433,510,0.73,26,26,77
OceanDNA-b40912,147,12.2,0.0,4.7e-06,0.0042,47,137,126,225,105,238,0.73,90,99,133
OceanDNA-b46829,980,11.8,0.0,6e-06,0.012,43,134,505,598,493,606,0.73,91,93,113
OceanDNA-b23258,83,-1.3,0.0,0.062,19.0,158,210,352,397,344,402,0.73,52,45,58
OceanDNA-b4488,2484,11.2,0.0,2.9e-05,0.026,65,146,141,224,112,238,0.73,81,83,126
OceanDNA-b6501,201,16.7,0.0,5.7e-07,9.7e-05,51,160,34,148,7,153,0.73,109,114,146
OceanDNA-b10080,453,10.2,0.0,3.8e-05,0.019,67,176,163,281,126,322,0.73,109,118,196
OceanDNA-b22848,486,-1.0,0.0,0.1,200.0,16,57,76,118,62,128,0.73,41,42,66
OceanDNA-b4290,7,1.1,0.0,0.011,2.8,117,154,35,72,20,83,0.73,37,37,63
OceanDNA-b41358,206,13.2,0.0,4.6e-06,0.0028,26,151,105,234,80,272,0.73,125,129,192
OceanDNA-b10261,75,-1.7,0.0,0.08,27.0,161,190,216,244,208,254,0.73,29,28,46
OceanDNA-b22995,1529,15.3,0.0,1.5e-06,0.0011,101,174,546,625,523,714,0.73,73,79,191
OceanDNA-b36079,214,10.9,0.0,1.2e-05,0.029,62,126,178,241,165,248,0.73,64,63,83
OceanDNA-b17582,63,17.4,0.0,1.2e-07,0.00037,117,204,166,255,143,276,0.73,87,89,133
OceanDNA-b20157,86,15.4,0.0,4.9e-07,0.00019,116,181,127,194,109,223,0.72,65,67,114
OceanDNA-b46728,1025,12.6,0.0,1.4e-05,0.0057,119,165,4,51,1,106,0.72,46,47,105
OceanDNA-b6781,378,-2.9,0.0,0.19,96.0,116,137,136,159,131,171,0.72,21,23,40
OceanDNA-b11316,39,12.7,0.0,6.6e-06,0.0011,103,145,145,184,136,207,0.72,42,39,71
OceanDNA-b45790,316,13.6,0.1,1.7e-06,0.0007,53,160,66,173,45,177,0.72,107,107,132
OceanDNA-b43907,104,-0.7,0.0,0.077,13.0,159,210,235,292,223,318,0.72,51,57,95
OceanDNA-b36140,2310,-0.7,0.0,0.04,110.0,32,91,393,459,380,464,0.72,59,66,84
OceanDNA-b40175,436,14.3,0.0,1.1e-06,0.00099,47,155,24,143,6,151,0.72,108,119,145
OceanDNA-b35371,154,17.3,0.0,1.3e-07,0.00011,57,160,39,147,14,160,0.72,103,108,146
OceanDNA-b8544,124,18.1,0.0,7.5e-08,1.4e-05,43,142,54,161,50,181,0.72,99,107,131
OceanDNA-b9096,35,7.5,0.0,0.00024,0.042,143,216,272,351,259,372,0.72,73,79,113
OceanDNA-b32791,286,9.4,0.0,3.3e-05,0.01,90,150,115,175,69,194,0.72,60,60,125
OceanDNA-b29542,1230,12.3,0.0,8.6e-06,0.0096,70,162,188,283,161,297,0.72,92,95,136
OceanDNA-b29555,2035,3.5,0.1,0.0021,5.3,137,216,222,301,213,310,0.72,79,79,97
OceanDNA-b19147,356,3.1,0.0,0.0055,0.98,94,142,118,167,111,182,0.72,48,49,71
OceanDNA-b38872,355,8.6,0.0,5.8e-05,0.038,69,152,49,131,3,150,0.72,83,82,147
OceanDNA-b27536,721,24.0,0.1,1.2e-09,2e-06,54,140,142,235,130,249,0.72,86,93,119
OceanDNA-b15967,1133,17.4,0.2,1.2e-07,0.00021,45,193,30,187,6,249,0.72,148,157,243
OceanDNA-b32706,1844,-0.6,0.0,0.038,73.0,166,189,246,269,167,307,0.72,23,23,140
OceanDNA-b6567,196,-3.6,0.1,0.31,310.0,33,53,142,162,132,182,0.72,20,20,50
OceanDNA-b423,584,-2.6,0.0,0.15,150.0,111,144,222,256,216,259,0.72,33,34,43
OceanDNA-b24040,1710,-1.2,0.0,0.058,100.0,215,249,171,207,158,216,0.72,34,36,58
OceanDNA-b40641,971,10.8,0.0,4.8e-05,0.016,102,148,119,164,53,173,0.72,46,45,120
OceanDNA-b37895,508,-0.9,0.0,0.046,36.0,108,154,510,557,495,568,0.72,46,47,73
OceanDNA-b23063,1570,22.1,0.5,4.2e-09,6.9e-06,44,156,65,182,35,213,0.72,112,117,178
OceanDNA-b15979,900,15.1,0.0,1.2e-06,0.0006,107,152,66,111,4,129,0.72,45,45,125
OceanDNA-b33394,954,13.3,0.1,4.3e-06,0.0056,25,66,238,280,214,295,0.72,41,42,81
OceanDNA-b45271,128,-0.3,0.0,0.03,15.0,163,188,317,342,307,395,0.72,25,25,88
OceanDNA-b21002,2868,-0.3,0.0,0.06,170.0,80,103,115,138,108,199,0.72,23,23,91
OceanDNA-b3658,1305,21.2,0.1,8.5e-09,1.2e-05,22,156,48,192,32,199,0.72,134,144,167
OceanDNA-b3653,1507,13.5,0.0,5.5e-06,0.0042,102,208,139,249,132,255,0.72,106,110,123
OceanDNA-b44582,699,15.5,0.0,4.6e-07,0.001,68,176,130,249,70,304,0.72,108,119,234
OceanDNA-b10144,58,11.3,0.1,8.8e-06,0.003,103,158,85,139,64,159,0.72,55,54,95
OceanDNA-b24097,631,14.4,0.0,9.8e-07,0.0014,45,148,99,208,69,227,0.72,103,109,158
OceanDNA-b15516,151,7.8,0.0,9.8e-05,0.082,160,200,205,244,190,273,0.72,40,39,83
OceanDNA-b38636,415,14.1,0.0,1.2e-06,0.00062,61,143,114,194,89,204,0.72,82,80,115
OceanDNA-b16220,1203,27.9,0.0,1.5e-10,9e-08,17,146,260,404,253,411,0.72,129,144,158
OceanDNA-b45854,2076,5.6,0.0,0.00095,1.0,164,231,140,207,133,215,0.72,67,67,82
OceanDNA-b44053,587,-4.1,0.0,0.44,590.0,118,150,564,596,555,602,0.72,32,32,47
OceanDNA-b44,4810,0.3,0.0,0.038,140.0,115,151,531,567,519,578,0.72,36,36,59
OceanDNA-b45640,461,22.1,0.0,4.3e-09,2.5e-06,113,215,136,250,119,269,0.72,102,114,150
OceanDNA-b31334,15,7.7,0.1,0.00011,0.017,173,236,217,279,204,279,0.72,63,62,75
OceanDNA-b1825,2392,28.0,0.2,1.4e-10,2.6e-07,50,208,490,672,482,679,0.72,158,182,197
OceanDNA-b23525,1023,10.5,0.5,1.5e-05,0.031,35,152,24,145,11,155,0.72,117,121,144
OceanDNA-b26842,552,-2.4,0.0,0.13,300.0,162,210,334,381,299,392,0.72,48,47,93
OceanDNA-b3635,774,16.3,0.0,5.3e-07,0.00069,118,151,158,192,146,255,0.72,33,34,109
OceanDNA-b26843,1077,10.0,0.1,4.3e-05,0.059,59,153,22,117,11,132,0.72,94,95,121
OceanDNA-b30627,591,0.1,0.0,0.023,21.0,139,210,278,354,266,368,0.72,71,76,102
OceanDNA-b18433,539,18.9,0.0,4.1e-08,2.4e-05,52,176,32,166,4,176,0.72,124,134,172
OceanDNA-b22293,614,12.4,0.2,4e-06,0.0046,103,162,118,179,112,215,0.72,59,61,103
OceanDNA-b1140,552,10.6,0.0,1.4e-05,0.022,114,170,97,154,84,178,0.72,56,57,94
OceanDNA-b15551,376,-0.0,0.0,0.049,52.0,47,83,82,114,75,120,0.72,36,32,45
OceanDNA-b15551,1054,18.4,0.0,1.2e-07,0.00013,45,162,70,196,55,205,0.72,117,126,150
OceanDNA-b12109,280,14.0,0.0,1.3e-06,0.00053,72,156,27,118,6,148,0.72,84,91,142
OceanDNA-b22093,3173,18.8,0.0,4.3e-08,0.00015,104,197,485,578,473,616,0.72,93,93,143
OceanDNA-b44444,1331,2.2,0.0,0.0051,12.0,137,208,253,329,232,339,0.72,71,76,107
OceanDNA-b24879,1546,13.4,0.0,1.9e-06,0.0036,110,145,110,145,89,235,0.72,35,35,146
OceanDNA-b30849,481,8.3,0.0,7.1e-05,0.07,125,161,110,150,35,156,0.72,36,40,121
OceanDNA-b45287,2349,0.7,0.0,0.015,40.0,151,238,319,408,302,414,0.72,87,89,112
OceanDNA-b37161,189,13.9,0.0,1.4e-06,0.0015,61,152,38,128,19,142,0.72,91,90,123
OceanDNA-b30206,381,18.3,0.0,1.2e-07,0.00014,51,141,141,241,131,257,0.72,90,100,126
OceanDNA-b17563,670,25.6,0.0,7.3e-10,8.2e-07,49,181,55,197,35,239,0.72,132,142,204
OceanDNA-b38942,1826,26.2,0.8,2.5e-10,4.8e-07,40,212,73,240,43,272,0.72,172,167,229
OceanDNA-b15892,186,16.9,0.0,1.7e-07,5.1e-05,93,162,95,158,62,163,0.72,69,63,101
OceanDNA-b32958,1170,14.8,0.0,7.3e-07,0.0018,96,149,356,407,304,422,0.72,53,51,118
OceanDNA-b22801,1851,0.8,0.0,0.029,36.0,114,156,503,548,491,556,0.72,42,45,65
OceanDNA-b3654,348,23.1,0.1,2.1e-09,2.7e-06,49,139,143,245,135,256,0.72,90,102,121
OceanDNA-b4143,217,15.7,0.0,1.2e-06,0.00063,114,208,130,227,121,241,0.72,94,97,120
OceanDNA-b24304,149,4.0,0.0,0.0014,3.0,136,210,193,263,180,273,0.72,74,70,93
OceanDNA-b22386,1880,21.9,0.0,1.5e-08,1e-05,114,156,181,226,166,255,0.72,42,45,89
OceanDNA-b22650,2148,17.9,0.0,1.7e-07,0.0002,87,151,116,178,81,184,0.72,64,62,103
OceanDNA-b12873,257,21.9,0.0,5.1e-09,3.5e-06,74,156,144,233,137,239,0.72,82,89,102
OceanDNA-b36858,388,19.9,0.0,2e-08,1.5e-05,117,153,195,231,167,302,0.72,36,36,135
OceanDNA-b30966,1378,1.2,0.1,0.01,28.0,114,137,69,94,50,111,0.72,23,25,61
OceanDNA-b22554,190,12.9,0.0,8.4e-06,0.0033,117,157,136,177,114,224,0.72,40,41,110
OceanDNA-a3737,266,6.2,0.0,0.00031,0.088,57,146,15,117,9,126,0.72,89,102,117
OceanDNA-b31056,401,4.3,0.0,0.0036,3.7,173,230,236,291,216,299,0.72,57,55,83
OceanDNA-b4022,184,-1.6,0.0,0.14,89.0,140,185,275,326,266,355,0.72,45,51,89
OceanDNA-b18413,186,-1.2,0.0,0.057,34.0,115,154,527,566,516,576,0.72,39,39,60
OceanDNA-b13084,750,19.4,0.0,5.8e-08,7.3e-05,40,141,185,299,142,307,0.72,101,114,165
OceanDNA-b16510,1060,15.3,0.1,5.3e-07,0.00072,43,140,222,335,216,343,0.72,97,113,127
OceanDNA-b23643,888,5.1,0.0,0.0013,1.6,162,228,232,299,226,300,0.72,66,67,74
OceanDNA-b22380,600,11.6,0.0,2.1e-05,0.011,74,150,143,218,92,224,0.72,76,75,132
OceanDNA-b34793,517,-2.5,0.0,0.14,110.0,178,212,85,119,79,131,0.72,34,34,52
OceanDNA-b36740,366,8.3,0.0,6.9e-05,0.038,110,152,122,165,93,189,0.72,42,43,96
OceanDNA-b45271,128,-3.5,0.0,0.28,140.0,204,243,84,122,81,136,0.72,39,38,55
OceanDNA-b16229,171,22.1,0.0,1.3e-08,5.9e-06,46,156,48,169,22,205,0.72,110,121,183
OceanDNA-b40613,167,0.2,0.0,0.064,16.0,58,89,53,87,27,101,0.72,31,34,74
OceanDNA-b26879,966,0.4,0.0,0.018,63.0,157,182,214,238,202,282,0.72,25,24,80
OceanDNA-b46050,498,15.0,0.0,6.3e-07,0.00061,117,208,248,342,226,376,0.72,91,94,150
OceanDNA-b30773,857,11.5,0.0,7.3e-06,0.021,103,160,152,204,112,214,0.72,57,52,102
OceanDNA-b40265,779,29.3,0.0,5.5e-11,2.6e-08,117,208,164,262,149,281,0.72,91,98,132
OceanDNA-b36151,1469,-0.9,0.0,0.091,100.0,131,186,299,356,286,370,0.72,55,57,84
OceanDNA-b23093,2434,18.9,0.0,1.3e-07,0.00026,40,140,375,486,371,494,0.72,100,111,123
OceanDNA-b22492,710,7.7,0.0,0.00011,0.18,40,146,40,147,6,164,0.72,106,107,158
OceanDNA-b1473,7,11.9,0.0,5.9e-06,0.0043,61,189,54,180,33,207,0.72,128,126,174
OceanDNA-b16161,577,13.8,0.0,1.5e-06,0.0012,41,141,41,152,32,156,0.72,100,111,124
OceanDNA-b20098,139,45.8,0.1,5e-16,6.2e-14,35,246,83,328,63,336,0.72,211,245,273
OceanDNA-b23047,344,25.5,0.0,4.1e-10,3.3e-07,65,212,89,250,27,258,0.72,147,161,231
OceanDNA-b36770,541,13.4,0.1,4e-06,0.0022,102,148,135,179,64,187,0.72,46,44,123
OceanDNA-b34924,232,4.0,0.1,0.0028,1.4,214,246,378,410,345,420,0.72,32,32,75
OceanDNA-b31421,2275,12.1,0.0,4.9e-06,0.017,64,140,105,179,96,197,0.72,76,74,101
OceanDNA-b22477,939,-3.0,0.0,0.2,340.0,153,175,193,215,171,217,0.72,22,22,46
OceanDNA-b22353,1092,16.6,0.0,4.1e-07,0.00023,115,189,118,199,99,231,0.72,74,81,132
OceanDNA-b17301,2418,12.0,0.0,1.1e-05,0.013,37,142,169,278,156,296,0.72,105,109,140
OceanDNA-b45518,70,23.5,0.0,3.2e-09,2.6e-06,100,155,134,189,83,247,0.72,55,55,164
OceanDNA-b15889,227,16.9,0.0,1.7e-07,5e-05,118,180,123,194,103,226,0.72,62,71,123
OceanDNA-b9190,106,1.9,0.0,0.0064,2.5,139,192,276,335,265,366,0.72,53,59,101
OceanDNA-b35343,514,12.6,0.0,3.6e-06,0.0025,40,155,236,358,214,365,0.72,115,122,151
OceanDNA-b38208,1052,13.8,0.0,1.5e-06,0.0042,42,154,56,170,28,181,0.72,112,114,153
OceanDNA-b23491,1528,11.7,0.0,1.3e-05,0.011,54,145,111,207,88,246,0.72,91,96,158
OceanDNA-b35901,22,6.2,0.0,0.00064,0.19,154,194,216,256,177,265,0.72,40,40,88
OceanDNA-b7450,995,12.4,0.0,8.1e-06,0.0053,47,154,159,269,139,284,0.72,107,110,145
OceanDNA-b2539,371,11.0,0.0,1e-05,0.0042,70,153,29,110,20,140,0.72,83,81,120
OceanDNA-b30215,1413,7.1,0.1,0.0005,0.31,75,122,9,61,3,68,0.72,47,52,65
OceanDNA-b44168,3,-1.3,0.0,0.062,33.0,160,195,201,235,176,256,0.72,35,34,80
OceanDNA-b47071,688,22.2,0.0,7.9e-09,2.9e-06,118,216,89,198,68,209,0.72,98,109,141
OceanDNA-b35069,891,14.9,0.0,2.1e-06,0.00065,90,151,105,167,47,177,0.72,61,62,130
OceanDNA-b22787,1043,5.1,0.0,0.00067,0.91,66,134,129,195,100,213,0.72,68,66,113
OceanDNA-b18035,77,22.2,0.0,4.2e-09,7.6e-07,104,162,230,291,142,307,0.72,58,61,165
OceanDNA-b26870,727,-2.3,0.0,0.12,380.0,162,210,300,347,265,358,0.72,48,47,93
OceanDNA-b26870,727,-1.9,0.0,0.091,280.0,215,249,383,419,351,426,0.72,34,36,75
OceanDNA-b24965,1753,-0.2,0.0,0.056,55.0,158,179,276,297,233,322,0.72,21,21,89
OceanDNA-b21342,331,-2.0,0.0,0.1,49.0,162,181,194,214,187,244,0.72,19,20,57
OceanDNA-b16128,406,13.3,0.0,2.2e-06,0.002,42,144,166,270,157,296,0.72,102,104,139
OceanDNA-b39,2116,15.2,0.0,1.1e-06,0.0039,103,150,173,223,152,237,0.72,47,50,85
OceanDNA-b16209,388,15.3,0.0,5.1e-07,0.00064,53,106,284,335,261,405,0.72,53,51,144
OceanDNA-b33307,615,8.0,0.0,8.8e-05,0.28,167,232,235,298,222,301,0.72,65,63,79
OceanDNA-b6163,418,4.0,0.0,0.0014,0.82,170,233,205,266,180,274,0.72,63,61,94
OceanDNA-b2513,1292,15.0,0.0,1.2e-06,0.00091,41,151,28,141,17,156,0.72,110,113,139
OceanDNA-b36152,858,13.6,0.4,1.7e-06,0.0041,41,151,124,253,114,263,0.72,110,129,149
OceanDNA-b37122,207,11.1,0.1,1e-05,0.0097,115,151,123,164,110,187,0.72,36,41,77
OceanDNA-b45862,19,13.0,0.0,2.6e-06,0.00068,59,140,80,160,41,212,0.72,81,80,171
OceanDNA-b23131,668,16.5,0.0,2.3e-07,0.00023,116,152,149,185,127,217,0.72,36,36,90
OceanDNA-b37653,1001,36.1,0.2,2.3e-13,2.4e-10,52,213,146,327,138,333,0.72,161,181,195
OceanDNA-b46402,2260,12.5,0.2,3.8e-06,0.01,24,138,72,194,61,213,0.72,114,122,152
OceanDNA-b22377,1876,19.6,0.0,5.1e-08,5.8e-05,113,176,191,256,171,268,0.72,63,65,97
OceanDNA-b46852,1158,-1.7,0.0,0.16,100.0,118,156,393,432,382,463,0.72,38,39,81
OceanDNA-b6168,140,7.2,0.0,0.00015,0.087,92,150,73,129,28,149,0.72,58,56,121
OceanDNA-b34944,273,-2.0,0.0,0.098,70.0,115,154,459,498,448,528,0.72,39,39,80
OceanDNA-b19626,143,20.3,0.0,3.1e-08,7.5e-06,94,158,202,261,149,301,0.71,64,59,152
OceanDNA-b15777,593,12.6,0.0,1.1e-05,0.0061,115,154,174,212,161,291,0.71,39,38,130
OceanDNA-b36411,1726,12.1,0.0,1.5e-05,0.01,26,151,22,152,10,166,0.71,125,130,156
OceanDNA-b19355,313,17.2,0.0,1.3e-07,4.9e-05,117,156,158,198,137,253,0.71,39,40,116
OceanDNA-b13256,790,17.6,0.1,7.4e-07,0.00021,41,165,384,507,345,541,0.71,124,123,196
OceanDNA-b3653,417,-0.2,0.0,0.085,65.0,112,154,534,577,525,588,0.71,42,43,63
OceanDNA-b2854,2002,16.3,0.2,7.6e-07,0.00089,51,156,40,148,5,174,0.71,105,108,169
OceanDNA-b36770,23,13.4,0.0,4e-06,0.0022,211,250,230,268,207,275,0.71,39,38,68
OceanDNA-b24095,812,11.8,0.0,6e-06,0.023,33,155,59,189,39,196,0.71,122,130,157
OceanDNA-b44183,327,18.4,0.0,5.7e-08,2.8e-05,100,172,119,188,53,196,0.71,72,69,143
OceanDNA-b40245,93,12.4,0.0,1.2e-05,0.003,154,225,235,310,210,315,0.71,71,75,105
OceanDNA-b22848,486,17.4,0.0,2.4e-07,0.00048,112,180,538,611,465,636,0.71,68,73,171
OceanDNA-b23108,845,11.8,0.0,1.2e-05,0.012,116,212,222,333,211,353,0.71,96,111,142
OceanDNA-b13273,1079,14.9,0.0,7.1e-07,0.00077,42,210,60,233,27,244,0.71,168,173,217
OceanDNA-b33411,617,12.8,0.0,5.9e-06,0.0038,91,135,122,167,94,186,0.71,44,45,92
OceanDNA-b23120,1596,13.1,0.0,2.5e-06,0.0046,116,227,115,241,102,245,0.71,111,126,143
OceanDNA-b38518,99,-1.2,0.0,0.11,51.0,42,89,41,94,34,100,0.71,47,53,66
OceanDNA-b3909,233,13.7,0.0,3.2e-06,0.002,117,187,117,195,106,205,0.71,70,78,99
OceanDNA-b35165,250,-1.9,0.0,0.093,51.0,115,154,513,552,500,563,0.71,39,39,63
OceanDNA-b23093,1592,26.9,1.3,4.4e-10,9e-07,21,207,35,247,24,283,0.71,186,212,259
OceanDNA-b41456,66,25.7,0.0,3.6e-10,3.6e-07,57,208,110,277,99,286,0.71,151,167,187
OceanDNA-b14104,303,12.9,0.0,8.4e-06,0.0013,108,182,147,222,135,252,0.71,74,75,117
OceanDNA-b16212,559,-2.4,0.0,0.14,150.0,29,50,25,44,17,50,0.71,21,19,33
OceanDNA-b17301,1187,-2.8,0.0,0.36,440.0,115,152,30,67,17,73,0.71,37,37,56
OceanDNA-b19687,279,47.1,0.0,1e-16,4.7e-14,37,244,81,317,58,327,0.71,207,236,269
OceanDNA-b4503,685,17.8,0.1,9.3e-08,6.4e-05,100,175,124,198,59,223,0.71,75,74,164
OceanDNA-b21008,2230,13.0,0.0,2.6e-06,0.0068,92,209,82,205,17,213,0.71,117,123,196
OceanDNA-b38376,703,6.5,0.0,0.00077,0.64,104,152,135,182,107,193,0.71,48,47,86
OceanDNA-b14001,78,12.2,0.0,4.5e-06,0.001,92,178,62,158,54,170,0.71,86,96,116
OceanDNA-b7477,488,14.6,0.0,1.7e-06,0.00055,77,157,109,192,99,201,0.71,80,83,102
OceanDNA-b20056,324,39.8,0.0,3.6e-14,6.9e-12,37,245,78,313,55,319,0.71,208,235,264
OceanDNA-b16112,176,11.1,0.0,1e-05,0.005,115,145,74,104,52,185,0.71,30,30,133
OceanDNA-b46916,2442,20.8,0.0,1.1e-08,5.7e-05,97,181,208,295,193,336,0.71,84,87,143
OceanDNA-b30852,1197,0.9,0.0,0.027,26.0,31,67,206,242,185,249,0.71,36,36,64
OceanDNA-b40263,195,26.0,0.0,2.9e-10,2e-07,38,146,88,207,70,277,0.71,108,119,207
OceanDNA-b41476,951,12.7,0.0,6.6e-06,0.0048,54,141,93,192,79,268,0.71,87,99,189
OceanDNA-b38880,297,2.3,0.0,0.0094,4.4,143,207,258,327,229,344,0.71,64,69,115
OceanDNA-b30874,1412,2.5,0.0,0.0041,9.7,157,209,229,279,194,292,0.71,52,50,98
OceanDNA-b38527,545,10.0,0.0,2.2e-05,0.015,110,181,65,135,48,171,0.71,71,70,123
OceanDNA-b32,392,5.8,0.0,0.00084,0.26,40,92,119,175,86,200,0.71,52,56,114
OceanDNA-b33048,1451,15.0,0.0,6.2e-07,0.0023,101,155,102,150,55,162,0.71,54,48,107
OceanDNA-b26937,161,3.5,0.0,0.0021,0.47,159,229,305,376,297,384,0.71,70,71,87
OceanDNA-b7203,304,16.1,0.0,3e-07,0.00022,62,178,118,244,61,254,0.71,116,126,193
OceanDNA-b23370,1686,16.1,0.1,3e-07,0.00063,62,144,81,161,73,173,0.71,82,80,100
OceanDNA-b32684,1044,11.5,0.1,7.7e-06,0.012,62,152,37,123,8,129,0.71,90,86,121
OceanDNA-b16220,1203,2.2,0.0,0.01,6.4,158,209,463,517,432,572,0.71,51,54,140
OceanDNA-b32822,367,-1.0,0.0,0.047,30.0,131,180,170,221,165,230,0.71,49,51,65
OceanDNA-b35371,154,-1.0,0.0,0.05,43.0,195,230,220,256,195,280,0.71,35,36,85
OceanDNA-b30641,995,15.7,0.0,7.8e-07,0.00042,33,152,51,174,29,190,0.71,119,123,161
OceanDNA-b33325,189,-2.8,0.0,0.18,290.0,178,210,79,111,73,127,0.71,32,32,54
OceanDNA-b24731,533,12.0,0.0,5.3e-06,0.0042,37,143,18,137,9,149,0.71,106,119,140
OceanDNA-b6493,506,14.8,0.0,1.4e-06,0.00054,51,177,106,242,81,293,0.71,126,136,212
OceanDNA-b4116,268,10.2,0.0,1.9e-05,0.012,113,149,108,147,89,155,0.71,36,39,66
OceanDNA-b36722,553,2.8,0.0,0.0035,3.4,182,210,240,268,214,288,0.71,28,28,74
OceanDNA-b3934,230,6.6,0.0,0.00047,0.17,162,231,187,254,174,259,0.71,69,67,85
OceanDNA-b46255,1416,-0.8,0.0,0.13,140.0,200,228,219,247,180,249,0.71,28,28,69
OceanDNA-b41340,1342,16.0,0.1,9.2e-07,0.00044,39,148,18,134,3,159,0.71,109,116,156
OceanDNA-b17618,82,11.6,0.0,7e-06,0.01,58,153,65,158,53,172,0.71,95,93,119
OceanDNA-b44390,515,14.6,0.1,1.7e-06,0.00059,116,209,130,225,96,247,0.71,93,95,151
OceanDNA-b23556,470,-1.3,0.1,0.12,130.0,130,153,78,101,66,147,0.71,23,23,81
OceanDNA-b20908,8483,26.0,0.0,2.9e-10,2.9e-06,49,209,46,231,7,246,0.71,160,185,239
OceanDNA-b3434,504,12.5,0.0,7.6e-06,0.0057,93,162,146,217,86,252,0.71,69,71,166
OceanDNA-b6561,240,2.9,0.0,0.0062,4.2,196,229,222,256,192,260,0.71,33,34,68
OceanDNA-b44039,156,1.0,0.0,0.024,3.7,160,210,229,285,221,324,0.71,50,56,103
OceanDNA-b9056,131,-1.2,0.0,0.057,17.0,120,155,259,294,241,302,0.71,35,35,61
OceanDNA-b18620,349,-3.2,0.0,0.45,91.0,56,85,112,141,105,144,0.71,29,29,39
OceanDNA-b20979,1920,-2.5,0.0,0.29,360.0,17,41,57,83,47,88,0.71,24,26,41
OceanDNA-b12076,229,16.2,0.2,2.8e-07,0.00012,25,153,22,163,13,210,0.71,128,141,197
OceanDNA-b2828,2148,8.7,0.6,0.00011,0.19,43,142,18,116,8,132,0.71,99,98,124
OceanDNA-b31510,187,-1.1,0.0,0.16,60.0,131,192,354,420,342,447,0.71,61,66,105
OceanDNA-b13249,128,17.7,0.1,2.9e-07,9e-05,117,228,34,151,22,177,0.71,111,117,155
OceanDNA-b425,789,15.6,0.0,4.2e-07,0.00038,56,164,113,237,105,276,0.71,108,124,171
OceanDNA-b32692,259,7.3,0.0,0.00014,0.35,150,185,180,216,162,251,0.71,35,36,89
OceanDNA-b18470,294,14.4,0.0,1.9e-06,0.00031,99,150,125,170,35,174,0.71,51,45,139
OceanDNA-b4484,255,12.9,0.0,2.8e-06,0.0038,116,242,263,395,159,408,0.71,126,132,249
OceanDNA-b40959,1116,20.5,0.0,1.4e-08,4.4e-05,60,158,143,250,89,272,0.71,98,107,183
OceanDNA-b19690,159,16.4,0.0,4.7e-07,0.0001,112,181,108,179,94,192,0.71,69,71,98
OceanDNA-b488,1656,2.7,0.1,0.0035,9.0,164,229,199,265,176,270,0.71,65,66,94
OceanDNA-b20404,296,-2.4,0.0,0.13,54.0,62,87,155,180,146,182,0.71,25,25,36
OceanDNA-b17690,254,1.8,0.0,0.0068,14.0,163,215,218,272,213,283,0.71,52,54,70
OceanDNA-b6759,143,-3.8,0.0,0.36,260.0,197,214,319,336,310,344,0.71,17,17,34
OceanDNA-b23944,1715,18.6,0.0,5.1e-08,8.9e-05,174,246,203,270,180,281,0.71,72,67,101
OceanDNA-b37508,143,11.1,0.4,1e-05,0.02,39,152,32,144,17,151,0.71,113,112,134
OceanDNA-b286,3125,16.1,0.0,3e-07,0.0012,63,183,98,228,44,261,0.71,120,130,217
OceanDNA-b1719,179,9.7,0.0,5.5e-05,0.082,66,150,157,240,140,258,0.71,84,83,118
OceanDNA-b9687,398,-2.1,0.0,0.21,93.0,116,154,539,577,524,585,0.71,38,38,61
OceanDNA-b13759,281,22.8,0.0,2.7e-09,9.2e-07,67,176,42,160,21,178,0.71,109,118,157
OceanDNA-b1765,1396,-2.0,0.1,0.1,240.0,115,145,32,62,13,88,0.71,30,30,75
OceanDNA-b16147,120,0.3,0.0,0.039,14.0,151,210,422,481,407,487,0.71,59,59,80
OceanDNA-b31535,2697,10.8,0.0,2.5e-05,0.035,110,145,156,191,139,210,0.71,35,35,71
OceanDNA-b32942,754,6.8,0.2,0.0002,0.23,120,144,88,112,56,125,0.71,24,24,69
OceanDNA-b8956,293,19.9,0.0,2e-08,6.1e-06,103,155,116,170,106,201,0.71,52,54,95
OceanDNA-b15272,62,9.1,0.0,3.9e-05,0.012,89,153,51,118,42,129,0.71,64,67,87
OceanDNA-b21002,2868,11.9,0.0,1.2e-05,0.033,48,143,223,328,212,400,0.71,95,105,188
OceanDNA-b37510,357,11.0,0.0,2.1e-05,0.017,52,150,33,142,7,153,0.71,98,109,146
OceanDNA-b43541,53,16.3,0.0,2.5e-07,0.00027,52,154,42,155,5,225,0.71,102,113,220
OceanDNA-b16098,320,3.3,0.0,0.0049,1.9,156,182,420,446,399,484,0.71,26,26,85
OceanDNA-b22461,2712,8.7,0.0,0.00011,0.25,49,98,72,121,63,147,0.71,49,49,84
OceanDNA-b23491,381,2.3,0.0,0.0096,8.7,192,232,257,298,220,305,0.71,40,41,85
OceanDNA-b30743,468,16.7,0.0,1.9e-07,0.00029,40,178,44,193,18,247,0.71,138,149,229
OceanDNA-b13174,41,15.4,0.0,4.7e-07,0.00027,43,153,45,167,19,240,0.71,110,122,221
OceanDNA-b30238,288,14.6,0.0,8.3e-07,0.0017,70,162,62,157,39,164,0.71,92,95,125
OceanDNA-b38177,705,-1.4,0.0,0.063,180.0,116,156,554,597,542,606,0.71,40,43,64
OceanDNA-b9705,341,7.9,0.0,9.4e-05,0.077,125,151,121,147,38,163,0.71,26,26,125
OceanDNA-b10366,399,2.0,0.0,0.006,9.6,119,143,145,169,71,242,0.71,24,24,171
OceanDNA-b20977,3170,12.4,0.0,1.2e-05,0.015,116,207,216,308,205,334,0.71,91,92,129
OceanDNA-b40912,147,2.5,0.0,0.0043,3.8,146,208,266,333,260,347,0.71,62,67,87
OceanDNA-b30216,630,13.6,0.0,1.7e-06,0.0034,70,162,265,360,242,367,0.71,92,95,125
OceanDNA-b1833,1400,-0.7,0.1,0.04,58.0,12,54,70,114,64,123,0.71,42,44,59
OceanDNA-b19817,245,26.0,0.0,2.9e-10,1.1e-07,37,156,88,217,68,268,0.71,119,129,200
OceanDNA-b22759,156,15.4,0.1,9.5e-07,0.00049,103,188,151,232,138,257,0.71,85,81,119
OceanDNA-b1696,585,11.4,0.0,1.6e-05,0.006,35,153,17,141,5,155,0.71,118,124,150
OceanDNA-b31694,127,-0.5,0.0,0.034,47.0,43,95,23,79,18,84,0.71,52,56,66
OceanDNA-b22496,4550,12.1,0.0,9.7e-06,0.023,107,150,60,100,22,169,0.71,43,40,147
OceanDNA-b31170,1207,4.3,0.0,0.0012,1.5,163,235,162,234,151,255,0.71,72,72,104
OceanDNA-b40797,403,17.4,0.1,1.2e-07,0.00013,53,155,40,155,15,182,0.71,102,115,167
OceanDNA-b17739,3688,10.7,0.0,1.3e-05,0.056,56,151,130,229,107,301,0.71,95,99,194
OceanDNA-b20977,2184,-3.4,0.0,0.78,960.0,164,195,328,361,326,375,0.71,31,33,49
OceanDNA-b35318,70,2.8,0.0,0.0034,3.4,166,224,198,255,194,261,0.71,58,57,67
OceanDNA-b25136,116,13.3,0.0,2.1e-06,0.00048,51,142,99,192,87,201,0.71,91,93,114
OceanDNA-b3916,443,13.6,0.0,1.7e-06,0.0032,66,146,306,397,274,407,0.71,80,91,133
OceanDNA-b3323,131,-1.7,0.0,0.16,270.0,165,194,295,323,292,345,0.71,29,28,53
OceanDNA-b3920,1406,12.8,0.0,9e-06,0.0058,66,146,306,397,274,407,0.71,80,91,133
OceanDNA-b3978,864,-3.3,0.0,0.24,230.0,161,191,231,260,223,270,0.71,30,29,47
OceanDNA-b30627,591,1.2,0.0,0.011,9.9,214,251,388,427,331,431,0.71,37,39,100
OceanDNA-b23344,1221,15.7,0.1,3.8e-07,0.00073,69,186,77,198,25,233,0.71,117,121,208
OceanDNA-b41451,1294,27.0,0.0,2.7e-10,2e-07,57,209,107,275,102,284,0.71,152,168,182
OceanDNA-b33307,615,10.0,0.0,2.2e-05,0.07,60,152,82,175,63,188,0.71,92,93,125
OceanDNA-b41690,180,11.1,0.0,9.7e-06,0.0022,47,151,47,162,22,169,0.71,104,115,147
OceanDNA-b46839,520,10.7,0.0,2.7e-05,0.017,112,176,158,224,142,264,0.71,64,66,122
OceanDNA-b23549,1740,5.7,0.0,0.0013,0.85,116,147,72,105,50,131,0.7,31,33,81
OceanDNA-b23308,398,12.1,0.0,5.1e-06,0.015,69,149,61,140,14,143,0.7,80,79,129
OceanDNA-b45499,524,7.0,0.1,0.00018,0.21,122,154,126,158,18,166,0.7,32,32,148
OceanDNA-b27525,1050,21.6,0.1,2.4e-08,1.6e-05,54,151,207,316,201,325,0.7,97,109,124
OceanDNA-b28083,1033,12.4,0.1,8e-06,0.0069,53,161,35,149,6,167,0.7,108,114,161
OceanDNA-b33192,357,15.2,0.0,1.1e-06,0.00024,39,156,43,171,20,177,0.7,117,128,157
OceanDNA-b16165,665,-3.1,0.0,0.21,190.0,167,229,329,391,326,393,0.7,62,62,67
OceanDNA-b37083,540,1.2,0.0,0.01,7.0,146,193,295,348,281,368,0.7,47,53,87
OceanDNA-b38062,924,0.1,0.0,0.022,20.0,105,154,84,133,75,151,0.7,49,49,76
OceanDNA-b36441,360,12.8,0.0,5.9e-06,0.0082,66,145,133,211,94,223,0.7,79,78,129
OceanDNA-b45584,658,-1.9,0.0,0.091,120.0,38,68,34,64,14,72,0.7,30,30,58
OceanDNA-b20097,224,40.0,0.0,4.4e-14,4.4e-12,34,246,76,315,56,322,0.7,212,239,266
OceanDNA-b17248,509,-3.2,0.0,0.22,120.0,54,69,231,246,228,302,0.7,15,15,74
OceanDNA-b17633,332,-3.1,0.0,0.22,160.0,124,146,109,131,99,136,0.7,22,22,37
OceanDNA-b22478,650,17.0,0.0,3.2e-07,0.00037,117,212,225,322,196,365,0.7,95,97,169
OceanDNA-b10418,245,10.9,0.0,1.1e-05,0.0031,115,197,139,222,117,242,0.7,82,83,125
OceanDNA-b1522,281,11.5,0.0,1.5e-05,0.0074,103,150,101,147,46,154,0.7,47,46,108
OceanDNA-b17056,36,6.3,0.0,0.00029,0.081,51,112,36,101,29,116,0.7,61,65,87
OceanDNA-b36733,1175,13.7,0.0,1.6e-06,0.0033,67,177,110,230,83,283,0.7,110,120,200
OceanDNA-b16187,169,10.6,0.0,1.4e-05,0.013,41,146,238,361,211,366,0.7,105,123,155
OceanDNA-b3199,754,18.8,0.0,4.3e-08,8.3e-05,66,155,48,148,27,183,0.7,89,100,156
OceanDNA-b3419,139,8.6,0.0,5.6e-05,0.076,116,141,110,135,49,143,0.7,25,25,94
OceanDNA-b40920,808,18.2,0.4,7e-08,8.7e-05,40,209,101,286,64,289,0.7,169,185,225
OceanDNA-b33298,1568,6.8,0.2,0.00021,0.4,100,152,99,149,65,196,0.7,52,50,131
OceanDNA-b45094,335,12.2,0.0,4.7e-06,0.0045,49,170,33,166,5,200,0.7,121,133,195
OceanDNA-b40613,87,11.3,0.0,2.7e-05,0.0068,104,149,121,166,35,178,0.7,45,45,143
OceanDNA-b45818,450,11.5,0.0,3.8e-05,0.011,72,146,567,649,552,660,0.7,74,82,108
OceanDNA-b28262,307,9.8,0.0,2.6e-05,0.013,157,187,195,224,173,266,0.7,30,29,93
OceanDNA-b41226,83,26.6,0.0,1.8e-10,3.4e-07,58,214,83,239,43,272,0.7,156,156,229
OceanDNA-b34551,738,25.6,0.2,1.1e-09,3.2e-07,45,139,113,218,78,236,0.7,94,105,158
OceanDNA-b40245,298,14.9,0.0,2.1e-06,0.00052,45,161,49,170,27,175,0.7,116,121,148
OceanDNA-b23530,1318,12.5,0.0,3.7e-06,0.0075,64,149,455,546,446,556,0.7,85,91,110
OceanDNA-b4488,407,6.2,0.0,0.00092,0.82,159,193,208,241,196,264,0.7,34,33,68
OceanDNA-b42536,241,10.6,0.0,1.5e-05,0.0043,67,146,61,138,30,143,0.7,79,77,113
OceanDNA-b7448,59,7.7,0.0,0.00011,0.072,71,150,56,134,25,151,0.7,79,78,126
OceanDNA-b44368,64,-3.7,0.0,0.32,72.0,220,229,116,125,108,135,0.7,9,9,27
OceanDNA-b9151,162,0.7,0.0,0.015,4.7,144,215,267,344,250,363,0.7,71,77,113
OceanDNA-b6505,278,9.8,0.0,2.5e-05,0.02,71,152,50,130,19,141,0.7,81,80,122
OceanDNA-b41587,636,17.9,0.0,1.7e-07,5.6e-05,75,153,191,273,179,294,0.7,78,82,115
OceanDNA-b31076,1192,6.2,0.0,0.00092,0.91,132,213,315,394,306,408,0.7,81,79,102
OceanDNA-b20946,2606,16.1,0.1,2.9e-07,0.0012,88,141,120,171,113,172,0.7,53,51,59
OceanDNA-b22513,1659,-4.0,0.1,0.8,1100.0,116,162,110,156,104,157,0.7,46,46,53
OceanDNA-b30640,386,12.3,0.2,4.2e-06,0.0053,103,148,77,120,27,136,0.7,45,43,109
OceanDNA-b21013,3975,16.6,0.0,2.1e-07,0.00083,70,193,118,250,96,292,0.7,123,132,196
OceanDNA-b36587,1116,8.1,0.0,8.1e-05,0.14,31,143,58,175,40,189,0.7,112,117,149
OceanDNA-b22616,3382,13.8,0.0,2.9e-06,0.0064,93,181,357,446,348,455,0.7,88,89,107
OceanDNA-b28111,1558,14.7,0.1,7.9e-07,0.0016,70,162,73,168,9,176,0.7,92,95,167
OceanDNA-b13590,1844,22.8,0.0,7.9e-09,7.6e-06,74,210,106,251,76,264,0.7,136,145,188
OceanDNA-b17591,1464,-1.3,0.0,0.058,94.0,9,74,57,125,49,139,0.7,65,68,90
OceanDNA-b10020,85,6.5,0.0,0.00051,0.13,68,150,60,141,34,158,0.7,82,81,124
OceanDNA-b26893,2504,-3.0,0.0,0.39,650.0,59,94,69,107,62,115,0.7,35,38,53
OceanDNA-b27590,561,-2.4,0.0,0.27,310.0,165,188,240,263,237,270,0.7,23,23,33
OceanDNA-b15769,683,12.1,0.0,1.4e-05,0.0083,115,165,164,213,141,283,0.7,50,49,142
OceanDNA-b12642,408,-2.3,0.0,0.12,72.0,186,213,147,174,137,198,0.7,27,27,61
OceanDNA-b19147,46,7.2,0.0,0.00032,0.056,99,155,282,342,266,355,0.7,56,60,89
OceanDNA-b4143,1413,7.3,0.0,0.00042,0.23,57,149,44,137,23,157,0.7,92,93,134
OceanDNA-b5452,195,15.3,0.0,5.1e-07,0.00023,19,158,156,307,140,337,0.7,139,151,197
OceanDNA-b6295,384,-2.5,0.0,0.14,67.0,112,150,378,417,370,429,0.7,38,39,59
OceanDNA-b5446,232,15.0,0.0,6.3e-07,0.00027,20,159,157,308,140,355,0.7,139,151,215
OceanDNA-b20657,149,1.5,0.0,0.017,2.7,157,208,179,228,166,248,0.7,51,49,82
OceanDNA-b30157,926,13.9,0.2,1.3e-06,0.0028,60,161,56,162,42,169,0.7,101,106,127
OceanDNA-b26917,1112,8.4,0.0,0.00013,0.1,116,152,112,147,46,167,0.7,36,35,121
OceanDNA-b16213,512,5.2,0.0,0.0012,0.52,144,210,432,501,425,512,0.7,66,69,87
OceanDNA-b23417,1309,-3.7,0.0,0.67,980.0,160,184,666,690,660,730,0.7,24,24,70
OceanDNA-b44627,225,7.2,0.1,0.00045,0.14,161,186,199,223,132,243,0.7,25,24,111
OceanDNA-b7584,366,-3.1,0.0,0.21,80.0,35,53,57,77,53,102,0.7,18,20,49
OceanDNA-b18804,177,19.3,0.0,3.2e-08,1e-05,115,169,153,209,120,250,0.7,54,56,130
OceanDNA-b23524,1285,13.8,0.0,4.6e-06,0.0022,48,167,54,176,36,200,0.7,119,122,164
OceanDNA-b23324,307,4.5,0.0,0.001,0.38,163,234,200,269,183,292,0.7,71,69,109
OceanDNA-b8408,166,-1.4,0.0,0.065,13.0,112,153,515,556,503,565,0.7,41,41,62
OceanDNA-b21144,22,15.4,0.0,4.8e-07,0.00021,116,227,129,242,70,254,0.7,111,113,184
OceanDNA-b36071,125,13.1,0.0,2.4e-06,0.005,59,153,47,142,11,158,0.7,94,95,147
OceanDNA-b6427,652,10.0,0.0,2.1e-05,0.017,21,152,190,333,183,339,0.7,131,143,156
OceanDNA-b34951,651,-0.8,0.0,0.043,31.0,118,150,355,387,340,399,0.7,32,32,59
OceanDNA-b45239,1260,10.9,0.0,1.1e-05,0.028,109,154,175,222,111,234,0.7,45,47,123
OceanDNA-b22965,2488,-3.5,0.0,0.57,1300.0,39,75,464,504,457,517,0.7,36,40,60
OceanDNA-b21048,591,-3.7,0.0,0.65,570.0,19,46,19,42,17,46,0.7,27,23,29
OceanDNA-b401,790,11.8,0.2,1.2e-05,0.0058,59,141,145,230,130,248,0.7,82,85,118
OceanDNA-b23145,632,21.3,0.0,1.5e-08,1.6e-05,118,184,154,224,140,259,0.7,66,70,119
OceanDNA-b40250,21,18.9,0.1,8.4e-08,3e-05,40,137,96,204,88,280,0.7,97,108,192
OceanDNA-b6844,273,13.3,0.0,2.1e-06,0.0021,106,148,125,166,94,190,0.7,42,41,96
OceanDNA-b40593,473,11.3,0.0,8.8e-06,0.0045,69,137,6,85,3,94,0.7,68,79,91
OceanDNA-b31270,1011,5.1,0.0,0.0013,1.5,175,248,268,340,248,347,0.7,73,72,99
OceanDNA-b6704,841,13.9,0.0,2.8e-06,0.0012,66,177,120,240,84,258,0.7,111,120,174
OceanDNA-b19229,137,21.7,0.0,5.8e-09,1.9e-06,100,182,132,215,76,249,0.7,82,83,173
OceanDNA-b39096,2190,16.8,0.0,1.8e-07,0.00042,70,184,61,189,28,229,0.7,114,128,201
OceanDNA-b16135,213,18.2,0.1,1.4e-07,6.3e-05,96,146,325,377,249,385,0.7,50,52,136
OceanDNA-b16147,423,14.9,0.0,1.4e-06,0.00049,43,145,229,350,220,356,0.7,102,121,136
OceanDNA-b20907,2112,23.9,1.1,1.2e-09,6.5e-06,74,193,198,329,171,349,0.7,119,131,178
OceanDNA-b32757,170,-0.4,0.0,0.031,15.0,164,186,295,317,286,349,0.7,22,22,63
OceanDNA-b35314,474,22.0,0.0,4.8e-09,5.1e-06,50,153,31,149,13,153,0.7,103,118,140
OceanDNA-b26756,121,-2.6,0.0,0.15,200.0,55,86,50,84,35,87,0.7,31,34,52
OceanDNA-b40467,684,11.2,0.1,2.8e-05,0.015,32,139,12,120,6,134,0.7,107,108,128
OceanDNA-b23102,319,13.1,0.1,2.4e-06,0.006,50,153,63,171,53,191,0.7,103,108,138
OceanDNA-b40265,482,3.8,0.0,0.0034,1.6,145,193,298,352,288,375,0.7,48,54,87
OceanDNA-b16215,845,12.3,0.0,8.5e-06,0.005,71,140,112,188,65,192,0.7,69,76,127
OceanDNA-b17212,4055,16.5,0.1,2.3e-07,0.00094,146,208,63,128,43,142,0.7,62,65,99
OceanDNA-b32139,30,8.9,0.7,9e-05,0.11,59,152,72,166,46,177,0.7,93,94,131
OceanDNA-b8205,133,8.9,0.0,4.5e-05,0.01,74,162,342,438,339,443,0.7,88,96,104
OceanDNA-b15879,188,10.5,0.0,3.1e-05,0.027,116,167,153,203,133,269,0.7,51,50,136
OceanDNA-b26737,1759,7.1,0.1,0.00032,0.38,60,150,54,145,19,165,0.7,90,91,146
OceanDNA-b6298,94,18.0,0.0,1.6e-07,3.3e-05,52,178,104,240,80,258,0.69,126,136,178
OceanDNA-b23624,2259,17.5,0.0,1.1e-07,0.00026,73,179,130,246,111,299,0.69,106,116,188
OceanDNA-b29209,436,11.3,0.0,8.4e-06,0.0048,47,160,147,259,131,272,0.69,113,112,141
OceanDNA-b35437,210,19.4,0.0,2.9e-08,7.5e-06,35,212,22,212,8,226,0.69,177,190,218
OceanDNA-b35159,1207,12.9,0.0,5.6e-06,0.0048,58,153,44,148,33,176,0.69,95,104,143
OceanDNA-b6574,401,10.4,0.0,3.2e-05,0.014,56,145,16,100,11,110,0.69,89,84,99
OceanDNA-b332,28,17.7,0.4,9.4e-08,7.3e-05,48,153,34,136,5,142,0.69,105,102,137
OceanDNA-b34949,288,-2.3,0.0,0.37,120.0,117,150,527,560,514,570,0.69,33,33,56
OceanDNA-b40768,273,14.8,0.0,1.5e-06,0.00048,28,149,37,174,28,205,0.69,121,137,177
OceanDNA-b25157,87,-0.1,0.0,0.025,5.4,159,205,253,296,233,309,0.69,46,43,76
OceanDNA-b31687,6,-0.6,0.0,0.037,100.0,70,94,87,113,76,167,0.69,24,26,91
OceanDNA-b17248,509,13.4,0.0,1.9e-06,0.001,119,202,649,744,617,762,0.69,83,95,145
OceanDNA-b4022,924,-2.6,0.0,0.3,190.0,162,193,242,272,225,295,0.69,31,30,70
OceanDNA-b26685,1657,12.7,0.0,3.2e-06,0.0079,42,141,55,156,32,164,0.69,99,101,132
OceanDNA-b46513,458,10.8,0.0,2.5e-05,0.0073,103,181,113,194,99,206,0.69,78,81,107
OceanDNA-b36934,678,-1.5,0.0,0.071,71.0,152,180,342,371,329,397,0.69,28,29,68
OceanDNA-b46964,505,16.9,0.0,1.6e-07,0.00012,113,192,149,239,135,275,0.69,79,90,140
OceanDNA-b20756,163,47.8,0.0,6.1e-17,1.8e-14,37,246,96,331,74,339,0.69,209,235,265
OceanDNA-b4498,1017,4.1,0.0,0.0041,1.4,140,208,290,363,262,376,0.69,68,73,114
OceanDNA-b32606,3261,6.1,0.0,0.00033,1.5,154,208,261,318,239,328,0.69,54,57,89
OceanDNA-b4064,464,11.6,0.0,2.1e-05,0.0072,40,136,277,392,275,402,0.69,96,115,127
OceanDNA-b41030,800,31.1,0.1,2.4e-11,2e-08,40,227,67,258,42,274,0.69,187,191,232
OceanDNA-b23367,1849,-1.9,0.0,0.093,190.0,59,94,268,306,253,314,0.69,35,38,61
OceanDNA-b30842,113,-0.5,0.0,0.034,19.0,59,99,60,104,54,124,0.69,40,44,70
OceanDNA-b6783,384,12.5,0.0,3.7e-06,0.0017,55,147,18,105,4,117,0.69,92,87,113
OceanDNA-b9151,162,28.1,0.0,6.5e-11,2e-08,43,146,121,235,84,254,0.69,103,114,170
OceanDNA-b42522,247,15.5,0.0,4.5e-07,0.00014,118,208,153,247,123,265,0.69,90,94,142
OceanDNA-b37652,816,-1.3,0.0,0.061,77.0,102,148,15,63,10,78,0.69,46,48,68
OceanDNA-b32734,108,12.3,0.1,4.2e-06,0.0016,103,197,69,169,60,179,0.69,94,100,119
OceanDNA-b17766,436,9.5,2.4,3e-05,0.14,110,142,30,63,11,74,0.69,32,33,63
OceanDNA-b42542,274,13.2,0.0,2.2e-06,0.00063,53,180,31,171,15,188,0.69,127,140,173
OceanDNA-b1435,497,12.6,0.0,6.8e-06,0.0028,62,150,46,133,39,145,0.69,88,87,106
OceanDNA-b45703,674,16.8,0.0,1.8e-07,0.00013,122,232,179,300,174,302,0.69,110,121,128
OceanDNA-b31945,387,12.3,0.0,4.3e-06,0.008,56,153,45,143,11,153,0.69,97,98,142
OceanDNA-b30138,3515,10.4,0.1,1.6e-05,0.057,58,150,194,279,153,337,0.69,92,85,184
OceanDNA-b41418,435,11.6,0.0,6.8e-06,0.0059,96,150,83,141,26,167,0.69,54,58,141
OceanDNA-b17563,890,1.3,0.0,0.02,22.0,111,154,547,591,538,602,0.69,43,44,64
OceanDNA-b32865,275,15.1,0.0,5.8e-07,0.0003,74,207,66,204,43,223,0.69,133,138,180
OceanDNA-b44627,133,-1.5,0.0,0.21,64.0,58,87,60,92,40,101,0.69,29,32,61
OceanDNA-b11392,106,14.1,0.0,1.2e-06,0.00059,43,154,23,151,20,162,0.69,111,128,142
OceanDNA-b17572,742,8.3,0.0,7.2e-05,0.069,144,230,71,157,65,161,0.69,86,86,96
OceanDNA-b36456,1321,6.6,0.0,0.00023,0.51,38,144,64,174,40,186,0.69,106,110,146
OceanDNA-b43986,170,7.0,0.6,0.00018,0.045,91,140,143,194,71,202,0.69,49,51,131
OceanDNA-b18519,79,-2.1,0.0,0.32,33.0,105,152,522,569,518,581,0.69,47,47,63
OceanDNA-b1347,737,28.9,0.1,7.6e-11,5.5e-08,48,208,190,364,180,383,0.69,160,174,203
OceanDNA-b39,2116,-3.0,0.0,0.4,1400.0,205,230,328,355,325,355,0.69,25,27,30
OceanDNA-b46933,2408,21.1,0.0,1.8e-08,3.5e-05,114,174,244,307,231,368,0.69,60,63,137
OceanDNA-b9009,59,5.3,0.0,0.0012,0.13,100,154,523,571,483,583,0.69,54,48,100
OceanDNA-b41304,3569,14.1,0.0,1.2e-06,0.0049,98,154,199,251,104,280,0.69,56,52,176
OceanDNA-b41211,1622,23.5,0.0,1.7e-09,3.3e-06,57,230,113,286,73,300,0.69,173,173,227
OceanDNA-b34562,134,15.3,0.0,5.3e-07,0.00038,85,152,130,200,90,211,0.69,67,70,121
OceanDNA-b34217,652,16.2,0.0,2.8e-07,0.00037,113,158,69,114,5,123,0.69,45,45,118
OceanDNA-b34562,134,0.6,0.0,0.015,11.0,132,198,262,332,252,354,0.69,66,70,102
OceanDNA-b31695,307,-0.4,0.0,0.031,58.0,161,210,621,671,613,677,0.69,49,50,64
OceanDNA-b3613,1182,11.7,0.0,6.5e-06,0.0083,115,152,260,298,150,304,0.69,37,38,154
OceanDNA-b43987,64,14.9,0.0,1.4e-06,0.00016,38,138,84,196,78,202,0.69,100,112,124
OceanDNA-b26843,1077,0.3,0.0,0.039,54.0,169,229,178,236,161,245,0.69,60,58,84
OceanDNA-b3242,329,-0.8,0.0,0.042,35.0,168,200,14,48,4,54,0.69,32,34,50
OceanDNA-b32985,1105,12.0,0.0,5.3e-06,0.019,52,183,60,202,31,233,0.69,131,142,202
OceanDNA-b394,393,15.8,0.0,3.8e-07,0.00038,102,155,183,238,83,266,0.69,53,55,183
OceanDNA-b19686,2,53.9,0.0,1.7e-18,3.9e-16,30,247,79,330,63,337,0.69,217,251,274
OceanDNA-b17610,1895,13.2,0.1,2.3e-06,0.0088,112,151,212,250,158,262,0.69,39,38,104
OceanDNA-b466,148,5.5,0.0,0.0015,1.5,157,185,269,296,217,326,0.69,28,27,109
OceanDNA-b4346,139,-3.6,0.0,0.62,77.0,119,151,354,386,352,396,0.69,32,32,44
OceanDNA-b20895,1799,25.4,0.1,4.3e-10,1.7e-06,72,174,163,279,157,369,0.69,102,116,212
OceanDNA-b40624,223,30.6,0.1,2.3e-11,1.1e-08,31,209,87,280,47,286,0.69,178,193,239
OceanDNA-b28146,1182,9.8,0.2,2.5e-05,0.046,122,161,88,129,19,134,0.69,39,41,115
OceanDNA-b35378,46,12.4,0.1,4.1e-06,0.0068,57,159,39,142,14,150,0.69,102,103,136
OceanDNA-b13674,206,4.1,0.0,0.0014,0.31,21,86,55,124,43,130,0.69,65,69,87
OceanDNA-b16140,405,10.0,0.1,4.2e-05,0.019,145,198,420,476,410,512,0.69,53,56,102
OceanDNA-b16143,19,0.4,0.0,0.037,16.0,144,210,414,483,406,493,0.69,66,69,87
OceanDNA-b35991,369,17.7,0.0,9.7e-08,4.3e-05,42,180,104,244,82,289,0.69,138,140,207
OceanDNA-b3647,588,12.4,0.0,4e-06,0.0036,67,178,110,231,78,285,0.69,111,121,207
OceanDNA-b16143,250,20.1,0.0,3.6e-08,1.5e-05,53,143,239,348,224,357,0.69,90,109,133
OceanDNA-b44435,2563,0.4,0.0,0.036,47.0,110,154,386,431,374,446,0.69,44,45,72
OceanDNA-b21004,1525,3.0,0.1,0.0089,5.7,126,169,99,149,74,163,0.69,43,50,89
OceanDNA-b18515,271,13.9,0.0,1.4e-06,0.00061,107,178,48,127,33,174,0.69,71,79,141
OceanDNA-b26636,3711,13.8,0.0,1.5e-06,0.0059,44,98,72,129,53,153,0.69,54,57,100
OceanDNA-b3329,1290,11.7,0.3,6.5e-06,0.014,54,159,89,192,77,206,0.69,105,103,129
OceanDNA-b41526,837,24.3,0.0,1.9e-09,1.1e-06,42,185,84,247,80,270,0.69,143,163,190
OceanDNA-b19120,201,18.2,0.0,1.4e-07,2.2e-05,62,153,58,159,19,178,0.69,91,101,159
OceanDNA-b36415,378,5.6,0.1,0.00048,0.75,157,187,240,270,198,283,0.69,30,30,85
OceanDNA-b34885,288,11.2,0.0,9.1e-06,0.0064,90,148,48,107,38,125,0.69,58,59,87
OceanDNA-b30483,397,-0.8,0.0,0.044,110.0,169,229,199,257,168,259,0.69,60,58,91
OceanDNA-b36083,1746,9.6,0.4,2.9e-05,0.055,120,155,106,141,25,144,0.69,35,35,119
OceanDNA-b12909,177,19.6,0.0,2.6e-08,1.6e-05,81,166,103,189,71,225,0.69,85,86,154
OceanDNA-b15516,151,3.4,0.1,0.0022,1.9,124,152,102,131,91,150,0.69,28,29,59
OceanDNA-b26901,3435,8.0,0.1,0.00018,0.34,97,152,113,166,65,181,0.69,55,53,116
OceanDNA-b27545,1368,11.4,0.0,8.2e-06,0.018,60,161,41,147,6,155,0.69,101,106,149
OceanDNA-b24219,68,14.2,0.1,1.1e-06,0.0013,44,140,58,168,53,193,0.69,96,110,140
OceanDNA-b34653,194,10.0,0.0,2.1e-05,0.016,68,147,429,514,412,524,0.69,79,85,112
OceanDNA-b24286,2219,7.9,0.0,9.2e-05,0.3,53,106,64,124,50,265,0.69,53,60,215
OceanDNA-b4116,268,-0.9,0.0,0.045,30.0,154,199,231,278,176,292,0.69,45,47,116
OceanDNA-b37918,608,-0.6,0.0,0.074,28.0,111,154,134,178,125,191,0.69,43,44,66
OceanDNA-b17609,3614,13.3,0.1,2.1e-06,0.0099,71,150,150,238,143,253,0.69,79,88,110
OceanDNA-b3338,1288,11.9,0.5,1.1e-05,0.02,49,150,43,142,33,159,0.69,101,99,126
OceanDNA-b46299,334,11.6,0.1,2.2e-05,0.036,40,136,88,190,66,202,0.69,96,102,136
OceanDNA-b22448,1490,-2.4,0.0,0.13,210.0,130,146,181,197,170,227,0.69,16,16,57
OceanDNA-b3712,1818,15.2,0.0,1.1e-06,0.0012,39,147,139,261,129,271,0.69,108,122,142
OceanDNA-b33558,772,-2.8,0.0,0.34,150.0,150,171,171,192,155,202,0.68,21,21,47
OceanDNA-b34767,496,-3.9,0.0,0.77,350.0,167,191,228,251,225,262,0.68,24,23,37
OceanDNA-b45663,568,13.8,0.0,2.9e-06,0.0013,67,161,51,143,22,147,0.68,94,92,125
OceanDNA-b46208,180,11.0,0.0,2.2e-05,0.011,113,160,89,136,20,142,0.68,47,47,122
OceanDNA-b6501,215,-2.8,0.0,0.5,86.0,115,152,528,565,515,573,0.68,37,37,58
OceanDNA-b22755,517,11.4,0.0,7.9e-06,0.0069,117,208,558,653,534,663,0.68,91,95,129
OceanDNA-b4064,777,17.5,0.0,3.4e-07,0.00012,54,210,71,240,36,263,0.68,156,169,227
OceanDNA-b2592,2047,-2.5,0.0,0.14,370.0,29,63,67,106,52,128,0.68,34,39,76
OceanDNA-b30854,1685,1.3,0.0,0.02,22.0,157,209,250,300,220,310,0.68,52,50,90
OceanDNA-b40245,290,23.5,0.2,5e-09,1.2e-06,40,176,96,250,91,273,0.68,136,154,182
OceanDNA-b16213,176,11.4,0.0,1.6e-05,0.0066,70,139,113,189,59,199,0.68,69,76,140
OceanDNA-b27535,1573,4.2,0.1,0.0013,3.0,195,246,254,304,219,312,0.68,51,50,93
OceanDNA-b15118,491,11.1,0.0,1e-05,0.0067,68,154,83,184,33,201,0.68,86,101,168
OceanDNA-b44440,1094,-0.1,0.0,0.026,62.0,111,154,545,589,534,604,0.68,43,44,70
OceanDNA-b38325,1042,13.8,0.0,1.5e-06,0.0024,59,165,71,181,32,202,0.68,106,110,170
OceanDNA-b314,121,28.0,1.3,7e-11,5.9e-08,34,182,89,262,73,277,0.68,148,173,204
OceanDNA-b23843,2041,-1.8,0.0,0.087,200.0,42,87,57,105,27,119,0.68,45,48,92
OceanDNA-b16777,43,10.9,0.0,3.4e-05,0.034,99,166,450,515,394,525,0.68,67,65,131
OceanDNA-b17032,419,-0.7,0.0,0.039,53.0,161,216,217,270,198,282,0.68,55,53,84
OceanDNA-b114,76,-0.4,0.0,0.033,15.0,163,187,471,494,452,522,0.68,24,23,70
OceanDNA-b21018,732,2.1,0.0,0.0057,19.0,152,193,239,279,226,306,0.68,41,40,80
OceanDNA-b46970,55,13.0,0.0,5.1e-06,0.0021,14,137,57,186,47,196,0.68,123,129,149
OceanDNA-b723,366,14.0,0.2,1.3e-06,0.00064,45,178,77,216,67,241,0.68,133,139,174
OceanDNA-b21019,1371,-3.6,0.0,0.3,900.0,153,176,226,249,219,265,0.68,23,23,46
OceanDNA-b6750,437,9.7,0.0,7.9e-05,0.019,75,150,3,77,1,95,0.68,75,74,94
OceanDNA-b13674,206,-3.5,0.0,0.29,65.0,175,194,279,297,267,300,0.68,19,18,33
OceanDNA-b5215,68,-2.6,0.0,0.15,43.0,162,179,204,221,196,242,0.68,17,17,46
OceanDNA-b37529,835,21.6,0.1,6.4e-09,1.3e-05,39,193,82,258,57,280,0.68,154,176,223
OceanDNA-b16227,471,3.6,0.0,0.0056,2.0,158,188,472,503,450,531,0.68,30,31,81
OceanDNA-a3040,26,13.0,0.0,2.6e-06,0.002,53,157,97,203,87,216,0.68,104,106,129
OceanDNA-b3927,27,13.3,0.0,2.2e-06,0.0026,113,185,144,225,110,239,0.68,72,81,129
OceanDNA-b40445,1103,-1.9,0.0,0.09,150.0,229,244,220,239,169,247,0.68,15,19,78
OceanDNA-b27536,721,2.9,0.0,0.0032,5.4,137,183,264,316,252,348,0.68,46,52,96
OceanDNA-b31170,1207,7.6,0.0,0.00012,0.15,93,143,49,104,9,120,0.68,50,55,111
OceanDNA-b42533,111,12.8,0.0,3e-06,0.00065,57,139,54,135,26,146,0.68,82,81,120
OceanDNA-b30849,481,0.8,0.0,0.014,14.0,192,229,219,257,182,266,0.68,37,38,84
OceanDNA-b22407,1618,-2.6,0.0,0.15,440.0,18,57,135,173,126,186,0.68,39,38,60
OceanDNA-b23369,1029,11.0,0.1,1.1e-05,0.022,75,147,130,201,97,214,0.68,72,71,117
OceanDNA-b23396,1251,-0.8,0.0,0.084,86.0,159,187,266,294,227,298,0.68,28,28,71
OceanDNA-b17091,323,14.9,0.0,1.4e-06,0.00076,66,156,44,143,11,217,0.68,90,99,206
OceanDNA-b26917,1026,10.7,0.2,2.7e-05,0.021,40,142,50,155,16,225,0.68,102,105,209
OceanDNA-b22548,674,10.3,0.0,5.4e-05,0.023,75,152,519,596,508,664,0.68,77,77,156
OceanDNA-b34854,147,-2.0,0.0,0.097,59.0,105,149,519,563,478,585,0.68,44,44,107
OceanDNA-b40634,229,32.5,0.0,2.9e-12,2.3e-09,26,209,77,275,68,280,0.68,183,198,212
OceanDNA-b740,193,15.0,0.2,6.4e-07,0.0003,50,180,142,277,128,305,0.68,130,135,177
OceanDNA-b36405,186,-2.0,0.0,0.1,43.0,74,92,75,93,54,102,0.68,18,18,48
OceanDNA-b3869,277,15.0,0.0,6.3e-07,0.00037,103,212,140,253,93,268,0.68,109,113,175
OceanDNA-b2854,2986,11.5,0.1,2.3e-05,0.027,76,152,72,144,47,169,0.68,76,72,122
OceanDNA-b9010,182,7.5,0.0,0.00012,0.03,105,154,95,145,56,157,0.68,49,50,101
OceanDNA-b38093,297,3.4,0.0,0.0023,2.0,114,150,59,95,9,110,0.68,36,36,101
OceanDNA-b23122,375,-0.6,0.0,0.037,170.0,150,196,107,154,101,158,0.68,46,47,57
OceanDNA-b13088,539,3.2,0.0,0.005,9.2,112,156,522,566,508,584,0.68,44,44,76
OceanDNA-b38548,512,18.8,0.0,4.3e-08,2.7e-05,42,154,20,140,16,156,0.68,112,120,140
OceanDNA-b12697,485,10.5,0.0,3e-05,0.012,72,141,547,622,527,643,0.68,69,75,116
OceanDNA-b46651,780,17.4,0.0,3.7e-07,0.00049,115,208,194,289,167,302,0.68,93,95,135
OceanDNA-b45634,528,0.0,0.0,0.071,17.0,118,161,21,66,7,82,0.68,43,45,75
OceanDNA-b45584,658,-2.0,0.0,0.1,140.0,176,212,221,254,204,263,0.68,36,33,59
OceanDNA-b43873,508,17.9,2.4,8.6e-08,0.0001,33,196,66,225,38,267,0.68,163,159,229
OceanDNA-b20979,1920,9.5,0.1,5.9e-05,0.075,109,142,208,241,126,256,0.68,33,33,130
OceanDNA-b10027,423,6.2,0.0,0.00031,0.17,70,150,54,133,26,151,0.68,80,79,125
OceanDNA-b28110,1919,-0.6,0.0,0.037,85.0,144,181,407,446,392,451,0.68,37,39,59
OceanDNA-b22512,2235,12.2,0.0,9e-06,0.011,118,188,132,209,114,221,0.68,70,77,107
OceanDNA-b46207,101,20.7,0.0,1.2e-08,1.6e-05,118,191,176,251,162,275,0.68,73,75,113
OceanDNA-b34551,215,-1.6,0.0,0.23,67.0,112,153,531,572,519,584,0.68,41,41,65
OceanDNA-b11212,101,10.6,0.0,1.4e-05,0.0055,103,155,163,218,148,223,0.68,52,55,75
OceanDNA-b37094,887,-1.8,0.0,0.083,80.0,114,154,562,602,551,620,0.68,40,40,69
OceanDNA-b27544,463,13.3,0.0,2.2e-06,0.0035,70,161,44,138,5,149,0.68,91,94,144
OceanDNA-b40889,92,-0.5,0.0,0.07,23.0,155,209,280,333,260,341,0.68,54,53,81
OceanDNA-b40171,78,9.4,0.1,3.2e-05,0.015,76,149,175,250,148,257,0.68,73,75,109
OceanDNA-b30748,463,0.4,0.0,0.018,18.0,155,228,304,377,284,387,0.68,73,73,103
OceanDNA-b40889,252,0.1,0.0,0.045,15.0,133,208,251,322,244,334,0.68,75,71,90
OceanDNA-b23289,1196,-3.6,0.1,0.31,560.0,33,48,101,116,87,135,0.68,15,15,48
OceanDNA-b38590,329,2.3,0.0,0.0049,3.4,149,183,225,259,182,283,0.68,34,34,101
OceanDNA-b40552,239,12.0,0.0,1.1e-05,0.0024,56,153,40,150,18,158,0.68,97,110,140
OceanDNA-b35543,165,11.4,0.0,8.3e-06,0.0017,43,212,85,269,81,277,0.68,169,184,196
OceanDNA-b16514,942,3.4,0.0,0.0023,2.3,154,193,367,406,340,445,0.68,39,39,105
OceanDNA-b4022,924,13.7,0.0,3.1e-06,0.0019,33,136,65,175,44,192,0.68,103,110,148
OceanDNA-b38976,762,12.3,0.1,8.7e-06,0.0053,53,153,84,181,54,190,0.68,100,97,136
OceanDNA-b10305,433,-2.3,0.1,0.12,54.0,34,52,92,110,76,123,0.68,18,18,47
OceanDNA-b16510,1060,-1.6,0.0,0.075,100.0,145,188,383,431,376,439,0.68,43,48,63
OceanDNA-b22806,4603,12.3,0.0,1.3e-05,0.02,111,145,250,286,166,299,0.68,34,36,133
OceanDNA-b3323,1598,16.5,0.1,4.6e-07,0.00076,70,150,180,265,134,282,0.68,80,85,148
OceanDNA-b1765,1396,20.9,0.5,1e-08,2.3e-05,47,173,171,302,160,324,0.68,126,131,164
OceanDNA-b40551,104,13.3,0.1,2.1e-06,0.0015,54,150,39,148,29,155,0.68,96,109,126
OceanDNA-b36408,291,10.1,0.0,2e-05,0.045,31,151,58,183,41,191,0.68,120,125,150
OceanDNA-b34946,337,9.4,0.1,3.3e-05,0.023,69,161,70,165,39,170,0.68,92,95,131
OceanDNA-b3712,2033,11.7,0.0,1.3e-05,0.013,74,165,25,123,13,132,0.68,91,98,119
OceanDNA-b36144,1955,13.9,0.2,1.4e-06,0.0035,68,144,159,251,145,291,0.68,76,92,146
OceanDNA-b22078,326,14.1,0.1,1.2e-06,0.0019,111,153,134,176,48,187,0.67,42,42,139
OceanDNA-b25939,345,-0.5,0.0,0.034,14.0,163,228,310,375,300,385,0.67,65,65,85
OceanDNA-b20098,140,38.4,0.0,9.4e-14,1.2e-11,34,241,111,345,91,357,0.67,207,234,266
OceanDNA-b43704,545,4.5,0.0,0.001,1.1,134,186,127,183,121,213,0.67,52,56,92
OceanDNA-b42863,284,8.7,0.0,5.3e-05,0.016,171,252,174,260,160,267,0.67,81,86,107
OceanDNA-b4534,24,17.5,0.0,1.1e-07,4.7e-05,42,150,11,113,5,125,0.67,108,102,120
OceanDNA-b45368,960,12.3,0.0,4.3e-06,0.0055,66,158,87,184,59,191,0.67,92,97,132
OceanDNA-b26879,966,19.5,0.0,2.7e-08,9.3e-05,70,141,83,168,67,176,0.67,71,85,109
OceanDNA-b40889,252,11.2,0.0,1.9e-05,0.0061,77,139,135,193,126,207,0.67,62,58,81
OceanDNA-b3372,1713,16.4,0.0,2.4e-07,0.0008,68,150,204,291,160,308,0.67,82,87,148
OceanDNA-b22397,2136,-0.9,0.0,0.18,120.0,82,115,49,82,41,96,0.67,33,33,55
OceanDNA-b13153,314,-1.1,0.0,0.052,37.0,35,60,16,41,11,67,0.67,25,25,56
OceanDNA-b36666,772,0.6,0.0,0.031,19.0,140,208,21,90,16,103,0.67,68,69,87
OceanDNA-b24045,2236,-1.2,0.0,0.11,140.0,111,157,132,176,125,209,0.67,46,44,84
OceanDNA-b22965,160,-1.1,0.0,0.1,230.0,99,127,288,315,256,319,0.67,28,27,63
OceanDNA-b31523,1127,-2.0,0.0,0.099,150.0,141,178,293,338,284,354,0.67,37,45,70
OceanDNA-b44154,508,-0.8,0.0,0.042,22.0,196,231,220,256,191,272,0.67,35,36,81
OceanDNA-b46812,2392,11.8,0.0,2.4e-05,0.014,106,192,296,387,278,422,0.67,86,91,144
OceanDNA-b23949,1238,12.0,0.1,5.2e-06,0.0094,41,139,93,210,61,221,0.67,98,117,160
OceanDNA-b35076,477,-0.3,0.0,0.062,23.0,116,150,101,135,86,147,0.67,34,34,61
OceanDNA-b3932,662,10.1,0.0,2e-05,0.015,42,141,270,387,265,407,0.67,99,117,142
OceanDNA-a3195,798,12.5,0.0,3.8e-06,0.0044,54,92,123,161,90,226,0.67,38,38,136
OceanDNA-b46050,498,5.1,0.0,0.00065,0.63,71,140,724,794,692,802,0.67,69,70,110
OceanDNA-b3547,369,0.3,0.0,0.02,15.0,152,183,206,241,189,281,0.67,31,35,92
OceanDNA-b26923,1761,1.4,0.0,0.0089,31.0,14,152,309,455,299,468,0.67,138,146,169
OceanDNA-b26917,1026,-1.1,0.0,0.1,82.0,164,223,268,323,263,327,0.67,59,55,64
OceanDNA-b32682,108,29.9,0.1,1.8e-11,3.6e-08,41,211,86,301,60,352,0.67,170,215,292
OceanDNA-b25939,345,9.9,0.0,2.3e-05,0.0095,77,145,184,254,157,279,0.67,68,70,122
OceanDNA-b45279,1373,13.7,0.0,1.6e-06,0.0026,116,182,149,225,142,259,0.67,66,76,117
OceanDNA-b36411,1843,11.3,0.0,2.5e-05,0.017,80,151,148,217,121,226,0.67,71,69,105
OceanDNA-b36303,17,-4.0,0.0,0.41,280.0,58,74,224,240,207,242,0.67,16,16,35
OceanDNA-b36663,634,0.2,0.0,0.02,26.0,143,176,17,51,10,94,0.67,33,34,84
OceanDNA-b5245,47,14.2,0.0,1.1e-06,0.00046,72,160,547,645,519,659,0.67,88,98,140
OceanDNA-b46299,2174,-3.7,0.0,0.97,1600.0,96,128,437,465,425,477,0.67,32,28,52
OceanDNA-b27542,1349,7.6,0.0,0.00036,0.26,71,161,65,158,37,170,0.67,90,93,133
OceanDNA-b46647,1849,12.1,0.0,1e-05,0.011,15,105,255,354,247,389,0.67,90,99,142
OceanDNA-b13256,1037,-2.9,0.0,1.3,370.0,207,243,65,98,45,105,0.67,36,33,60
OceanDNA-b40252,239,19.6,0.2,2.5e-08,2.3e-05,44,161,26,157,13,171,0.67,117,131,158
OceanDNA-b29482,1279,-2.1,0.0,0.11,340.0,142,180,248,292,234,321,0.67,38,44,87
OceanDNA-b269,1108,22.5,0.0,6.8e-09,7e-06,73,208,137,280,128,294,0.67,135,143,166
OceanDNA-b4471,6,18.7,0.0,4.7e-08,1e-05,41,149,212,335,209,358,0.67,108,123,149
OceanDNA-b46303,2029,11.6,0.0,1.4e-05,0.025,42,140,86,190,62,201,0.67,98,104,139
OceanDNA-b13445,179,9.7,0.0,2.7e-05,0.015,122,239,130,249,123,252,0.67,117,119,129
OceanDNA-b34630,690,-1.8,0.0,0.17,79.0,114,154,641,681,626,689,0.67,40,40,63
OceanDNA-b34551,738,-3.0,0.0,0.62,180.0,182,199,20,37,5,72,0.67,17,17,67
OceanDNA-b14328,67,12.5,0.0,3.7e-06,0.0017,113,227,102,215,90,218,0.67,114,113,128
OceanDNA-b21790,8,10.8,0.0,1.3e-05,0.0034,74,157,545,639,532,646,0.67,83,94,114
OceanDNA-b41340,879,11.5,0.0,2.2e-05,0.011,67,149,45,130,2,161,0.67,82,85,159
OceanDNA-b15230,311,14.5,0.0,1.9e-06,0.00044,53,152,31,126,20,132,0.67,99,95,112
OceanDNA-b30927,693,1.4,0.0,0.018,19.0,156,209,223,274,190,285,0.67,53,51,95
OceanDNA-b15711,972,13.8,0.0,3e-06,0.0017,117,174,162,223,150,263,0.67,57,61,113
OceanDNA-b27535,1573,7.7,0.3,0.00011,0.25,116,162,135,183,72,219,0.67,46,48,147
OceanDNA-b5248,272,13.8,0.0,1.5e-06,0.001,72,157,550,645,533,657,0.67,85,95,124
OceanDNA-b25157,87,9.8,0.0,2.5e-05,0.0053,86,150,90,158,77,195,0.67,64,68,118
OceanDNA-b17714,1521,17.6,0.0,1e-07,0.00023,104,179,155,224,141,234,0.67,75,69,93
OceanDNA-b23394,910,-2.5,0.0,0.14,340.0,19,70,296,347,290,355,0.67,51,51,65
OceanDNA-b22882,788,-0.8,0.0,0.043,180.0,90,141,586,641,555,654,0.67,51,55,99
OceanDNA-b46255,1416,11.2,0.2,2.8e-05,0.03,114,161,96,142,19,152,0.67,47,46,133
OceanDNA-b36971,832,14.2,0.1,1.1e-06,0.0011,53,148,69,166,48,183,0.67,95,97,135
OceanDNA-b23150,2605,15.2,0.1,5.6e-07,0.0015,23,142,58,178,49,209,0.67,119,120,160
OceanDNA-b4134,225,15.9,0.0,3.5e-07,0.0003,44,145,266,382,256,389,0.67,101,116,133
OceanDNA-b44609,332,2.9,0.0,0.0032,5.9,164,212,621,669,616,687,0.67,48,48,71
OceanDNA-b45114,282,-0.7,0.0,0.038,44.0,81,95,89,103,62,117,0.67,14,14,55
OceanDNA-b30938,2151,-0.4,0.1,0.096,80.0,21,56,38,74,31,86,0.67,35,36,55
OceanDNA-b11352,456,9.0,0.0,4.3e-05,0.027,56,149,46,140,22,158,0.66,93,94,136
OceanDNA-b327,2001,10.7,0.0,1.4e-05,0.043,72,145,54,126,36,136,0.66,73,72,100
OceanDNA-b45289,7,-0.9,0.0,0.14,120.0,145,209,305,372,299,392,0.66,64,67,93
OceanDNA-b32143,985,11.1,2.6,3e-05,0.021,23,124,24,129,4,153,0.66,101,105,149
OceanDNA-b16210,467,26.2,0.1,5e-10,2.8e-07,43,143,301,422,292,443,0.66,100,121,151
OceanDNA-b45442,215,12.2,0.0,1.4e-05,0.0068,43,158,25,140,16,149,0.66,115,115,133
OceanDNA-b1435,497,-2.1,0.0,0.21,87.0,163,212,239,284,213,300,0.66,49,45,87
OceanDNA-b4007,753,8.1,0.0,8.2e-05,0.085,70,152,62,143,29,159,0.66,82,81,130
OceanDNA-b13250,1327,11.6,0.0,6.8e-05,0.028,64,154,175,268,164,302,0.66,90,93,138
OceanDNA-b4149,154,-0.6,0.0,0.037,47.0,113,154,381,422,368,439,0.66,41,41,71
OceanDNA-b26843,1308,8.8,0.7,0.0001,0.14,96,144,145,191,83,199,0.66,48,46,116
OceanDNA-b30115,454,7.5,0.1,0.00012,0.31,132,210,220,297,212,313,0.66,78,77,101
OceanDNA-b17030,137,12.1,0.0,4.8e-06,0.0018,52,166,29,148,12,200,0.66,114,119,188
OceanDNA-b40257,356,11.9,0.1,5.6e-06,0.0046,14,139,67,213,62,229,0.66,125,146,167
OceanDNA-b23522,1260,11.4,0.0,8.3e-06,0.011,104,168,140,203,104,211,0.66,64,63,107
OceanDNA-b10085,654,15.4,0.0,5e-07,0.00044,118,210,360,454,342,469,0.66,92,94,127
OceanDNA-b723,366,-1.9,0.0,0.09,45.0,159,201,609,650,597,664,0.66,42,41,67
OceanDNA-b36441,2119,12.1,0.0,1e-05,0.014,100,178,154,231,151,278,0.66,78,77,127
OceanDNA-b517,1813,-1.4,0.3,0.066,260.0,110,159,20,73,14,96,0.66,49,53,82
OceanDNA-b33512,2615,-3.3,0.0,0.24,970.0,57,86,77,109,59,113,0.66,29,32,54
OceanDNA-b15138,937,17.9,0.3,1.7e-07,9.2e-05,23,108,5,95,1,154,0.66,85,90,153
OceanDNA-b36430,1104,-2.8,0.0,0.17,360.0,195,210,282,297,256,318,0.66,15,15,62
OceanDNA-b46830,927,-0.6,0.1,0.038,81.0,136,164,27,55,4,71,0.66,28,28,67
OceanDNA-b4251,445,15.4,0.0,4.8e-07,0.00054,44,154,108,223,89,234,0.66,110,115,145
OceanDNA-b30487,2596,14.4,0.1,2e-06,0.0028,51,150,75,182,58,211,0.66,99,107,153
OceanDNA-b21344,633,22.2,0.0,4.1e-09,4.1e-06,75,226,77,243,55,258,0.66,151,166,203
OceanDNA-b2828,3215,12.8,0.0,6.1e-06,0.011,126,210,126,211,115,215,0.66,84,85,100
OceanDNA-b3934,230,8.7,0.0,0.00011,0.039,75,152,56,132,30,145,0.66,77,76,115
OceanDNA-b9447,96,8.3,0.0,7e-05,0.023,42,140,70,175,51,197,0.66,98,105,146
OceanDNA-b35857,444,1.7,0.2,0.0072,3.3,62,140,58,135,48,148,0.66,78,77,100
OceanDNA-b16098,490,-2.3,0.0,0.24,94.0,158,187,248,277,223,301,0.66,29,29,78
OceanDNA-b31229,252,12.0,0.1,1.1e-05,0.0081,50,177,37,177,13,199,0.66,127,140,186
OceanDNA-b27517,135,-0.5,0.0,0.069,150.0,158,195,222,261,191,282,0.66,37,39,91
OceanDNA-b31070,1234,14.5,0.2,3.7e-06,0.0028,45,180,34,186,6,213,0.66,135,152,207
OceanDNA-b20906,284,13.6,0.2,1.7e-06,0.0073,48,142,118,223,109,291,0.66,94,105,182
OceanDNA-b20998,1644,12.3,0.0,4.4e-06,0.017,54,150,152,261,128,274,0.66,96,109,146
OceanDNA-b38369,225,19.9,0.0,2e-08,3.6e-05,48,219,87,272,54,289,0.66,171,185,235
OceanDNA-b41303,5,-3.7,0.1,0.32,920.0,145,169,129,153,120,160,0.66,24,24,40
OceanDNA-b40892,819,15.6,0.1,4.2e-07,0.00049,70,155,48,146,12,173,0.66,85,98,161
OceanDNA-b31152,265,11.1,0.0,2e-05,0.008,33,153,23,149,8,169,0.66,120,126,161
OceanDNA-b29385,2659,-2.0,0.0,0.3,340.0,143,209,471,542,456,546,0.66,66,71,90
OceanDNA-b23261,187,11.4,0.0,1.6e-05,0.019,51,166,51,175,20,197,0.66,115,124,177
OceanDNA-b42995,28,-1.0,0.0,0.048,12.0,61,83,43,65,24,74,0.66,22,22,50
OceanDNA-b36153,427,6.9,0.0,0.00018,0.22,112,160,99,150,36,154,0.66,48,51,118
OceanDNA-b37266,1047,-3.6,0.0,0.31,1100.0,119,154,543,578,525,589,0.66,35,35,64
OceanDNA-b32144,436,-1.6,0.0,0.15,200.0,24,38,249,263,228,288,0.66,14,14,60
OceanDNA-b20950,1951,9.4,0.0,3.3e-05,0.18,115,152,159,196,89,215,0.66,37,37,126
OceanDNA-b40641,871,12.4,0.0,1.5e-05,0.0051,78,182,72,183,66,198,0.66,104,111,132
OceanDNA-b36616,37,13.7,0.6,1.6e-06,0.0047,69,138,167,252,160,284,0.66,69,85,124
OceanDNA-b40641,883,11.2,0.1,3.8e-05,0.013,58,152,54,149,5,171,0.66,94,95,166
OceanDNA-b40467,684,-2.1,0.0,0.31,160.0,216,244,217,249,198,258,0.66,28,32,60
OceanDNA-b34725,188,9.2,0.0,3.8e-05,0.027,40,146,398,514,381,525,0.66,106,116,144
OceanDNA-b31152,265,0.1,0.0,0.046,19.0,165,228,249,314,243,316,0.66,63,65,73
OceanDNA-b3385,1277,12.6,0.0,3.5e-06,0.012,41,156,88,233,85,255,0.65,115,145,170
OceanDNA-b13296,356,13.1,0.0,2.5e-06,0.0025,51,152,163,266,143,272,0.65,101,103,129
OceanDNA-b41553,665,28.4,0.0,5.1e-11,6e-08,93,235,232,391,180,402,0.65,142,159,222
OceanDNA-b22385,2068,-1.9,0.0,0.19,360.0,126,157,105,137,47,144,0.65,31,32,97
OceanDNA-b27549,1961,-0.4,0.0,0.064,68.0,126,149,70,93,7,100,0.65,23,23,93
OceanDNA-b43704,545,8.8,0.2,5.1e-05,0.056,111,149,33,73,2,81,0.65,38,40,79
OceanDNA-b45587,130,9.2,0.0,3.8e-05,0.034,112,154,102,145,22,154,0.65,42,43,132
OceanDNA-b30168,970,15.7,0.0,7.6e-07,0.00058,73,158,143,226,118,254,0.65,85,83,136
OceanDNA-b3912,1924,16.5,0.0,2.2e-07,0.00045,41,143,87,191,66,210,0.65,102,104,144
OceanDNA-b4004,18,7.9,0.0,0.00029,0.11,71,152,6,86,3,107,0.65,81,80,104
OceanDNA-b264,1997,15.3,0.3,5.3e-07,0.0011,21,147,171,312,159,322,0.65,126,141,163
OceanDNA-b22828,2364,-3.1,0.0,0.44,920.0,64,84,287,307,282,312,0.65,20,20,30
OceanDNA-b30021,940,-0.7,0.0,0.039,72.0,102,130,54,82,27,125,0.65,28,28,98
OceanDNA-b6753,128,13.0,0.0,2.6e-06,0.0016,43,141,261,377,257,383,0.65,98,116,126
OceanDNA-b17737,1410,10.7,0.1,1.3e-05,0.045,70,151,228,311,177,318,0.65,81,83,141
OceanDNA-b30206,381,-0.6,0.0,0.071,81.0,139,202,271,339,260,360,0.65,63,68,100
OceanDNA-b44414,115,12.6,0.6,3.5e-06,0.0008,53,208,80,248,48,269,0.65,155,168,221
OceanDNA-b32141,2161,2.1,0.2,0.016,16.0,133,221,252,340,245,349,0.65,88,88,104
OceanDNA-b34544,56,0.3,0.0,0.019,14.0,130,216,218,305,187,314,0.65,86,87,127
OceanDNA-b35110,138,-1.8,0.0,0.18,68.0,111,153,335,378,326,391,0.65,42,43,65
OceanDNA-b23515,852,-0.7,0.0,0.077,48.0,114,150,332,368,319,382,0.65,36,36,63
OceanDNA-b394,393,-1.0,0.0,0.047,48.0,150,174,57,83,30,87,0.65,24,26,57
OceanDNA-b32747,410,4.2,0.0,0.0012,0.58,144,227,285,365,276,368,0.65,83,80,92
OceanDNA-b31270,1011,9.0,0.0,8.8e-05,0.1,70,161,119,213,92,224,0.65,91,94,132
OceanDNA-b32786,574,13.2,0.1,6.9e-06,0.0037,63,152,448,543,387,547,0.65,89,95,160
OceanDNA-b46897,281,-0.5,0.0,0.035,30.0,166,227,254,313,247,316,0.65,61,59,69
OceanDNA-b35314,474,0.5,0.0,0.017,18.0,167,227,198,257,194,260,0.65,60,59,66
OceanDNA-b8547,29,-1.3,0.0,0.062,13.0,116,150,519,553,504,565,0.65,34,34,61
OceanDNA-b23515,852,-1.6,0.1,0.15,92.0,14,57,264,313,258,327,0.65,43,49,69
OceanDNA-b31056,480,12.3,0.1,1.2e-05,0.013,101,156,99,148,10,155,0.65,55,49,145
OceanDNA-b23551,407,10.1,0.0,2e-05,0.029,125,154,131,160,121,210,0.65,29,29,89
OceanDNA-b16141,638,-1.8,0.0,0.088,65.0,187,211,239,264,230,279,0.65,24,25,49
OceanDNA-b45526,124,-3.8,0.0,0.35,120.0,64,79,139,153,126,156,0.65,15,14,30
OceanDNA-b23400,399,-1.1,0.1,0.051,110.0,30,75,228,279,214,309,0.65,45,51,95
OceanDNA-b32135,345,14.7,0.0,8.2e-07,0.0021,71,136,80,159,47,184,0.65,65,79,137
OceanDNA-b35229,353,11.0,0.0,1.1e-05,0.0076,53,152,207,306,187,350,0.65,99,99,163
OceanDNA-b3144,1036,13.8,0.0,1.4e-06,0.0019,117,155,185,224,84,235,0.65,38,39,151
OceanDNA-b34300,366,-0.2,0.0,0.055,24.0,116,163,531,575,516,583,0.65,47,44,67
OceanDNA-b26870,727,15.6,0.3,4.1e-07,0.0012,49,140,138,240,131,249,0.65,91,102,118
OceanDNA-b41267,1339,-3.1,0.0,0.21,650.0,159,176,272,290,234,302,0.65,17,18,68
OceanDNA-b27525,756,10.4,0.4,6.3e-05,0.042,125,173,177,219,103,258,0.65,48,42,155
OceanDNA-b22518,396,9.4,0.1,3.3e-05,0.12,116,156,259,299,179,306,0.65,40,40,127
OceanDNA-b45442,635,12.5,0.0,1.1e-05,0.0055,29,143,15,135,9,146,0.65,114,120,137
OceanDNA-b46258,827,12.8,0.0,3e-06,0.004,24,162,84,230,70,251,0.64,138,146,181
OceanDNA-b3301,2382,10.8,0.0,1.2e-05,0.034,74,150,294,378,246,391,0.64,76,84,145
OceanDNA-b23400,399,0.1,0.1,0.022,48.0,138,211,272,347,265,362,0.64,73,75,97
OceanDNA-b24591,1677,-0.5,0.0,0.035,96.0,40,86,42,94,4,100,0.64,46,52,96
OceanDNA-b45518,29,10.9,0.0,2.3e-05,0.018,69,152,157,249,93,257,0.64,83,92,164
OceanDNA-b21004,1385,8.6,0.0,0.00017,0.11,54,149,163,269,148,286,0.64,95,106,138
OceanDNA-b35009,27,-1.7,0.0,0.078,64.0,111,149,533,571,485,592,0.64,38,38,107
OceanDNA-b29538,190,-2.5,0.0,0.14,280.0,62,231,229,242,205,248,0.64,169,13,43
OceanDNA-b16121,452,12.1,0.0,4.9e-06,0.0038,54,147,262,375,247,391,0.64,93,113,144
OceanDNA-b16140,405,12.9,0.0,5.7e-06,0.0026,52,143,269,380,241,411,0.64,91,111,170
OceanDNA-b18519,306,-2.5,0.0,0.41,42.0,29,52,230,253,224,287,0.64,23,23,63
OceanDNA-b50,2159,-1.7,0.0,0.081,210.0,65,87,166,188,104,192,0.64,22,22,88
OceanDNA-b9532,299,11.4,0.0,1.6e-05,0.0024,40,162,211,348,209,358,0.64,122,137,149
OceanDNA-b10381,264,-1.7,0.0,0.079,28.0,116,150,318,352,269,371,0.64,34,34,102
OceanDNA-b34087,371,5.1,0.0,0.00069,0.34,58,147,40,130,23,138,0.64,89,90,115
OceanDNA-b7475,556,11.5,0.0,7.6e-06,0.0046,99,157,67,130,36,139,0.64,58,63,103
OceanDNA-b36140,2310,0.5,0.0,0.018,49.0,107,150,563,600,542,614,0.64,43,37,72
OceanDNA-b5161,252,15.0,0.0,6.2e-07,0.00017,42,150,28,153,24,162,0.64,108,125,138
OceanDNA-b44390,296,-2.4,0.0,0.27,93.0,168,193,242,266,238,303,0.64,25,24,65
OceanDNA-b24066,1419,14.0,0.0,1.3e-06,0.0042,103,153,221,265,136,270,0.64,50,44,134
OceanDNA-b45554,234,9.1,0.0,7.9e-05,0.024,94,155,103,161,46,170,0.64,61,58,124
OceanDNA-b13256,77,-1.9,0.0,0.65,180.0,59,91,65,101,55,108,0.64,32,36,53
OceanDNA-b46536,1384,-3.5,0.0,0.28,390.0,173,191,355,373,331,385,0.64,18,18,54
OceanDNA-b1347,1187,28.0,0.5,1.4e-10,9.9e-08,49,185,121,286,114,310,0.64,136,165,196
OceanDNA-b44480,233,-2.5,0.0,0.14,49.0,59,91,86,121,67,131,0.64,32,35,64
OceanDNA-b15853,58,8.2,0.0,0.00015,0.14,115,168,150,202,131,277,0.64,53,52,146
OceanDNA-b3978,864,10.8,0.0,1.3e-05,0.012,42,142,61,168,42,186,0.64,100,107,144
OceanDNA-b5500,93,11.6,0.0,7.2e-06,0.0029,105,160,186,246,73,256,0.64,55,60,183
OceanDNA-b23382,1938,-2.9,0.0,0.19,420.0,28,57,51,81,27,90,0.64,29,30,63
OceanDNA-b23055,42,31.2,0.0,1.4e-11,5.3e-09,17,182,54,246,47,285,0.64,165,192,238
OceanDNA-b45289,7,11.8,0.0,1.9e-05,0.016,67,149,179,263,155,278,0.64,82,84,123
OceanDNA-b23850,133,11.7,0.0,2e-05,0.0097,70,157,638,734,599,740,0.64,87,96,141
OceanDNA-b512,233,-0.1,0.0,0.026,42.0,21,60,150,195,141,209,0.64,39,45,68
OceanDNA-b10367,795,12.2,0.0,4.8e-06,0.0038,103,191,27,117,11,158,0.64,88,90,147
OceanDNA-b35035,536,-1.2,0.0,0.11,43.0,114,150,523,559,510,570,0.64,36,36,60
OceanDNA-b34735,132,-3.0,0.0,0.62,130.0,182,202,352,372,333,384,0.64,20,20,51
OceanDNA-b15711,972,-2.8,0.0,0.34,190.0,205,244,68,107,47,120,0.64,39,39,73
OceanDNA-b26842,552,15.7,0.3,3.8e-07,0.00087,48,140,171,274,165,284,0.64,92,103,119
OceanDNA-b1751,2372,-1.4,0.0,0.063,180.0,114,141,198,226,142,235,0.64,27,28,93
OceanDNA-b35278,377,10.6,0.1,2.7e-05,0.011,32,157,16,156,5,164,0.64,125,140,159
OceanDNA-b1232,562,-3.8,0.7,0.34,690.0,169,195,28,54,20,80,0.64,26,26,60
OceanDNA-b35318,70,18.4,0.0,5.8e-08,5.7e-05,55,153,37,150,23,153,0.64,98,113,130
OceanDNA-b16229,52,-3.4,0.0,0.79,350.0,162,194,430,462,427,479,0.64,32,32,52
OceanDNA-b20905,2622,8.6,0.0,5.6e-05,0.27,103,150,441,487,373,491,0.64,47,46,118
OceanDNA-b276,1268,23.3,0.0,5.8e-09,4.5e-06,112,208,48,148,16,174,0.64,96,100,158
OceanDNA-b10728,419,6.9,0.0,0.00019,0.13,45,150,47,153,31,168,0.64,105,106,137
OceanDNA-b35069,310,-1.6,0.0,0.23,71.0,111,149,533,571,487,592,0.64,38,38,105
OceanDNA-b26380,46,-2.8,0.0,0.17,130.0,163,188,249,274,230,286,0.63,25,25,56
OceanDNA-b17770,189,8.2,0.1,7.6e-05,0.022,158,215,221,275,194,290,0.63,57,54,96
OceanDNA-b31994,2391,-3.3,0.0,0.24,800.0,160,177,218,235,197,279,0.63,17,17,82
OceanDNA-b12096,376,4.1,0.0,0.0014,1.0,66,150,50,133,24,153,0.63,84,83,129
OceanDNA-b43700,166,2.2,0.0,0.0052,5.6,134,193,108,170,102,195,0.63,59,62,93
OceanDNA-b21790,8,-2.5,0.0,0.14,37.0,187,215,693,722,670,737,0.63,28,29,67
OceanDNA-b42,3294,-2.9,0.2,0.18,1000.0,38,70,203,240,195,245,0.63,32,37,50
OceanDNA-b17764,2398,-3.8,0.0,0.34,1600.0,116,153,18,54,8,60,0.63,37,36,52
OceanDNA-b37601,1414,12.8,0.1,6.1e-06,0.0046,52,141,113,214,98,241,0.63,89,101,143
OceanDNA-b13084,750,-3.5,0.4,0.56,710.0,110,153,19,62,11,72,0.63,43,43,61
OceanDNA-b44448,147,-2.9,0.0,0.18,48.0,58,86,64,95,39,101,0.63,28,31,62
OceanDNA-b14104,138,10.6,0.0,4.4e-05,0.0069,75,148,66,135,51,142,0.63,73,69,91
OceanDNA-b22998,423,-2.1,0.0,0.11,100.0,162,188,425,451,398,460,0.63,26,26,62
OceanDNA-b6556,429,5.3,0.0,0.00058,0.67,124,157,108,145,6,157,0.63,33,37,151
OceanDNA-b26937,161,11.9,0.0,5.8e-06,0.0013,92,150,196,258,156,280,0.63,58,62,124
OceanDNA-b22548,674,-4.1,0.0,1.3,540.0,144,175,169,204,160,209,0.63,31,35,49
OceanDNA-b27491,217,-1.1,0.0,0.053,15.0,164,196,302,333,293,362,0.63,32,31,69
OceanDNA-b506,1674,16.1,0.5,3e-07,0.00058,53,208,91,280,73,292,0.63,155,189,219
OceanDNA-b13256,1664,13.5,0.0,1.3e-05,0.0037,19,238,373,575,358,588,0.63,219,202,230
OceanDNA-b26065,209,-1.5,0.0,0.072,26.0,42,87,43,93,33,105,0.63,45,50,72
OceanDNA-b25306,13,-1.5,0.0,0.067,15.0,185,201,35,51,22,80,0.63,16,16,58
OceanDNA-b17165,251,-3.5,0.0,0.27,100.0,82,97,178,193,171,208,0.63,15,15,37
OceanDNA-b6709,259,12.6,0.0,3.4e-06,0.004,94,222,153,278,146,288,0.63,128,125,142
OceanDNA-b12871,421,9.0,0.2,4.2e-05,0.018,39,153,132,268,119,274,0.63,114,136,155
OceanDNA-b44623,1895,-3.3,0.0,0.48,520.0,117,151,567,601,554,611,0.63,34,34,57
OceanDNA-b5274,115,15.0,0.0,6.2e-07,0.00041,72,160,539,637,504,647,0.63,88,98,143
OceanDNA-b16229,53,5.5,0.0,0.0015,0.65,53,86,272,305,246,387,0.63,33,33,141
OceanDNA-b11397,196,-1.5,0.0,0.071,47.0,151,174,227,250,207,260,0.63,23,23,53
OceanDNA-b269,1802,26.7,0.0,3.5e-10,3.6e-07,97,208,154,269,142,292,0.63,111,115,150
OceanDNA-b5499,196,13.7,0.1,1.6e-06,0.00065,21,158,132,281,128,297,0.63,137,149,169
OceanDNA-b10383,74,-0.6,0.0,0.037,12.0,104,150,283,330,247,343,0.63,46,47,96
OceanDNA-b1833,1400,13.5,0.2,1.9e-06,0.0027,51,143,142,253,134,314,0.63,92,111,180
OceanDNA-b34805,485,-2.8,0.0,0.17,98.0,106,150,532,576,529,591,0.62,44,44,62
OceanDNA-b40467,458,-3.5,0.1,0.82,430.0,57,89,275,311,268,316,0.62,32,36,48
OceanDNA-b22922,367,-2.4,0.0,0.27,220.0,20,80,126,144,114,158,0.62,60,18,44
OceanDNA-b18466,166,15.7,0.0,3.8e-07,0.00014,63,154,73,174,34,197,0.62,91,101,163
OceanDNA-b6295,384,-1.7,0.2,0.082,40.0,29,54,209,233,199,259,0.62,25,24,60
OceanDNA-b10398,161,0.4,0.0,0.018,4.5,104,150,72,119,35,135,0.62,46,47,100
OceanDNA-b40250,557,-2.9,0.0,0.37,130.0,198,230,394,431,385,439,0.62,32,37,54
OceanDNA-b22377,438,-3.0,0.0,0.39,450.0,199,231,240,274,228,274,0.62,32,34,46
OceanDNA-b9687,373,3.8,0.0,0.0033,1.5,125,149,116,140,21,164,0.62,24,24,143
OceanDNA-b33419,741,-3.4,0.0,0.26,400.0,59,86,56,86,37,88,0.62,27,30,51
OceanDNA-b35016,214,-2.2,0.0,0.11,98.0,114,148,536,570,487,591,0.62,34,34,104
OceanDNA-b22324,3543,11.6,0.0,3.4e-05,0.028,53,145,97,196,63,232,0.62,92,99,169
OceanDNA-b4147,1093,14.2,0.0,1.1e-06,0.0023,40,136,273,388,269,397,0.62,96,115,128
OceanDNA-b4028,349,9.5,0.0,3.1e-05,0.025,116,230,115,231,104,255,0.62,114,116,151
OceanDNA-b10067,117,-2.2,0.1,0.11,52.0,29,52,360,382,347,396,0.62,23,22,49
OceanDNA-b37833,583,-1.6,0.0,0.15,76.0,147,179,211,243,182,266,0.62,32,32,84
OceanDNA-b46520,903,-1.5,0.0,0.07,130.0,165,227,224,283,218,285,0.62,62,59,67
OceanDNA-b32747,410,10.0,0.0,2.1e-05,0.01,45,154,150,260,143,274,0.62,109,110,131
OceanDNA-b42461,83,1.1,0.0,0.011,3.4,71,143,43,111,26,125,0.62,72,68,99
OceanDNA-b40618,151,-3.3,0.0,0.74,150.0,59,89,64,97,60,109,0.62,30,33,49
OceanDNA-b32709,1502,4.7,0.1,0.0018,1.5,122,197,123,205,105,216,0.62,75,82,111
OceanDNA-b4594,24,6.3,0.0,0.00057,0.14,124,162,106,147,13,152,0.62,38,41,139
OceanDNA-b3684,19,3.0,0.0,0.003,3.8,120,143,95,118,83,189,0.62,23,23,106
OceanDNA-b45634,528,8.9,0.0,0.00014,0.034,105,162,299,355,254,369,0.62,57,56,115
OceanDNA-b32695,807,-1.7,0.0,0.079,73.0,117,146,99,131,62,145,0.62,29,32,83
OceanDNA-b40553,216,10.8,0.0,1.2e-05,0.006,62,154,46,151,23,160,0.62,92,105,137
OceanDNA-b401,641,16.3,0.1,5.3e-07,0.00026,101,155,178,234,79,262,0.61,54,56,183
OceanDNA-b40624,141,-3.4,0.0,0.53,260.0,59,89,57,90,55,101,0.61,30,33,46
OceanDNA-b16098,320,8.8,0.0,0.0001,0.039,42,143,243,360,240,367,0.61,101,117,127
OceanDNA-b13125,663,11.7,0.0,6.5e-06,0.0054,54,151,66,176,47,185,0.61,97,110,138
OceanDNA-b35100,535,11.5,0.0,7.5e-06,0.0059,60,142,113,204,104,211,0.61,82,91,107
OceanDNA-b9724,486,5.4,0.0,0.00055,0.27,118,201,90,187,78,196,0.61,83,97,118
OceanDNA-b45848,879,-2.8,0.0,0.17,340.0,144,204,324,389,302,393,0.61,60,65,91
OceanDNA-b26197,431,12.1,0.0,5e-06,0.0035,116,150,139,173,57,181,0.61,34,34,124
OceanDNA-b37342,417,-1.7,0.0,0.08,110.0,29,89,62,129,52,140,0.61,60,67,88
OceanDNA-b12501,1285,10.8,0.0,1.2e-05,0.018,58,150,41,138,9,173,0.61,92,97,164
OceanDNA-b40885,211,-3.2,0.0,0.23,150.0,119,149,569,599,555,616,0.61,30,30,61
OceanDNA-b45123,193,-3.1,0.0,0.22,210.0,81,94,89,102,65,113,0.61,13,13,48
OceanDNA-b41307,1384,5.9,0.4,0.00038,1.6,122,140,147,165,81,180,0.61,18,18,99
OceanDNA-b15134,83,-2.3,0.0,0.24,37.0,52,83,33,63,19,75,0.61,31,30,56
OceanDNA-b27556,936,13.0,0.1,5.1e-06,0.0055,20,154,22,169,13,186,0.61,134,147,173
OceanDNA-b23484,982,-1.6,0.0,0.15,130.0,148,210,225,283,220,304,0.61,62,58,84
OceanDNA-b34471,261,-0.9,0.0,0.045,40.0,107,150,572,616,566,629,0.61,43,44,63
OceanDNA-b14822,76,10.4,0.0,1.6e-05,0.0037,66,143,48,130,23,146,0.61,77,82,123
OceanDNA-b41608,419,12.0,0.0,5.3e-06,0.0031,41,174,37,188,20,202,0.61,133,151,182
OceanDNA-b36730,3243,1.6,0.0,0.016,25.0,112,142,103,132,93,156,0.61,30,29,63
OceanDNA-b24145,1148,4.6,0.0,0.00093,1.7,160,195,281,315,244,336,0.61,35,34,92
OceanDNA-b16111,443,12.6,0.0,3.5e-06,0.0036,57,216,56,237,11,244,0.61,159,181,233
OceanDNA-b13250,950,15.4,0.2,4.8e-06,0.0019,103,157,195,250,120,306,0.61,54,55,186
OceanDNA-b13264,1312,7.5,1.3,0.00013,0.2,29,133,29,153,19,167,0.61,104,124,148
OceanDNA-b22848,1547,-3.7,0.0,0.63,1200.0,110,131,104,125,85,134,0.61,21,21,49
OceanDNA-b30217,1058,-2.1,0.0,0.1,250.0,140,189,266,321,257,345,0.61,49,55,88
OceanDNA-b16224,1390,8.3,0.1,7.2e-05,0.11,43,104,248,304,221,380,0.61,61,56,159
OceanDNA-b46252,556,12.6,0.1,1.4e-05,0.0077,64,155,171,278,144,289,0.61,91,107,145
OceanDNA-b23175,2997,16.4,0.8,2.4e-07,0.0018,113,230,322,468,196,473,0.6,117,146,277
OceanDNA-b3956,990,8.3,0.0,7.2e-05,0.075,52,152,35,136,7,150,0.6,100,101,143
OceanDNA-b1820,355,14.2,0.4,2.2e-06,0.0023,51,193,156,328,144,347,0.6,142,172,203
OceanDNA-b32306,131,-1.4,0.0,0.063,26.0,183,233,24,76,16,83,0.6,50,52,67
OceanDNA-b12639,372,12.3,0.0,4.3e-06,0.0026,41,150,27,154,19,159,0.6,109,127,140
OceanDNA-b36730,3243,-2.7,0.0,0.32,530.0,15,38,39,66,35,112,0.6,23,27,77
OceanDNA-b21048,591,11.6,0.1,1.4e-05,0.012,49,142,92,194,84,254,0.6,93,102,170
OceanDNA-b34288,969,-3.1,0.0,0.43,270.0,115,141,537,561,526,582,0.59,26,24,56
OceanDNA-b30938,2151,-2.8,0.0,0.5,410.0,156,209,255,308,231,313,0.59,53,53,82
OceanDNA-b37846,1121,1.0,0.0,0.012,13.0,115,150,342,377,328,391,0.59,35,35,63
OceanDNA-b13544,146,1.3,0.0,0.01,12.0,148,223,197,273,192,280,0.59,75,76,88
OceanDNA-b16098,490,7.9,0.0,0.00019,0.072,55,143,79,185,60,193,0.59,88,106,133
OceanDNA-b3242,329,13.7,0.0,1.6e-06,0.0013,39,153,80,206,51,233,0.59,114,126,182
OceanDNA-b33521,1386,-3.3,0.0,0.51,730.0,110,151,340,384,333,388,0.59,41,44,55
OceanDNA-b15459,1164,7.0,0.0,0.00017,0.21,21,152,3,135,1,166,0.59,131,132,165
OceanDNA-b40629,357,6.3,0.0,0.00029,0.18,87,216,148,269,139,279,0.59,129,121,140
OceanDNA-b22805,5940,-1.4,0.0,0.13,440.0,81,131,703,761,695,787,0.59,50,58,92
OceanDNA-b15784,572,-2.4,0.0,0.13,140.0,170,210,249,286,243,308,0.58,40,37,65
OceanDNA-b20726,68,-2.9,0.0,0.18,30.0,186,229,257,298,233,317,0.58,43,41,84
OceanDNA-b16107,394,14.8,0.0,7.4e-07,0.00051,96,145,307,359,231,366,0.58,49,52,135
OceanDNA-b30235,805,-3.9,0.0,0.36,1000.0,142,162,294,315,285,337,0.58,20,21,52
OceanDNA-b37508,143,4.7,0.0,0.0009,1.8,161,217,226,279,155,287,0.58,56,53,132
OceanDNA-b37345,318,20.7,0.0,3.6e-08,1.7e-05,52,210,15,198,6,237,0.58,158,183,231
OceanDNA-b21048,127,16.4,0.1,4.7e-07,0.00042,56,188,111,277,105,306,0.58,132,166,201
OceanDNA-b43907,104,5.0,0.9,0.0015,0.25,111,136,168,193,53,203,0.58,25,25,150
OceanDNA-b6561,240,7.1,0.0,0.00032,0.22,40,150,23,134,2,154,0.58,110,111,152
OceanDNA-b32277,1368,-2.4,0.0,0.13,280.0,41,86,49,99,12,105,0.57,45,50,93
OceanDNA-b18639,160,-0.7,0.0,0.077,16.0,49,83,139,173,91,179,0.57,34,34,88
OceanDNA-b34299,271,-3.7,0.0,0.64,650.0,61,89,57,88,53,95,0.57,28,31,42
OceanDNA-b46308,138,-1.7,0.0,0.16,160.0,124,155,253,284,215,294,0.57,31,31,79
OceanDNA-b37345,174,-1.3,0.0,0.18,81.0,42,86,51,99,14,108,0.57,44,48,94
OceanDNA-b36732,2751,-2.6,0.0,0.15,530.0,160,192,304,336,275,370,0.56,32,32,95
OceanDNA-b23996,1022,-0.9,0.0,0.091,53.0,112,142,24,55,15,74,0.56,30,31,59
OceanDNA-b23996,682,-1.3,0.0,0.12,72.0,116,142,538,564,448,577,0.56,26,26,129
OceanDNA-b12642,408,14.3,0.0,1e-06,0.00061,110,150,101,141,9,148,0.56,40,40,139
OceanDNA-b41496,132,7.4,0.9,0.00014,0.26,69,99,173,203,165,292,0.55,30,30,127
OceanDNA-b22894,353,13.1,0.1,2.4e-06,0.005,42,208,73,282,70,290,0.55,166,209,220
OceanDNA-b34610,170,-0.6,0.0,0.072,47.0,150,157,297,304,210,363,0.55,7,7,153
OceanDNA-b31526,855,-2.5,0.0,0.43,150.0,41,54,161,174,139,180,0.55,13,13,41
OceanDNA-b46897,281,-3.5,0.0,0.28,240.0,9,49,38,75,33,79,0.55,40,37,46
OceanDNA-b32306,131,-1.9,0.0,0.09,37.0,126,134,82,90,54,111,0.55,8,8,57
OceanDNA-b32834,306,-2.1,0.0,0.22,87.0,161,173,202,214,143,253,0.54,12,12,110
OceanDNA-b23813,1139,-0.6,0.0,0.037,54.0,122,188,157,230,121,251,0.54,66,73,130
OceanDNA-b2923,1425,-0.9,0.0,0.047,90.0,144,179,182,219,169,268,0.54,35,37,99
OceanDNA-b37298,235,-2.9,0.0,0.19,180.0,47,53,43,49,14,112,0.54,6,6,98
OceanDNA-b15128,974,-2.7,0.0,0.17,200.0,121,180,186,246,169,273,0.53,59,60,104
OceanDNA-b36473,1282,-2.9,0.0,0.19,590.0,119,151,159,189,141,218,0.53,32,30,77
OceanDNA-b32684,1044,-1.4,0.0,0.066,100.0,74,127,208,263,172,266,0.52,53,55,94
OceanDNA-b32851,680,-1.4,0.0,0.065,51.0,104,174,145,215,136,236,0.52,70,70,100
OceanDNA-b23515,852,-3.3,0.0,0.48,290.0,38,90,167,226,151,230,0.52,52,59,79
OceanDNA-b31726,1049,-3.7,0.2,0.32,570.0,34,53,416,435,409,454,0.52,19,19,45
OceanDNA-b423,584,-2.1,0.0,0.1,100.0,66,96,82,112,60,153,0.52,30,30,93
OceanDNA-b13087,1025,-3.2,0.0,0.22,390.0,167,215,324,371,319,388,0.49,48,47,69
OceanDNA-b960,417,-8.0,6.1,1.0,2100.0,62,86,122,146,81,167,0.46,24,24,86
