File,SubFile,Score,Bias,EValue(C),EValue(I),HMM-From,HMM-To,Ali-From,Ali-To,Env-From,Env-To,Accuracy,HMM-Length,Ali-Length,Env-Length
OceanDNA-b41030,1870,309.3,0.1,3.6e-96,3.1e-93,35,296,69,333,59,333,0.94,261,264,274
OceanDNA-b23655,703,13.6,0.1,3e-06,0.0028,154,182,154,182,14,197,0.94,28,28,183
OceanDNA-b22507,886,13.1,0.1,2.1e-06,0.0062,154,186,205,237,200,243,0.93,32,32,43
OceanDNA-b26636,3711,7.3,0.0,0.00025,0.49,132,168,153,189,148,189,0.93,36,36,41
OceanDNA-b6501,409,3.8,0.0,0.0028,0.72,196,257,373,434,363,437,0.93,61,61,74
OceanDNA-b46216,450,13.0,0.1,2.2e-06,0.0029,153,186,233,266,223,270,0.93,33,33,47
OceanDNA-b22917,1245,8.1,0.0,0.00029,0.21,77,120,67,110,64,117,0.93,43,43,53
OceanDNA-b22385,1572,15.0,0.1,5.4e-07,0.0021,154,186,266,298,256,302,0.93,32,32,46
OceanDNA-b38376,1463,318.7,0.1,6.9e-99,4.3e-96,33,296,85,353,76,353,0.93,263,268,277
OceanDNA-b22509,2558,15.9,0.0,2.8e-07,0.00082,153,186,204,237,200,242,0.93,33,33,42
OceanDNA-b46812,1104,13.6,0.1,3e-06,0.0036,153,186,231,264,221,269,0.93,33,33,48
OceanDNA-b17737,215,10.8,0.0,1e-05,0.036,166,221,7,62,4,84,0.93,55,55,80
OceanDNA-b16133,307,11.6,0.0,1.8e-05,0.0067,152,183,142,173,123,277,0.93,31,31,154
OceanDNA-b17160,71,12.9,0.0,2.4e-06,0.00043,81,121,188,228,183,239,0.93,40,40,56
OceanDNA-b45526,124,13.2,0.0,1.9e-06,0.00064,153,187,236,270,231,280,0.92,34,34,49
OceanDNA-b22894,353,9.0,0.1,7.5e-05,0.079,77,120,73,116,27,138,0.92,43,43,111
OceanDNA-b20588,136,12.5,0.0,3.3e-06,0.00081,80,121,120,161,112,169,0.92,41,41,57
OceanDNA-b14104,281,17.6,0.0,2.6e-07,4.2e-05,151,190,160,199,157,204,0.92,39,39,47
OceanDNA-b24136,3117,11.3,0.0,7.5e-06,0.027,152,187,138,173,130,182,0.92,35,35,52
OceanDNA-b39170,558,322.7,2.1,9.9e-101,2.1e-97,34,296,60,327,25,327,0.92,262,267,302
OceanDNA-b22978,1591,11.8,0.1,5.3e-06,0.012,152,186,217,251,213,254,0.92,34,34,41
OceanDNA-b24086,404,23.0,0.0,2.1e-09,1.2e-06,150,198,132,180,119,190,0.92,48,48,71
OceanDNA-b15979,255,19.4,0.0,5.1e-08,2.6e-05,152,197,169,214,160,229,0.92,45,45,69
OceanDNA-b46684,332,13.3,0.0,3.6e-06,0.0014,153,186,239,272,224,283,0.92,33,33,59
OceanDNA-b22816,1853,14.3,0.0,8.9e-07,0.0031,152,187,82,117,58,127,0.92,35,35,69
OceanDNA-b15326,263,23.0,0.0,2.1e-09,5.9e-07,105,189,106,190,75,202,0.92,84,84,127
OceanDNA-b16480,1016,9.7,0.0,2.3e-05,0.026,197,247,319,369,311,374,0.92,50,50,63
OceanDNA-b46558,120,13.7,0.0,2.8e-06,0.00086,153,186,197,230,193,242,0.92,33,33,49
OceanDNA-b23229,485,10.3,0.0,3.1e-05,0.021,153,185,206,238,199,247,0.92,32,32,48
OceanDNA-b38936,521,329.6,1.5,8.3e-103,5.3e-100,36,296,48,313,19,313,0.92,260,265,294
OceanDNA-b37615,440,8.8,0.0,4.4e-05,0.084,153,185,374,406,363,412,0.92,32,32,49
OceanDNA-b45381,2554,12.9,0.0,2.5e-06,0.0068,152,186,360,394,352,404,0.92,34,34,52
OceanDNA-a4078,317,9.3,0.0,3e-05,0.011,152,199,150,197,136,198,0.92,47,47,62
OceanDNA-b23199,586,13.4,0.0,1.7e-06,0.0031,153,186,201,234,194,243,0.91,33,33,49
OceanDNA-b44357,392,12.1,0.0,4.3e-06,0.0024,150,184,97,131,77,136,0.91,34,34,59
OceanDNA-b13229,111,19.2,0.0,5.7e-08,1.9e-05,139,184,126,171,117,180,0.91,45,45,63
OceanDNA-b35208,909,8.5,0.0,5.1e-05,0.049,175,218,231,274,228,291,0.91,43,43,63
OceanDNA-b14697,145,12.2,0.0,3.9e-06,0.001,136,183,42,89,32,96,0.91,47,47,64
OceanDNA-b22566,1112,10.9,0.1,1.9e-05,0.012,152,186,238,272,229,276,0.91,34,34,47
OceanDNA-b13674,206,14.3,0.0,8.9e-07,0.0002,154,193,179,218,171,226,0.91,39,39,55
OceanDNA-b45389,308,11.3,0.0,7.5e-06,0.0094,152,192,175,215,159,222,0.91,40,40,63
OceanDNA-b29,2122,11.7,0.1,2.2e-05,0.028,68,106,210,248,203,256,0.91,38,38,53
OceanDNA-b24941,1854,11.9,0.1,9.7e-06,0.014,157,187,107,137,89,170,0.91,30,30,81
OceanDNA-b33243,962,21.4,0.1,6e-09,1.6e-05,149,186,180,217,171,237,0.91,37,37,66
OceanDNA-b50,2159,11.7,0.0,5.7e-06,0.015,151,188,233,270,227,291,0.91,37,37,64
OceanDNA-b45626,73,10.7,0.0,1.1e-05,0.0082,153,186,261,294,256,304,0.91,33,33,48
OceanDNA-b45634,308,12.6,0.0,5.8e-06,0.0021,153,186,229,262,198,273,0.91,33,33,75
OceanDNA-b31227,782,11.4,0.3,7e-06,0.0065,131,158,101,128,92,139,0.91,27,27,47
OceanDNA-b46303,2952,10.1,0.0,3.5e-05,0.063,151,185,380,414,368,426,0.91,34,34,58
OceanDNA-b45437,549,7.5,0.0,0.00011,0.14,150,188,91,129,83,139,0.91,38,38,56
OceanDNA-b45859,1146,17.9,0.0,1.5e-07,0.00027,152,185,146,179,134,185,0.91,33,33,51
OceanDNA-b45014,133,9.1,0.0,3.4e-05,0.024,154,189,137,172,126,180,0.91,35,35,54
OceanDNA-b20819,330,9.0,0.0,7.5e-05,0.025,155,192,239,276,197,282,0.91,37,37,85
OceanDNA-b22512,912,13.6,0.0,2.9e-06,0.0036,153,186,206,239,202,244,0.91,33,33,42
OceanDNA-b45835,357,17.4,0.0,1e-07,0.0001,154,186,127,159,117,191,0.91,32,32,74
OceanDNA-b22722,737,13.3,0.0,1.8e-06,0.0019,155,185,149,179,136,218,0.91,30,30,82
OceanDNA-b17611,2516,11.5,0.0,2e-05,0.022,150,190,190,230,179,234,0.91,40,40,55
OceanDNA-b17611,2100,24.6,0.0,2e-09,2.1e-06,124,191,45,112,42,119,0.91,67,67,77
OceanDNA-b18473,63,12.8,0.0,2.5e-06,0.0012,141,191,303,353,279,359,0.91,50,50,80
OceanDNA-b13585,772,22.9,0.0,8.9e-09,3.4e-06,129,190,114,175,109,190,0.91,61,61,81
OceanDNA-b44876,223,11.6,0.0,5.9e-06,0.0049,146,186,344,384,336,390,0.91,40,40,54
OceanDNA-b13076,1906,15.9,0.6,2.8e-07,0.00077,51,109,64,123,38,130,0.91,58,59,92
OceanDNA-b13539,88,15.6,0.0,7e-07,0.00053,152,184,502,534,485,543,0.91,32,32,58
OceanDNA-b45659,148,11.2,0.0,8e-06,0.0027,153,187,230,264,222,275,0.91,34,34,53
OceanDNA-b31567,1370,10.5,0.2,2.6e-05,0.022,161,189,163,192,158,222,0.91,28,29,64
OceanDNA-b45576,1161,11.2,0.0,1.6e-05,0.01,153,186,194,227,188,238,0.91,33,33,50
OceanDNA-b40254,276,11.9,0.1,9.4e-06,0.003,161,185,171,195,160,203,0.91,24,24,43
OceanDNA-b14889,170,12.4,0.0,3.3e-06,0.00076,136,183,42,89,28,95,0.91,47,47,67
OceanDNA-b22607,586,14.2,0.2,2.8e-06,0.00085,152,186,226,260,215,263,0.91,34,34,48
OceanDNA-b15497,403,10.5,0.0,1.3e-05,0.0063,151,190,170,209,163,214,0.91,39,39,51
OceanDNA-b45233,1211,11.1,0.0,1.8e-05,0.013,154,186,175,207,168,213,0.91,32,32,45
OceanDNA-b33388,1370,16.3,0.0,6.7e-07,0.00085,155,186,327,358,320,372,0.91,31,31,52
OceanDNA-b28238,1655,11.3,0.1,1.5e-05,0.017,86,118,81,113,69,122,0.91,32,32,53
OceanDNA-b45578,722,13.2,0.0,2e-06,0.0021,153,186,243,276,236,286,0.91,33,33,50
OceanDNA-b15135,103,12.6,0.0,2.9e-06,0.0015,89,134,31,76,23,88,0.91,45,45,65
OceanDNA-b22130,936,12.3,0.0,7.4e-06,0.0092,158,189,2,33,1,42,0.91,31,31,41
OceanDNA-b23725,689,11.9,0.0,1.4e-05,0.01,68,88,194,214,183,222,0.91,20,20,39
OceanDNA-b46697,1101,13.9,0.0,2.4e-06,0.0024,154,185,201,232,188,241,0.91,31,31,53
OceanDNA-b14283,358,13.3,0.0,1.8e-06,0.00084,151,190,161,200,157,204,0.91,39,39,47
OceanDNA-b22393,660,13.6,0.0,2.9e-06,0.0023,151,188,197,234,190,247,0.91,37,37,57
OceanDNA-b45131,359,14.3,0.0,8.7e-07,0.0011,151,190,178,217,174,226,0.91,39,39,52
OceanDNA-b32076,153,10.8,0.0,2.1e-05,0.032,154,180,147,173,103,181,0.91,26,26,78
OceanDNA-b29383,363,11.8,0.0,5.1e-06,0.0043,159,182,82,105,37,122,0.91,23,23,85
OceanDNA-b45487,190,10.3,0.0,1.5e-05,0.034,153,186,236,269,225,279,0.91,33,33,54
OceanDNA-b23843,2041,19.1,0.0,3.2e-08,7.3e-05,154,185,159,190,141,199,0.9,31,31,58
OceanDNA-b23584,548,11.9,0.0,1e-05,0.012,66,88,95,117,74,138,0.9,22,22,64
OceanDNA-b27579,1754,12.7,0.0,5.4e-06,0.0078,159,182,180,203,157,211,0.9,23,23,54
OceanDNA-b32139,904,9.8,0.2,2e-05,0.048,160,189,124,154,113,158,0.9,29,30,45
OceanDNA-b18796,201,4.6,0.1,0.00082,0.23,89,121,203,235,196,254,0.9,32,32,58
OceanDNA-b46625,550,14.2,0.0,2.9e-06,0.00089,153,187,197,231,193,243,0.9,34,34,50
OceanDNA-b45438,1698,15.0,0.1,5.5e-07,0.0011,154,186,203,235,198,240,0.9,32,32,42
OceanDNA-b7262,306,139.5,0.0,1.3e-44,2.4e-42,74,288,66,287,49,294,0.9,214,221,245
OceanDNA-b13457,125,2.3,0.0,0.0084,2.9,223,256,101,134,96,136,0.9,33,33,40
OceanDNA-b3414,1223,11.8,0.3,5.2e-06,0.0076,159,187,80,108,77,113,0.9,28,28,36
OceanDNA-b32695,807,11.4,0.0,6.9e-06,0.0064,197,262,219,280,196,281,0.9,65,61,85
OceanDNA-b40685,345,206.6,0.2,4.8e-65,2.6e-62,44,274,25,270,20,279,0.9,230,245,259
OceanDNA-b11358,140,18.4,0.0,5e-08,2.1e-05,144,183,25,64,17,103,0.9,39,39,86
OceanDNA-b45514,593,13.6,0.0,1.5e-06,0.0029,152,187,231,266,201,277,0.9,35,35,76
OceanDNA-b33393,2192,10.3,0.0,1.5e-05,0.064,54,106,11,64,5,82,0.9,52,53,77
OceanDNA-b7401,137,12.0,0.0,4.5e-06,0.0012,182,215,154,187,122,195,0.9,33,33,73
OceanDNA-b22624,2593,8.9,1.6,4e-05,0.13,151,186,144,179,133,183,0.9,35,35,50
OceanDNA-b32011,1221,14.7,0.0,6.6e-07,0.0014,150,185,113,148,108,154,0.9,35,35,46
OceanDNA-b20918,1824,17.2,0.1,2.4e-07,0.00038,107,157,64,117,56,147,0.9,50,53,91
OceanDNA-b15551,376,8.9,0.0,8.2e-05,0.087,151,193,164,206,150,213,0.9,42,42,63
OceanDNA-b28567,65,15.2,0.0,4.8e-07,0.00035,153,175,185,207,170,220,0.9,22,22,50
OceanDNA-b22083,915,11.2,0.0,7.9e-06,0.02,153,193,177,217,157,227,0.9,40,40,70
OceanDNA-b13153,314,18.9,0.0,3.7e-08,2.6e-05,139,185,126,172,119,180,0.9,46,46,61
OceanDNA-b46906,628,12.4,0.0,3.5e-06,0.0028,132,176,147,191,129,212,0.9,44,44,83
OceanDNA-b46326,1716,12.0,0.0,8.8e-06,0.012,153,185,258,290,242,302,0.9,32,32,60
OceanDNA-b20505,46,2.0,0.0,0.0049,1.4,80,120,125,165,97,173,0.9,40,40,76
OceanDNA-b13844,27,18.1,0.0,6.4e-08,1.9e-05,153,193,180,220,167,228,0.9,40,40,61
OceanDNA-b20951,1368,13.5,0.0,3.2e-06,0.0041,124,183,29,90,19,109,0.9,59,61,90
OceanDNA-b27448,73,10.4,0.0,1.4e-05,0.0037,153,193,224,264,195,281,0.9,40,40,86
OceanDNA-b23327,1031,11.9,0.1,1e-05,0.008,157,181,78,102,71,113,0.9,24,24,42
OceanDNA-b15453,1319,14.8,0.0,1.2e-06,0.0013,88,177,293,379,246,419,0.9,89,86,173
OceanDNA-b17564,520,11.7,0.0,5.5e-06,0.011,154,193,185,224,165,232,0.9,39,39,67
OceanDNA-b24230,372,15.5,0.0,3.9e-07,0.00016,59,118,67,125,58,150,0.9,59,58,92
OceanDNA-b22406,2680,10.7,0.0,5.6e-05,0.033,154,186,222,254,190,259,0.9,32,32,69
OceanDNA-b24230,372,8.5,0.0,5.3e-05,0.022,152,186,181,216,155,271,0.9,34,35,116
OceanDNA-b20952,4,13.4,0.0,1.7e-06,0.0057,124,183,29,90,19,109,0.9,59,61,90
OceanDNA-b11822,70,11.3,0.0,7.4e-06,0.0071,157,182,131,156,103,188,0.9,25,25,85
OceanDNA-b23340,1830,17.7,0.0,8.4e-08,0.00017,157,185,140,168,125,178,0.9,28,28,53
OceanDNA-b24900,1143,10.6,0.0,1.2e-05,0.022,152,187,93,128,80,135,0.9,35,35,55
OceanDNA-b45854,1983,12.6,0.0,6.1e-06,0.0064,155,184,45,74,32,94,0.9,29,29,62
OceanDNA-b10475,234,10.1,0.0,1.7e-05,0.0082,187,216,287,316,273,338,0.9,29,29,65
OceanDNA-b28583,702,2.5,0.0,0.0035,3.3,192,229,244,281,233,295,0.9,37,37,62
OceanDNA-b36948,1090,20.5,0.0,1.2e-08,1.4e-05,149,192,239,282,219,303,0.9,43,43,84
OceanDNA-b33388,2196,12.7,0.0,8.1e-06,0.01,151,191,139,178,88,193,0.9,40,39,105
OceanDNA-b3621,155,6.1,0.0,0.00028,0.25,84,120,175,211,155,219,0.9,36,36,64
OceanDNA-b45520,1064,19.8,0.0,3.8e-08,2.7e-05,132,186,178,233,168,241,0.9,54,55,73
OceanDNA-b22324,2077,12.2,0.0,7.8e-06,0.016,152,186,232,266,219,280,0.9,34,34,61
OceanDNA-b20934,4662,10.6,0.0,1.2e-05,0.068,155,187,485,517,478,560,0.9,32,32,82
OceanDNA-b13250,1592,19.5,0.0,2.2e-07,9.9e-05,92,186,71,166,11,170,0.9,94,95,159
OceanDNA-b23400,399,11.0,0.0,8.9e-06,0.019,157,180,178,201,166,207,0.9,23,23,41
OceanDNA-b42446,268,13.4,0.0,1.7e-06,0.00048,153,188,149,184,138,215,0.9,35,35,77
OceanDNA-b36076,862,5.7,0.1,0.00076,0.97,90,119,118,147,112,154,0.9,29,29,42
OceanDNA-b46812,1757,13.3,0.0,3.5e-06,0.0043,154,183,122,151,111,158,0.9,29,29,47
OceanDNA-b3462,229,10.7,0.0,1.1e-05,0.0074,150,185,43,78,20,89,0.9,35,35,69
OceanDNA-b3696,1147,-1.4,0.0,0.055,140.0,125,152,71,98,67,100,0.9,27,27,33
OceanDNA-b13164,157,19.3,0.0,2.7e-08,1.8e-05,139,185,126,172,117,181,0.9,46,46,64
OceanDNA-b20708,83,8.2,0.0,6.4e-05,0.014,80,121,156,197,132,202,0.9,41,41,70
OceanDNA-b42818,121,16.6,0.0,1.9e-07,0.00016,153,189,493,530,482,536,0.9,36,37,54
OceanDNA-b37342,417,17.6,0.0,9e-08,0.00012,154,181,182,209,167,228,0.9,27,27,61
OceanDNA-b23012,2134,4.2,0.0,0.0011,5.9,161,180,232,251,193,260,0.9,19,19,67
OceanDNA-b17273,142,208.5,0.2,1.3e-65,1.6e-62,53,280,64,299,51,310,0.9,227,235,259
OceanDNA-b30499,1061,11.5,0.0,6.5e-06,0.0085,159,182,82,105,66,149,0.9,23,23,83
OceanDNA-b37527,1146,22.7,0.0,5.1e-09,5.8e-06,137,191,124,177,113,183,0.9,54,53,70
OceanDNA-b45857,2941,7.6,0.0,0.00019,0.39,196,236,255,295,245,307,0.89,40,40,62
OceanDNA-b19147,46,11.5,0.1,1.3e-05,0.0022,89,122,209,242,203,259,0.89,33,33,56
OceanDNA-b6218,393,9.6,0.0,2.4e-05,0.013,187,217,282,312,266,325,0.89,30,30,59
OceanDNA-b6509,444,13.3,0.0,1.9e-06,0.0019,153,190,188,228,179,299,0.89,37,40,120
OceanDNA-b15921,218,13.9,0.0,1.2e-06,0.00039,157,182,100,125,84,133,0.89,25,25,49
OceanDNA-b15834,331,11.0,0.0,8.8e-06,0.01,151,189,168,206,156,210,0.89,38,38,54
OceanDNA-b23260,70,9.9,0.0,2e-05,0.014,196,257,207,267,128,271,0.89,61,60,143
OceanDNA-b36729,927,6.3,0.0,0.00024,0.55,153,184,235,266,228,282,0.89,31,31,54
OceanDNA-b46766,1240,19.1,0.0,6.3e-08,5.6e-05,149,188,136,176,117,206,0.89,39,40,89
OceanDNA-b7374,41,127.4,0.0,3.2e-41,1e-38,53,276,43,274,34,291,0.89,223,231,257
OceanDNA-b17593,1196,11.2,0.0,7.7e-06,0.019,104,131,70,97,60,115,0.89,27,27,55
OceanDNA-b7584,366,11.7,0.0,5.6e-06,0.0021,187,217,287,317,276,340,0.89,30,30,64
OceanDNA-b23519,427,6.1,0.0,0.00057,0.44,161,185,122,146,54,174,0.89,24,24,120
OceanDNA-b23634,108,7.0,0.0,0.00045,0.37,196,236,260,299,254,320,0.89,40,39,66
OceanDNA-b17549,984,13.7,0.0,1.4e-06,0.0052,153,189,269,305,256,317,0.89,36,36,61
OceanDNA-b27445,13,15.9,0.0,2.9e-07,6.5e-05,151,202,216,266,184,275,0.89,51,50,91
OceanDNA-b7010,154,147.5,0.0,2.4e-47,1e-44,53,276,57,288,46,305,0.89,223,231,259
OceanDNA-b30678,1209,10.9,0.0,9.7e-06,0.014,154,176,148,170,133,186,0.89,22,22,53
OceanDNA-b22935,660,13.7,0.0,1.4e-06,0.0055,152,184,221,253,207,259,0.89,32,32,52
OceanDNA-b11455,288,13.8,0.0,1.3e-06,0.001,150,188,236,274,207,279,0.89,38,38,72
OceanDNA-b3711,1465,10.8,0.0,1.1e-05,0.033,124,164,436,477,430,487,0.89,40,41,57
OceanDNA-b42824,223,17.0,0.0,1.4e-07,0.00027,153,189,231,268,215,275,0.89,36,37,60
OceanDNA-b24169,608,-1.3,0.0,0.051,52.0,188,211,205,228,197,244,0.89,23,23,47
OceanDNA-b46725,1949,12.8,0.0,5.3e-06,0.0055,153,186,199,232,195,247,0.89,33,33,52
OceanDNA-b2674,68,10.9,0.0,1e-05,0.0086,161,188,86,113,79,119,0.89,27,27,40
OceanDNA-b28587,550,8.7,0.0,4.7e-05,0.04,192,227,244,279,230,295,0.89,35,35,65
OceanDNA-b32790,63,12.5,0.0,3.1e-06,0.00088,145,197,155,207,145,220,0.89,52,52,75
OceanDNA-b15465,1021,10.8,0.0,2.1e-05,0.011,149,193,5,49,3,65,0.89,44,44,62
OceanDNA-b32,528,9.7,0.0,4.5e-05,0.014,145,176,130,161,90,168,0.89,31,31,78
OceanDNA-b38311,923,17.4,0.0,1e-07,0.00014,139,180,129,171,124,188,0.89,41,42,64
OceanDNA-b45859,2819,8.7,0.0,8.9e-05,0.16,196,236,349,389,340,400,0.89,40,40,60
OceanDNA-b13615,335,11.5,0.0,6.6e-06,0.0024,149,184,108,143,97,151,0.89,35,35,54
OceanDNA-b33329,23,12.5,0.0,9.4e-06,0.0049,153,183,440,470,428,492,0.89,30,30,64
OceanDNA-b13203,166,5.7,0.0,0.00037,0.38,161,188,112,139,59,156,0.89,27,27,97
OceanDNA-b47086,269,6.7,0.1,0.00036,0.76,149,188,268,307,257,320,0.89,39,39,63
OceanDNA-b3599,397,18.1,0.0,1.3e-07,4.8e-05,150,188,155,194,145,226,0.89,38,39,81
OceanDNA-b45257,1415,12.2,0.1,8e-06,0.0087,149,188,211,250,153,253,0.89,39,39,100
OceanDNA-b32861,660,20.6,0.0,2.1e-08,1.3e-05,153,181,154,182,140,205,0.89,28,28,65
OceanDNA-b28155,1056,4.1,0.0,0.0011,1.7,159,188,88,117,67,156,0.89,29,29,89
OceanDNA-b10017,7,8.7,0.0,4.6e-05,0.034,134,188,104,156,29,163,0.89,54,52,134
OceanDNA-b30757,244,13.8,0.0,1.3e-06,0.00053,153,185,167,199,151,212,0.89,32,32,61
OceanDNA-b22287,1008,13.6,0.0,1.5e-06,0.0022,153,184,134,165,128,178,0.89,31,31,50
OceanDNA-b61,724,14.4,0.0,8.6e-07,0.00099,126,185,159,218,147,226,0.89,59,59,79
OceanDNA-b30127,816,14.6,0.1,7.1e-07,0.0017,159,186,151,178,130,194,0.89,27,27,64
OceanDNA-b13541,1191,16.9,0.0,1.4e-07,0.0002,152,184,218,250,200,260,0.89,32,32,60
OceanDNA-b17441,966,211.0,0.1,1.1e-66,1.1e-63,42,277,49,291,42,306,0.89,235,242,264
OceanDNA-b20668,73,12.2,0.0,8.1e-06,0.0011,148,192,228,272,205,287,0.89,44,44,82
OceanDNA-b46309,179,6.5,0.6,0.00064,0.5,157,182,179,204,171,210,0.89,25,25,39
OceanDNA-b44662,2521,0.1,0.0,0.039,53.0,178,211,215,248,209,260,0.89,33,33,51
OceanDNA-b44662,2521,10.2,0.0,3.2e-05,0.044,152,179,116,143,107,164,0.89,27,27,57
OceanDNA-b45536,507,14.9,0.0,5.8e-07,0.00034,153,187,250,284,245,300,0.89,34,34,55
OceanDNA-b22615,804,185.3,0.1,2.2e-58,4.3e-55,41,281,80,327,59,337,0.89,240,247,278
OceanDNA-b45166,151,12.4,0.2,3.3e-06,0.0049,157,187,319,349,310,362,0.89,30,30,52
OceanDNA-b28578,509,13.1,0.0,2.1e-06,0.0013,154,176,143,165,127,185,0.89,22,22,58
OceanDNA-b13621,87,14.4,0.0,8.2e-07,0.00025,151,184,129,162,119,173,0.89,33,33,54
OceanDNA-b23187,394,14.9,0.0,6e-07,0.00067,151,185,34,68,24,73,0.89,34,34,49
OceanDNA-b31076,1999,14.4,0.0,2.4e-06,0.0024,149,192,181,224,168,236,0.89,43,43,68
OceanDNA-b40232,2108,208.1,0.0,1.7e-65,2e-62,45,275,112,357,101,368,0.89,230,245,267
OceanDNA-b33317,1303,1.7,0.0,0.0062,17.0,197,230,239,271,234,279,0.89,33,32,45
OceanDNA-b23004,1653,10.9,0.1,9.5e-06,0.041,157,185,170,198,165,209,0.89,28,28,44
OceanDNA-b26884,1682,13.1,0.0,2.1e-06,0.0061,151,180,170,199,86,212,0.89,29,29,126
OceanDNA-b20782,423,10.5,0.0,2.7e-05,0.013,154,192,251,289,219,298,0.89,38,38,79
OceanDNA-b38332,52,17.6,0.0,8.9e-08,0.00013,139,180,129,171,119,189,0.89,41,42,70
OceanDNA-b24941,2495,10.2,0.0,3.3e-05,0.047,153,187,133,167,118,203,0.89,34,34,85
OceanDNA-b28083,995,19.2,0.0,5.9e-08,5.1e-05,154,180,140,166,125,181,0.89,26,26,56
OceanDNA-b41583,245,5.9,0.0,0.00033,0.21,198,235,260,297,243,305,0.89,37,37,62
OceanDNA-b32692,1303,7.1,0.0,0.00014,0.33,153,180,73,100,65,107,0.89,27,27,42
OceanDNA-b24743,113,11.4,0.0,1.4e-05,0.0054,244,292,28,76,22,79,0.88,48,48,57
OceanDNA-b32144,436,26.5,0.1,3.5e-10,4.8e-07,75,189,52,164,40,173,0.88,114,112,133
OceanDNA-b22118,1516,12.7,0.0,2.7e-06,0.0057,134,193,513,570,509,584,0.88,59,57,75
OceanDNA-b46638,531,10.9,0.0,3e-05,0.016,153,186,53,86,49,105,0.88,33,33,56
OceanDNA-b7279,223,13.2,0.0,1.9e-06,0.00071,182,217,78,113,60,121,0.88,35,35,61
OceanDNA-b38880,867,1.9,0.0,0.011,5.2,188,214,191,217,180,243,0.88,26,26,63
OceanDNA-b27556,2127,6.7,0.0,0.00058,0.41,144,180,27,63,11,72,0.88,36,36,61
OceanDNA-b8222,62,11.4,0.0,6.8e-06,0.0018,186,216,200,230,191,258,0.88,30,30,67
OceanDNA-b29579,235,14.0,0.0,1.1e-06,0.00079,153,179,138,164,127,179,0.88,26,26,52
OceanDNA-b11418,498,3.6,0.0,0.0016,0.88,161,187,108,134,50,148,0.88,26,26,98
OceanDNA-b24005,575,9.8,0.0,2.2e-05,0.039,198,268,585,657,563,661,0.88,70,72,98
OceanDNA-b31577,2131,12.9,0.0,2.4e-06,0.0053,154,185,159,190,144,197,0.88,31,31,53
OceanDNA-b15137,1468,18.3,0.0,1.6e-07,0.00012,153,190,115,152,97,200,0.88,37,37,103
OceanDNA-b15769,856,11.1,0.0,3.5e-05,0.015,151,189,185,223,174,227,0.88,38,38,53
OceanDNA-b19934,261,4.1,0.0,0.0012,0.42,82,120,196,234,183,249,0.88,38,38,66
OceanDNA-b27556,2014,8.6,0.0,0.00014,0.1,195,220,180,205,174,217,0.88,25,25,43
OceanDNA-b26699,34,13.2,0.0,1.9e-06,0.0049,152,192,191,231,179,240,0.88,40,40,61
OceanDNA-b7003,11,145.9,0.0,7.2e-47,3.2e-44,53,276,52,283,24,299,0.88,223,231,275
OceanDNA-b19928,527,2.3,0.0,0.0039,2.3,84,120,198,234,191,252,0.88,36,36,61
OceanDNA-b46252,2090,-0.4,0.1,0.11,63.0,182,199,126,143,117,147,0.88,17,17,30
OceanDNA-b31687,6,9.7,0.0,2.2e-05,0.06,188,263,259,332,242,339,0.88,75,73,97
OceanDNA-b22849,1949,11.1,0.0,2.5e-05,0.017,153,187,171,205,103,216,0.88,34,34,113
OceanDNA-b37345,174,14.8,0.0,2e-06,0.00091,154,180,155,181,147,198,0.88,26,26,51
OceanDNA-b15080,267,11.3,0.0,7.1e-06,0.0074,157,182,126,151,115,158,0.88,25,25,43
OceanDNA-b23974,166,11.0,0.0,9e-06,0.011,193,230,136,173,122,191,0.88,37,37,69
OceanDNA-b15167,1879,9.0,0.1,7.7e-05,0.078,152,180,92,120,42,129,0.88,28,28,87
OceanDNA-b38353,719,21.4,0.0,6.1e-09,1.4e-05,139,186,149,197,143,212,0.88,47,48,69
OceanDNA-b13585,820,10.1,0.0,6.9e-05,0.026,153,188,93,128,80,138,0.88,35,35,58
OceanDNA-b22806,2866,11.6,0.0,1.9e-05,0.029,150,184,244,278,233,285,0.88,34,34,52
OceanDNA-b30215,1298,15.4,0.0,8.3e-07,0.00076,154,180,172,198,156,226,0.88,26,26,70
OceanDNA-b44623,260,5.2,0.0,0.00053,1.1,155,183,538,566,531,578,0.88,28,28,47
OceanDNA-b21342,331,10.0,0.0,1.8e-05,0.0087,156,185,128,157,107,163,0.88,29,29,56
OceanDNA-b32969,132,14.8,0.0,6.2e-07,0.00032,155,185,157,187,141,230,0.88,30,30,89
OceanDNA-b6298,319,16.0,0.0,5.5e-07,0.00011,144,185,73,114,60,126,0.88,41,41,66
OceanDNA-b25027,809,11.2,0.1,8e-06,0.0066,161,187,149,175,140,184,0.88,26,26,44
OceanDNA-b5215,68,12.8,0.0,2.5e-06,0.00071,139,185,97,143,91,158,0.88,46,46,67
OceanDNA-b45370,3,10.5,0.1,1.3e-05,0.017,152,187,241,276,233,286,0.88,35,35,53
OceanDNA-a3660,363,22.1,0.0,3.8e-09,1.6e-06,153,194,67,109,54,133,0.88,41,42,79
OceanDNA-b6423,306,153.8,0.1,3e-49,1.5e-46,53,276,42,273,9,288,0.88,223,231,279
OceanDNA-b17563,225,9.7,0.0,6.7e-05,0.05,154,193,191,230,173,239,0.88,39,39,66
OceanDNA-b4060,782,16.1,0.0,5e-07,0.0002,160,184,148,172,124,180,0.88,24,24,56
OceanDNA-b38220,389,17.7,0.0,8.5e-08,0.0001,139,180,139,181,129,197,0.88,41,42,68
OceanDNA-b32911,528,7.2,0.0,0.00013,0.18,148,180,86,118,68,125,0.88,32,32,57
OceanDNA-b33192,357,12.9,0.0,4.6e-06,0.001,125,193,111,173,32,179,0.88,68,62,147
OceanDNA-b45838,706,145.4,0.0,1.1e-46,1.3e-43,37,280,96,346,80,354,0.88,243,250,274
OceanDNA-b14831,96,11.2,0.1,7.7e-06,0.0021,67,110,140,183,125,200,0.88,43,43,75
OceanDNA-b26825,261,10.3,0.0,1.5e-05,0.016,161,187,120,146,70,161,0.88,26,26,91
OceanDNA-b22387,366,11.6,0.0,1.2e-05,0.013,151,189,238,276,231,290,0.88,38,38,59
OceanDNA-b10708,286,149.6,0.0,5.6e-48,2.5e-45,53,276,41,272,12,292,0.88,223,231,280
OceanDNA-b26776,1836,6.4,0.0,0.00046,0.54,195,231,262,298,251,307,0.88,36,36,56
OceanDNA-b24169,608,10.4,0.0,1.4e-05,0.014,140,180,75,115,44,127,0.88,40,40,83
OceanDNA-b40618,49,194.7,0.1,3.9e-61,5.9e-59,67,275,50,275,32,285,0.88,208,225,253
OceanDNA-b45857,4007,16.1,0.0,5.2e-07,0.001,136,185,180,229,173,240,0.88,49,49,67
OceanDNA-b4683,266,128.8,0.0,1.2e-41,5.7e-39,71,276,56,267,25,286,0.88,205,211,261
OceanDNA-b20982,1046,7.1,0.0,0.00014,0.41,175,212,232,269,224,286,0.88,37,37,62
OceanDNA-b38915,32,14.5,0.0,7.7e-07,0.0004,146,186,105,145,89,172,0.88,40,40,83
OceanDNA-b34310,331,11.7,0.0,5.5e-06,0.0046,187,243,93,147,90,165,0.88,56,54,75
OceanDNA-b33391,2935,19.7,0.1,2e-08,0.00011,79,171,42,133,23,144,0.88,92,91,121
OceanDNA-b26639,931,-0.3,0.0,0.025,35.0,198,220,209,231,202,233,0.88,22,22,31
OceanDNA-b2514,271,11.1,0.0,8.5e-06,0.0061,150,180,27,57,15,156,0.88,30,30,141
OceanDNA-b9617,142,11.3,0.0,7.6e-06,0.0018,157,180,100,123,82,133,0.88,23,23,51
OceanDNA-b22840,3847,10.2,0.0,4.7e-05,0.066,149,188,235,274,223,285,0.88,39,39,62
OceanDNA-b3978,495,16.3,0.0,2.2e-07,0.00021,159,189,156,186,133,192,0.88,30,30,59
OceanDNA-b16220,635,5.3,0.0,0.00096,0.59,77,151,105,181,103,191,0.88,74,76,88
OceanDNA-b36755,2942,13.3,0.1,3.5e-06,0.0066,156,186,99,129,84,137,0.88,30,30,53
OceanDNA-b7184,341,15.0,0.0,1.1e-06,0.00027,182,215,271,304,260,312,0.88,33,33,52
OceanDNA-b30042,1923,4.3,0.0,0.002,3.4,195,220,191,216,155,236,0.88,25,25,81
OceanDNA-b19626,358,11.0,0.0,1.9e-05,0.0046,221,276,255,310,225,314,0.88,55,55,89
OceanDNA-b6173,392,130.6,0.2,3.4e-42,1.9e-39,72,279,53,271,14,287,0.88,207,218,273
OceanDNA-b11789,1224,11.1,0.0,8.4e-06,0.011,155,180,126,151,67,171,0.88,25,25,104
OceanDNA-b22394,92,10.4,0.0,2.7e-05,0.027,152,185,447,480,426,515,0.88,33,33,89
OceanDNA-b2796,846,21.7,0.0,1e-08,1e-05,146,191,306,353,291,361,0.88,45,47,70
OceanDNA-b3704,1601,18.3,0.0,5.4e-08,0.00015,154,180,142,168,135,181,0.88,26,26,46
OceanDNA-b46852,1158,14.0,0.0,3.3e-06,0.0014,153,186,143,176,129,193,0.88,33,33,64
OceanDNA-b23065,671,9.7,0.0,2.2e-05,0.021,158,193,130,165,122,171,0.88,35,35,49
OceanDNA-b9758,999,16.4,0.0,4.2e-07,0.00024,155,187,176,209,159,237,0.88,32,33,78
OceanDNA-b6778,256,8.2,0.0,6.4e-05,0.039,186,215,273,302,267,313,0.88,29,29,46
OceanDNA-b34384,90,10.6,0.0,5e-05,0.01,187,243,93,147,90,165,0.88,56,54,75
OceanDNA-b4858,199,124.9,0.0,1.8e-40,3.6e-38,55,283,35,274,24,284,0.88,228,239,260
OceanDNA-b34653,194,12.6,0.0,2.9e-06,0.0023,196,258,570,632,560,640,0.88,62,62,80
OceanDNA-b24820,498,15.0,0.0,5.4e-07,0.00038,154,182,143,171,127,186,0.88,28,28,59
OceanDNA-a4458,450,11.2,0.0,8e-06,0.0037,153,185,16,48,7,91,0.88,32,32,84
OceanDNA-b36722,553,10.6,0.0,2.3e-05,0.011,160,181,146,167,130,175,0.88,21,21,45
OceanDNA-b1333,585,2.3,0.0,0.013,6.6,90,135,248,293,233,297,0.88,45,45,64
OceanDNA-b23019,3479,10.6,0.0,2.5e-05,0.047,195,243,296,341,290,352,0.88,48,45,62
OceanDNA-b46309,65,13.3,0.0,5.5e-06,0.0042,148,193,229,274,221,282,0.88,45,45,61
OceanDNA-b23364,1374,11.8,0.0,5.2e-06,0.012,158,182,140,164,130,175,0.88,24,24,45
OceanDNA-b32047,264,23.1,0.1,5.6e-09,6.6e-06,132,202,125,194,61,223,0.88,70,69,162
OceanDNA-b31459,42,18.0,0.0,6.8e-08,0.00013,154,185,148,179,143,189,0.88,31,31,46
OceanDNA-b22306,1201,10.5,0.1,2.5e-05,0.021,149,189,244,284,235,297,0.88,40,40,62
OceanDNA-b23370,2087,13.7,0.1,2.7e-06,0.0028,160,185,306,331,300,340,0.88,25,25,40
OceanDNA-b47092,283,7.0,0.0,0.0003,0.28,196,235,210,249,191,258,0.88,39,39,67
OceanDNA-b6582,313,12.4,0.1,3.4e-06,0.0022,174,219,197,242,193,257,0.88,45,45,64
OceanDNA-b2515,845,12.0,0.1,4.5e-06,0.0086,161,181,297,317,266,320,0.88,20,20,54
OceanDNA-b13250,3720,9.3,0.0,0.00027,0.12,189,230,248,288,242,299,0.88,41,40,57
OceanDNA-b21028,240,16.3,0.0,4.5e-07,0.00059,153,186,189,222,174,231,0.88,33,33,57
OceanDNA-b23314,819,6.3,0.1,0.00025,0.93,195,220,204,229,195,238,0.88,25,25,43
OceanDNA-b42522,68,7.5,0.0,0.00021,0.032,195,238,260,302,255,318,0.88,43,42,63
OceanDNA-b23458,1638,4.4,0.0,0.00096,2.7,105,120,189,204,180,221,0.88,15,15,41
OceanDNA-b17589,1582,11.7,0.0,5.8e-06,0.011,104,132,8,36,2,44,0.88,28,28,42
OceanDNA-b46695,1303,15.8,0.0,1.6e-06,0.00069,133,185,131,178,118,239,0.88,52,47,121
OceanDNA-b45663,108,21.4,0.0,1.3e-08,5.5e-06,152,187,167,203,150,206,0.88,35,36,56
OceanDNA-b24591,1847,-2.4,0.0,0.22,310.0,96,115,42,61,40,68,0.88,19,19,28
OceanDNA-b36083,798,11.2,0.0,8.2e-06,0.016,156,185,219,248,213,261,0.88,29,29,48
OceanDNA-b15876,464,13.9,0.0,1.2e-06,0.0015,151,189,168,206,156,210,0.88,38,38,54
OceanDNA-b22858,2614,10.1,0.0,1.7e-05,0.059,149,189,235,275,223,301,0.88,40,40,78
OceanDNA-b23012,2134,5.2,0.0,0.00054,2.9,197,245,310,357,304,366,0.88,48,47,62
OceanDNA-b24637,144,0.9,0.0,0.011,7.1,94,111,71,88,53,93,0.88,17,17,40
OceanDNA-b42068,240,12.2,0.0,3.9e-06,0.0011,153,216,145,210,130,249,0.88,63,65,119
OceanDNA-b32721,2142,12.2,0.0,7.9e-06,0.0091,155,203,1,49,1,86,0.88,48,48,85
OceanDNA-b20588,136,9.2,0.0,3.2e-05,0.0078,124,191,201,269,198,278,0.88,67,68,80
OceanDNA-b35890,2812,6.5,0.0,0.00022,0.89,151,190,277,316,253,328,0.88,39,39,75
OceanDNA-b24637,144,12.6,0.0,2.9e-06,0.0019,69,115,159,205,147,217,0.88,46,46,70
OceanDNA-b22108,1590,7.5,0.0,0.00033,0.22,153,187,153,187,138,191,0.88,34,34,53
OceanDNA-b32153,1760,9.5,0.0,2.6e-05,0.065,196,235,273,312,254,332,0.88,39,39,78
OceanDNA-b26893,2035,3.1,0.0,0.0046,7.6,188,244,247,303,237,310,0.88,56,56,73
OceanDNA-b13544,146,9.8,0.0,2.1e-05,0.024,159,189,122,152,117,163,0.88,30,30,46
OceanDNA-b3907,464,10.1,0.0,1.7e-05,0.0094,134,188,104,158,97,169,0.88,54,54,72
OceanDNA-b31456,54,18.0,0.0,6.8e-08,0.00013,154,185,148,179,143,189,0.88,31,31,46
OceanDNA-b30447,350,7.8,0.1,8.6e-05,0.22,160,187,177,204,167,215,0.88,27,27,48
OceanDNA-b22842,1272,19.4,0.0,4.9e-08,0.00011,84,185,222,324,214,332,0.88,101,102,118
OceanDNA-b38741,416,-2.1,0.0,0.086,44.0,107,121,178,192,163,196,0.88,14,14,33
OceanDNA-b6345,278,138.0,0.2,1.8e-44,5.2e-42,72,282,66,287,41,299,0.88,210,221,258
OceanDNA-b30001,1264,6.2,0.0,0.00052,0.42,195,228,261,294,235,310,0.88,33,33,75
OceanDNA-b44638,2053,11.5,0.0,6.3e-06,0.022,151,180,191,220,174,243,0.88,29,29,69
OceanDNA-b22882,788,10.4,0.0,1.4e-05,0.059,150,188,228,266,215,276,0.88,38,38,61
OceanDNA-b6781,378,13.5,0.0,1.6e-06,0.00083,187,218,268,299,262,338,0.88,31,31,76
OceanDNA-b30257,76,15.4,0.0,4.1e-07,0.00087,154,180,172,198,156,226,0.88,26,26,70
OceanDNA-b26781,1409,12.8,0.0,5.1e-06,0.0044,154,180,71,97,63,115,0.87,26,26,52
OceanDNA-b32281,1901,20.9,0.0,8.6e-09,1.7e-05,154,185,26,57,11,73,0.87,31,31,62
OceanDNA-b35898,1605,14.0,0.0,1.1e-06,0.0022,154,203,153,201,134,207,0.87,49,48,73
OceanDNA-b30408,365,4.2,0.0,0.0011,2.5,154,188,188,222,178,236,0.87,34,34,58
OceanDNA-b4111,10,12.5,0.0,3.2e-06,0.0021,134,189,103,158,56,170,0.87,55,55,114
OceanDNA-b23382,1938,11.5,0.0,6.6e-06,0.015,161,185,190,214,177,223,0.87,24,24,46
OceanDNA-b36648,147,1.9,0.0,0.0054,3.0,152,173,503,524,455,541,0.87,21,21,86
OceanDNA-b46695,283,11.5,0.0,3.1e-05,0.014,151,186,161,196,149,208,0.87,35,35,59
OceanDNA-b46594,693,11.3,0.0,7.5e-06,0.011,152,187,217,252,213,271,0.87,35,35,58
OceanDNA-b16778,122,13.8,0.0,2.6e-06,0.0021,148,187,79,118,59,140,0.87,39,39,81
OceanDNA-b13544,146,-0.1,0.2,0.022,25.0,88,116,53,81,46,83,0.87,28,28,37
OceanDNA-b23379,1414,15.7,0.1,7e-07,0.00079,157,182,267,292,252,298,0.87,25,25,46
OceanDNA-b35796,702,9.6,0.0,2.4e-05,0.025,144,183,127,166,119,174,0.87,39,39,55
OceanDNA-b4763,414,8.2,0.0,6.7e-05,0.033,160,176,135,151,121,170,0.87,16,16,49
OceanDNA-b31270,447,15.2,0.0,4.8e-07,0.0011,156,181,166,191,161,209,0.87,25,25,48
OceanDNA-b30736,960,10.6,0.1,1.2e-05,0.014,154,223,283,352,277,357,0.87,69,69,80
OceanDNA-b28646,761,11.5,0.0,6.2e-06,0.0073,154,179,146,171,129,190,0.87,25,25,61
OceanDNA-b16210,288,14.7,0.0,1.4e-06,0.00079,139,185,81,129,73,137,0.87,46,48,64
OceanDNA-b202,248,5.0,0.1,0.0019,1.4,197,229,202,234,197,242,0.87,32,32,45
OceanDNA-b7440,29,142.6,0.0,7.6e-46,2.6e-43,51,276,38,270,8,288,0.87,225,232,280
OceanDNA-b440,696,6.9,0.0,0.00033,0.4,162,190,156,186,149,196,0.87,28,30,47
OceanDNA-b24743,76,10.8,0.0,2.1e-05,0.0083,154,181,156,183,141,199,0.87,27,27,58
OceanDNA-b20991,1065,11.2,0.0,1.5e-05,0.015,153,186,295,328,278,359,0.87,33,33,81
OceanDNA-b9726,71,11.1,0.0,8.6e-06,0.004,159,183,86,110,35,143,0.87,24,24,108
OceanDNA-b24091,193,9.1,0.0,3.3e-05,0.033,150,184,217,251,204,271,0.87,34,34,67
OceanDNA-b16123,12,10.3,0.0,2.9e-05,0.011,153,185,141,173,120,186,0.87,32,32,66
OceanDNA-b15831,1481,11.5,0.0,6.5e-06,0.011,151,189,168,206,158,212,0.87,38,38,54
OceanDNA-b23484,1131,10.5,0.0,2.5e-05,0.022,155,181,144,170,125,188,0.87,26,26,63
OceanDNA-b3424,671,14.1,0.0,1e-06,0.0017,154,187,129,162,115,221,0.87,33,33,106
OceanDNA-b27579,40,5.7,0.1,0.00074,1.1,153,187,117,151,87,173,0.87,34,34,86
OceanDNA-b31592,1648,13.7,0.0,1.3e-06,0.0034,154,185,161,192,144,201,0.87,31,31,57
OceanDNA-b23394,1879,13.8,0.1,2.6e-06,0.0033,161,184,193,216,186,227,0.87,23,23,41
OceanDNA-b19574,99,1.0,0.0,0.0099,3.8,89,120,243,274,235,290,0.87,31,31,55
OceanDNA-b231,9,29.9,0.1,1.6e-11,1.5e-08,153,245,120,213,91,223,0.87,92,93,132
OceanDNA-b23327,389,12.3,0.0,7.4e-06,0.0058,160,182,222,244,210,257,0.87,22,22,47
OceanDNA-b15317,658,10.2,0.0,1.6e-05,0.012,146,187,85,126,61,133,0.87,41,41,72
OceanDNA-b34263,107,9.0,0.0,7.4e-05,0.024,148,188,508,549,465,565,0.87,40,41,100
OceanDNA-b17591,1464,15.8,0.0,3.2e-07,0.00051,139,191,175,227,159,240,0.87,52,52,81
OceanDNA-b30718,465,17.1,0.0,1.3e-07,0.00026,156,185,151,180,134,210,0.87,29,29,76
OceanDNA-a5075,29,18.3,0.0,5.3e-08,2.1e-05,153,196,273,317,261,340,0.87,43,44,79
OceanDNA-b37298,235,19.3,0.0,5.4e-08,2.6e-05,154,181,159,186,150,208,0.87,27,27,58
OceanDNA-b27563,76,7.1,0.1,0.00014,0.22,155,181,54,80,39,116,0.87,26,26,77
OceanDNA-b18620,306,19.0,0.0,3.4e-08,1.4e-05,152,185,131,164,112,178,0.87,33,33,66
OceanDNA-b31152,642,13.8,0.0,2.5e-06,0.001,150,196,243,290,238,294,0.87,46,47,56
OceanDNA-b20993,2777,12.9,0.0,2.5e-06,0.0085,212,273,301,360,271,367,0.87,61,59,96
OceanDNA-b30572,993,14.4,0.0,8.3e-07,0.0024,154,179,169,194,153,232,0.87,25,25,79
OceanDNA-b33331,208,17.6,0.0,1.8e-07,0.00014,140,182,126,169,118,190,0.87,42,43,72
OceanDNA-b15450,1537,18.8,0.0,7.5e-08,7.8e-05,195,243,167,213,158,221,0.87,48,46,63
OceanDNA-b20505,46,14.7,0.0,6.6e-07,0.00019,123,191,205,273,197,329,0.87,68,68,132
OceanDNA-b40635,9,11.3,0.0,1.4e-05,0.0043,7,100,10,105,5,121,0.87,93,95,116
OceanDNA-b23345,103,10.8,0.1,1.1e-05,0.021,147,184,683,720,633,730,0.87,37,37,97
OceanDNA-b22888,200,11.4,0.2,1.4e-05,0.0096,109,175,189,253,170,261,0.87,66,64,91
OceanDNA-b16222,285,4.6,0.0,0.00078,1.3,154,185,174,205,167,219,0.87,31,31,52
OceanDNA-b24973,397,11.2,0.0,7.9e-06,0.0036,150,189,181,220,171,240,0.87,39,39,69
OceanDNA-b8077,136,11.9,0.0,4.9e-06,0.00098,134,185,99,148,33,157,0.87,51,49,124
OceanDNA-b30085,1262,-0.6,0.1,0.095,70.0,165,186,203,224,196,259,0.87,21,21,63
OceanDNA-b36680,368,9.6,0.0,2.4e-05,0.02,158,180,26,48,18,56,0.87,22,22,38
OceanDNA-b23655,661,4.3,0.0,0.0019,1.8,197,230,268,300,252,308,0.87,33,32,56
OceanDNA-b28141,466,10.9,0.0,2e-05,0.016,155,182,178,205,157,221,0.87,27,27,64
OceanDNA-b32974,2789,4.7,0.0,0.0015,2.2,196,218,246,268,235,289,0.87,22,22,54
OceanDNA-b31542,1510,15.5,0.1,3.8e-07,0.00065,154,180,9,35,4,49,0.87,26,26,45
OceanDNA-b2592,2047,15.5,0.0,7.6e-07,0.00098,149,190,180,223,170,230,0.87,41,43,60
OceanDNA-b30786,1244,14.7,0.0,6.8e-07,0.00093,148,195,167,214,155,229,0.87,47,47,74
OceanDNA-b24641,274,9.3,0.1,2.9e-05,0.0095,191,265,180,252,173,255,0.87,74,72,82
OceanDNA-b33288,2766,14.4,0.0,1.6e-06,0.0023,157,185,384,412,365,437,0.87,28,28,72
OceanDNA-b47085,317,12.3,0.0,3.7e-06,0.0034,153,186,149,182,116,198,0.87,33,33,82
OceanDNA-b31567,588,15.4,0.1,8e-07,0.00068,155,185,5,35,3,44,0.87,30,30,41
OceanDNA-b1424,451,10.5,0.1,2.6e-05,0.01,146,188,80,122,71,137,0.87,42,42,66
OceanDNA-b3982,297,10.1,0.0,5.1e-05,0.01,161,197,107,147,44,170,0.87,36,40,126
OceanDNA-b6426,302,144.7,0.1,1.7e-46,1.3e-43,53,276,38,269,5,279,0.87,223,231,274
OceanDNA-b510,1351,10.9,0.0,1.9e-05,0.021,149,182,110,143,33,157,0.87,33,33,124
OceanDNA-b3982,579,18.7,0.0,1.2e-07,2.5e-05,145,184,138,177,116,185,0.87,39,39,69
OceanDNA-b3982,21,15.9,0.0,8.9e-07,0.00018,159,187,154,182,134,189,0.87,28,28,55
OceanDNA-b10602,177,11.4,0.0,7.1e-06,0.0023,183,216,279,312,265,320,0.87,33,33,55
OceanDNA-b40629,357,7.7,0.0,9.1e-05,0.056,160,187,89,116,74,126,0.87,27,27,52
OceanDNA-b29592,1803,12.2,0.0,3.9e-06,0.0094,153,174,531,552,514,582,0.87,21,21,68
OceanDNA-b35167,467,26.7,0.0,1.5e-10,1.3e-07,135,188,35,85,19,98,0.87,53,50,79
OceanDNA-b32925,605,6.3,0.0,0.00024,0.55,147,180,87,120,71,126,0.87,33,33,55
OceanDNA-b40669,87,10.8,0.0,2.1e-05,0.0068,193,245,221,271,202,282,0.87,52,50,80
OceanDNA-b36675,330,1.6,0.0,0.0065,7.6,154,182,517,545,457,553,0.87,28,28,96
OceanDNA-b38938,372,16.5,0.0,1.9e-07,0.00014,158,185,148,175,128,186,0.87,27,27,58
OceanDNA-b20923,2449,10.5,0.0,4e-05,0.081,160,183,141,164,123,181,0.87,23,23,58
OceanDNA-b22805,5940,13.1,0.0,8.5e-06,0.014,153,187,181,216,173,226,0.87,34,35,53
OceanDNA-b22997,133,68.9,0.0,6.4e-23,2.2e-20,33,244,18,235,2,248,0.87,211,217,246
OceanDNA-b38907,339,12.6,0.2,2.9e-06,0.0028,84,142,572,630,562,665,0.87,58,58,103
OceanDNA-b22830,3137,13.3,0.0,3.6e-06,0.0084,147,184,234,271,218,280,0.87,37,37,62
OceanDNA-b9951,224,145.1,0.1,1.3e-46,5.4e-44,54,278,43,275,25,293,0.87,224,232,268
OceanDNA-b46922,163,10.8,0.0,1e-05,0.023,160,181,180,201,171,218,0.87,21,21,47
OceanDNA-b211,630,6.9,0.1,0.00016,0.15,157,177,183,203,165,214,0.87,20,20,49
OceanDNA-b10366,399,11.2,0.0,1.6e-05,0.013,175,230,249,304,244,311,0.87,55,55,67
OceanDNA-b26613,119,12.6,0.0,3e-06,0.0017,157,189,90,122,69,144,0.87,32,32,75
OceanDNA-b13585,772,7.0,0.0,0.00059,0.22,85,120,40,75,34,90,0.87,35,35,56
OceanDNA-b23054,1823,13.0,0.0,2.3e-06,0.0058,85,117,70,102,19,103,0.87,32,32,84
OceanDNA-b46823,662,15.1,0.0,1.6e-06,0.00093,154,185,139,170,122,206,0.87,31,31,84
OceanDNA-b34793,517,-3.4,0.0,0.23,190.0,178,204,31,57,28,59,0.87,26,26,31
OceanDNA-b35250,67,1.1,0.0,0.0097,6.5,155,185,507,538,491,552,0.87,30,31,61
OceanDNA-b8264,535,9.7,0.0,2.3e-05,0.017,182,216,287,321,274,327,0.87,34,34,53
OceanDNA-b44039,31,22.8,0.0,4.6e-09,6.9e-07,154,184,136,166,118,179,0.87,30,30,61
OceanDNA-b13158,100,11.6,0.0,6.1e-06,0.0031,140,185,125,170,118,178,0.87,45,45,60
OceanDNA-b36886,1428,14.2,0.0,9.4e-07,0.0017,154,180,138,164,123,184,0.87,26,26,61
OceanDNA-b13457,125,7.1,0.1,0.00028,0.098,58,90,168,200,163,243,0.87,32,32,80
OceanDNA-b13178,83,5.3,0.0,0.00049,0.39,195,215,236,256,225,278,0.87,20,20,53
OceanDNA-b2866,2501,12.9,0.0,4.8e-06,0.0063,153,181,163,191,147,198,0.87,28,28,51
OceanDNA-b36072,497,13.4,0.0,1.7e-06,0.0017,154,180,13,39,5,54,0.87,26,26,49
OceanDNA-b20982,1046,8.4,0.0,5.7e-05,0.17,153,180,137,164,127,176,0.87,27,27,49
OceanDNA-b24625,397,15.0,0.0,5.4e-07,0.00028,154,185,139,170,122,184,0.87,31,31,62
OceanDNA-b30459,1839,9.5,0.1,2.6e-05,0.068,166,230,266,332,245,345,0.87,64,66,100
OceanDNA-b22212,22,13.4,0.2,1.7e-06,0.0015,149,202,199,252,187,322,0.87,53,53,135
OceanDNA-b15078,251,13.3,0.0,1.8e-06,0.002,158,182,19,43,13,51,0.87,24,24,38
OceanDNA-b33048,2277,10.2,0.0,3.2e-05,0.059,161,182,108,129,97,137,0.87,21,21,40
OceanDNA-b17212,2925,7.0,0.4,0.0003,0.61,157,175,18,36,8,42,0.87,18,18,34
OceanDNA-b5007,104,109.1,0.0,1.2e-35,3.3e-33,53,280,32,269,18,282,0.87,227,237,264
OceanDNA-b28110,1919,-3.5,0.1,0.24,540.0,199,217,429,447,424,456,0.87,18,18,32
OceanDNA-b20915,804,11.5,0.0,6.4e-06,0.0053,156,180,112,136,91,149,0.87,24,24,58
OceanDNA-b10577,120,11.9,0.0,4.9e-06,0.0016,182,216,271,305,258,317,0.87,34,34,59
OceanDNA-b29993,55,13.7,0.0,1.4e-06,0.0019,153,176,145,168,129,189,0.87,23,23,60
OceanDNA-b31245,1431,22.6,0.0,2.8e-09,5.3e-06,156,185,147,176,115,199,0.87,29,29,84
OceanDNA-b13084,750,-0.9,0.0,0.075,94.0,152,174,359,381,352,405,0.87,22,22,53
OceanDNA-b22760,2709,13.7,0.1,1.4e-06,0.005,147,188,244,285,232,293,0.87,41,41,61
OceanDNA-b23229,1345,13.1,0.0,4.3e-06,0.003,151,180,117,146,105,146,0.87,29,29,41
OceanDNA-b47105,25,10.7,0.0,1.1e-05,0.0036,192,230,247,284,243,291,0.87,38,37,48
OceanDNA-b21437,139,6.3,0.0,0.00024,0.054,193,218,176,201,169,238,0.87,25,25,69
OceanDNA-b13006,155,14.3,0.0,9.1e-07,0.00033,152,191,207,247,195,273,0.87,39,40,78
OceanDNA-b17034,171,11.5,0.0,1.3e-05,0.0058,154,219,176,241,165,263,0.87,65,65,98
OceanDNA-b22833,1824,16.8,0.0,1.5e-07,0.00061,151,182,254,285,221,296,0.87,31,31,75
OceanDNA-b10094,20,134.0,0.2,3.2e-43,1.5e-40,53,276,37,268,12,283,0.87,223,231,271
OceanDNA-b19896,68,1.7,0.0,0.0061,2.4,89,121,208,240,199,253,0.87,32,32,54
OceanDNA-b31271,856,16.3,0.0,2.3e-07,0.00055,156,183,168,195,163,211,0.87,27,27,48
OceanDNA-b4494,680,5.4,0.0,0.00093,0.54,159,185,142,168,131,174,0.87,26,26,43
OceanDNA-b22256,248,18.1,0.0,6.1e-08,0.00011,152,185,152,185,135,246,0.87,33,33,111
OceanDNA-b32136,343,11.7,0.4,5.7e-06,0.012,150,182,55,87,47,106,0.87,32,32,59
OceanDNA-b37442,373,3.7,0.0,0.0015,1.5,89,121,138,170,77,180,0.87,32,32,103
OceanDNA-b46252,556,2.0,0.0,0.02,11.0,103,118,175,190,151,211,0.87,15,15,60
OceanDNA-b23367,1849,21.7,0.1,9.9e-09,1e-05,145,180,117,155,112,163,0.87,35,38,51
OceanDNA-b23089,3322,15.5,0.0,7.9e-07,0.0016,140,183,310,353,303,370,0.87,43,43,67
OceanDNA-b5654,190,13.2,0.0,1.9e-06,0.00052,148,232,117,199,107,217,0.87,84,82,110
OceanDNA-b22808,143,22.1,0.0,3.8e-09,1.6e-05,152,188,99,136,91,170,0.87,36,37,79
OceanDNA-b3129,147,9.9,0.0,1.9e-05,0.0068,150,198,208,257,196,273,0.87,48,49,77
OceanDNA-b23644,7,15.9,0.1,2.9e-07,0.00075,157,189,187,220,174,243,0.86,32,33,69
OceanDNA-b11392,106,0.7,0.0,0.012,6.3,191,216,203,228,199,240,0.86,25,25,41
OceanDNA-b23333,179,13.5,0.1,1.6e-06,0.0027,153,187,548,583,530,587,0.86,34,35,57
OceanDNA-b7219,294,17.3,0.0,1.1e-07,3.6e-05,135,185,100,148,83,158,0.86,50,48,75
OceanDNA-b46326,1026,16.0,0.1,5.3e-07,0.0007,151,185,286,320,277,324,0.86,34,34,47
OceanDNA-b3323,131,16.4,0.2,4.2e-07,0.00069,137,181,136,180,99,183,0.86,44,44,84
OceanDNA-b41011,471,9.8,0.0,4.3e-05,0.053,192,263,239,309,228,315,0.86,71,70,87
OceanDNA-b23356,1225,12.1,0.0,4.2e-06,0.0077,161,185,171,195,159,215,0.86,24,24,56
OceanDNA-b37704,397,14.1,0.0,1.1e-06,0.00063,151,180,170,199,154,213,0.86,29,29,59
OceanDNA-b13180,128,5.1,0.0,0.00055,0.42,195,215,248,268,239,286,0.86,20,20,47
OceanDNA-b31519,410,0.4,0.0,0.015,9.9,155,189,503,538,486,544,0.86,34,35,58
OceanDNA-b9687,398,8.9,0.0,3.9e-05,0.034,198,266,621,691,617,693,0.86,68,70,76
OceanDNA-b22805,721,17.7,0.0,3.2e-07,0.00053,152,185,164,197,144,218,0.86,33,33,74
OceanDNA-b47087,581,13.0,0.0,4.4e-06,0.0061,146,185,69,108,59,144,0.86,39,39,85
OceanDNA-b45373,219,26.8,0.0,1.4e-10,9.5e-08,153,218,198,265,183,295,0.86,65,67,112
OceanDNA-b33318,3389,19.9,0.0,1.8e-08,8.3e-05,154,184,144,174,128,191,0.86,30,30,63
OceanDNA-b33299,3441,11.5,0.1,6.4e-06,0.026,155,179,454,478,449,493,0.86,24,24,44
OceanDNA-b23974,166,2.6,0.1,0.0034,4.3,157,180,15,38,9,51,0.86,23,23,42
OceanDNA-b33308,960,12.4,0.0,6.8e-06,0.011,154,185,160,191,144,207,0.86,31,31,63
OceanDNA-b22917,2318,12.5,0.0,1.3e-05,0.0092,157,185,154,182,122,190,0.86,28,28,68
OceanDNA-b16280,24,4.8,0.0,0.00072,0.2,89,121,236,268,226,279,0.86,32,32,53
OceanDNA-b23482,159,2.8,0.0,0.0029,4.6,193,231,274,312,264,333,0.86,38,38,69
OceanDNA-b22926,2357,10.6,0.0,2.4e-05,0.056,149,180,271,302,253,310,0.86,31,31,57
OceanDNA-b23524,1143,19.0,0.0,6.8e-08,4.8e-05,140,180,127,169,116,188,0.86,40,42,72
OceanDNA-b23524,154,12.9,0.0,4.8e-06,0.0034,150,191,83,124,71,139,0.86,41,41,68
OceanDNA-b33284,2828,15.7,0.0,3.5e-07,0.0017,155,180,155,180,137,201,0.86,25,25,64
OceanDNA-b46255,2575,13.9,0.0,1.2e-06,0.0039,150,187,143,181,128,186,0.86,37,38,58
OceanDNA-b45823,1426,14.0,0.0,2.3e-06,0.002,153,186,135,168,115,212,0.86,33,33,97
OceanDNA-b36770,733,13.2,0.0,2e-06,0.0022,144,187,116,159,106,181,0.86,43,43,75
OceanDNA-b34275,576,11.4,0.0,1.4e-05,0.0064,142,185,494,539,455,557,0.86,43,45,102
OceanDNA-b20923,4877,11.1,0.1,2.6e-05,0.052,159,186,172,199,142,216,0.86,27,27,74
OceanDNA-b32277,1368,19.4,0.0,4.9e-08,5e-05,154,181,153,180,138,199,0.86,27,27,61
OceanDNA-b41014,1477,11.8,0.0,1.5e-05,0.011,94,131,70,108,54,117,0.86,37,38,63
OceanDNA-b41272,1357,3.2,0.1,0.0022,4.9,161,185,114,138,95,170,0.86,24,24,75
OceanDNA-b34918,458,17.1,0.0,3.7e-07,0.00013,139,177,169,208,163,223,0.86,38,39,60
OceanDNA-b13088,539,9.7,0.0,2.2e-05,0.081,198,264,608,676,603,679,0.86,66,68,76
OceanDNA-b7450,617,18.2,0.0,1.2e-07,7.8e-05,192,268,184,258,173,282,0.86,76,74,109
OceanDNA-b24140,199,4.1,0.0,0.0011,0.83,194,215,201,222,189,231,0.86,21,21,42
OceanDNA-b6838,638,11.6,0.0,5.8e-06,0.0043,144,187,78,121,67,131,0.86,43,43,64
OceanDNA-b4249,812,6.9,0.0,0.00016,0.23,161,197,122,162,100,174,0.86,36,40,74
OceanDNA-b22351,537,10.3,0.0,1.5e-05,0.014,153,188,34,68,29,87,0.86,35,34,58
OceanDNA-b23417,1401,12.8,0.1,7.8e-06,0.0076,80,188,191,301,129,317,0.86,108,110,188
OceanDNA-b4608,21,15.2,0.0,4.8e-07,0.00025,194,270,185,261,180,286,0.86,76,76,106
OceanDNA-b24595,2814,11.4,0.0,6.7e-06,0.024,197,230,236,269,228,284,0.86,33,33,56
OceanDNA-b40777,1138,202.0,0.0,1.2e-63,6.9e-61,48,275,36,278,10,289,0.86,227,242,279
OceanDNA-b31192,461,9.9,0.0,2e-05,0.015,156,192,62,100,51,111,0.86,36,38,60
OceanDNA-b27600,381,12.5,0.0,3.1e-06,0.005,154,179,147,172,129,186,0.86,25,25,57
OceanDNA-b37918,626,16.1,0.0,2.6e-07,0.0002,154,184,32,62,21,91,0.86,30,30,70
OceanDNA-b21507,90,3.7,0.0,0.0015,0.26,216,255,192,231,182,251,0.86,39,39,69
OceanDNA-b31981,881,14.2,0.0,1.9e-06,0.0022,162,214,141,196,135,242,0.86,52,55,107
OceanDNA-b45383,5853,11.1,0.0,8.8e-06,0.079,160,220,15,75,8,88,0.86,60,60,80
OceanDNA-b47053,235,11.5,0.0,6.2e-06,0.0041,158,198,103,143,71,149,0.86,40,40,78
OceanDNA-b22452,985,11.2,0.0,7.8e-06,0.011,137,192,135,190,111,221,0.86,55,55,110
OceanDNA-b44480,233,17.5,0.0,9.6e-08,3.3e-05,153,185,171,203,150,217,0.86,32,32,67
OceanDNA-b46349,97,16.2,0.1,2.4e-07,0.00061,151,185,247,281,238,285,0.86,34,34,47
OceanDNA-b20043,325,13.2,0.0,4e-06,0.00067,151,198,172,223,165,247,0.86,47,51,82
OceanDNA-b40669,87,3.2,0.0,0.0044,1.4,161,185,146,170,132,203,0.86,24,24,71
OceanDNA-b13286,751,12.4,0.0,3.4e-06,0.0045,29,106,48,128,34,135,0.86,77,80,101
OceanDNA-b22985,3018,10.2,2.2,3.1e-05,0.053,145,185,85,125,78,130,0.86,40,40,52
OceanDNA-b30042,2509,13.5,0.0,3.1e-06,0.0053,149,185,118,154,111,162,0.86,36,36,51
OceanDNA-b22656,602,10.3,0.0,1.5e-05,0.012,149,188,258,297,243,304,0.86,39,39,61
OceanDNA-b17033,596,11.7,0.0,1.1e-05,0.0086,153,186,107,140,97,145,0.86,33,33,48
OceanDNA-b27491,217,13.6,0.0,1.5e-06,0.00041,150,204,216,269,181,282,0.86,54,53,101
OceanDNA-b20918,1140,14.5,0.0,1.6e-06,0.0026,149,214,223,289,202,297,0.86,65,66,95
OceanDNA-b46646,996,12.9,0.1,2.3e-06,0.008,153,183,252,282,238,297,0.86,30,30,59
OceanDNA-b36862,966,20.1,0.0,1.5e-08,1.7e-05,153,187,176,210,149,276,0.86,34,34,127
OceanDNA-b46982,311,19.9,0.0,3.5e-08,1.2e-05,138,186,110,159,92,170,0.86,48,49,78
OceanDNA-b20976,3532,8.1,0.0,7.1e-05,0.44,154,181,126,153,112,169,0.86,27,27,57
OceanDNA-b46188,73,5.4,0.0,0.00047,0.38,197,262,178,240,170,243,0.86,65,62,73
OceanDNA-b23468,540,15.9,0.0,3e-07,0.00081,155,183,139,167,124,179,0.86,28,28,55
OceanDNA-b35493,143,11.7,0.0,5.7e-06,0.0012,153,215,110,175,5,212,0.86,62,65,207
OceanDNA-b466,148,13.5,0.0,3.1e-06,0.0045,153,182,143,172,125,179,0.86,29,29,54
OceanDNA-b4007,753,14.5,0.2,8e-07,0.00083,193,266,194,265,188,283,0.86,73,71,95
OceanDNA-b17033,808,13.3,0.0,3.7e-06,0.003,180,230,231,282,220,315,0.86,50,51,95
OceanDNA-b40884,305,24.9,0.0,5.5e-10,2.1e-07,138,181,125,170,116,189,0.86,43,45,73
OceanDNA-b40947,36,116.7,0.1,1.2e-37,4.6e-35,67,266,69,282,8,297,0.86,199,213,289
OceanDNA-b22397,2422,13.6,0.0,5.8e-06,0.0038,153,178,246,271,236,278,0.86,25,25,42
OceanDNA-b22178,122,-0.2,0.0,0.023,8.1,82,103,262,283,256,288,0.86,21,21,32
OceanDNA-b34788,303,15.4,0.0,4.1e-07,0.00026,138,185,139,187,130,196,0.86,47,48,66
OceanDNA-b9684,662,16.5,0.1,3.9e-07,0.00014,144,191,75,123,70,132,0.86,47,48,62
OceanDNA-b2854,33,11.5,0.0,1.3e-05,0.023,139,172,226,259,216,277,0.86,33,33,61
OceanDNA-b27556,2014,2.3,0.0,0.013,9.0,157,182,68,93,55,104,0.86,25,25,49
OceanDNA-b33411,1017,8.3,0.0,0.00012,0.081,124,187,222,287,211,309,0.86,63,65,98
OceanDNA-b45612,488,6.3,0.0,0.00024,0.12,152,189,164,201,143,228,0.86,37,37,85
OceanDNA-b19079,130,18.3,0.0,5.3e-08,1.7e-05,152,188,125,162,104,216,0.86,36,37,112
OceanDNA-b28259,95,18.9,0.0,3.7e-08,1.5e-05,154,185,139,170,122,180,0.86,31,31,58
OceanDNA-b24654,471,14.6,0.0,7.1e-07,0.00051,76,119,51,96,23,104,0.86,43,45,81
OceanDNA-b25128,263,13.3,0.0,3.6e-06,0.0016,197,245,340,386,332,406,0.86,48,46,74
OceanDNA-b1345,2514,5.9,0.0,0.00034,0.92,155,180,97,122,78,130,0.86,25,25,52
OceanDNA-b17430,13,10.4,0.0,1.3e-05,0.029,155,175,116,136,99,143,0.86,20,20,44
OceanDNA-b46722,1228,13.8,0.0,2.6e-06,0.0021,151,186,159,194,146,206,0.86,35,35,60
OceanDNA-b30025,2079,19.2,0.0,2.8e-08,7e-05,140,179,131,172,124,206,0.86,39,41,82
OceanDNA-b45445,755,14.4,0.0,8.6e-07,0.0015,153,184,129,160,113,176,0.86,31,31,63
OceanDNA-b38376,2262,11.5,0.0,2.5e-05,0.016,141,182,104,148,97,159,0.86,41,44,62
OceanDNA-b41592,139,10.1,0.0,1.7e-05,0.0089,157,186,162,191,150,230,0.86,29,29,80
OceanDNA-b22406,1775,19.1,0.0,1.6e-07,9.2e-05,154,214,170,232,162,261,0.86,60,62,99
OceanDNA-b10017,7,1.1,0.0,0.0093,6.8,192,214,210,232,207,256,0.86,22,22,49
OceanDNA-b33515,491,7.3,0.0,0.00012,0.18,151,196,212,258,208,286,0.86,45,46,78
OceanDNA-b22767,1464,14.5,0.0,1.6e-06,0.0022,145,187,146,189,137,209,0.86,42,43,72
OceanDNA-b10504,90,28.8,0.0,3.4e-11,9.3e-09,139,198,123,183,87,206,0.86,59,60,119
OceanDNA-b4339,186,38.7,0.0,3.3e-14,8.5e-12,152,243,143,236,115,244,0.86,91,93,129
OceanDNA-b29496,1108,13.1,0.1,4e-06,0.0053,157,182,149,174,110,206,0.86,25,25,96
OceanDNA-b28125,933,17.3,0.0,1.1e-07,0.00029,153,180,180,207,164,244,0.86,27,27,80
OceanDNA-b11787,224,39.5,0.0,1.9e-14,1.3e-11,76,243,138,311,135,319,0.86,167,173,184
OceanDNA-b6501,215,12.5,0.0,6.4e-06,0.0016,198,264,611,679,606,680,0.86,66,68,74
OceanDNA-b322,447,12.4,0.0,3.5e-06,0.0018,102,135,17,50,9,94,0.86,33,33,85
OceanDNA-b46296,2016,12.3,0.0,3.6e-06,0.0098,152,184,205,237,189,252,0.86,32,32,63
OceanDNA-b32285,973,13.0,0.0,2.3e-06,0.0023,157,181,149,173,131,191,0.86,24,24,60
OceanDNA-b23508,519,2.9,0.0,0.0027,4.0,161,190,95,123,67,135,0.86,29,28,68
OceanDNA-b30082,62,11.0,0.1,1.9e-05,0.016,161,185,103,127,95,136,0.86,24,24,41
OceanDNA-b15777,892,11.2,0.0,2.3e-05,0.013,197,243,199,243,184,248,0.86,46,44,64
OceanDNA-b496,923,16.2,0.0,4.8e-07,0.00062,153,182,104,133,86,140,0.86,29,29,54
OceanDNA-b30459,1839,8.1,0.1,6.8e-05,0.17,157,187,174,204,161,214,0.86,30,30,53
OceanDNA-b40262,146,-3.7,0.0,0.27,130.0,195,213,277,295,276,304,0.86,18,18,28
OceanDNA-b43563,496,9.8,0.1,2.1e-05,0.023,154,181,97,124,89,137,0.86,27,27,48
OceanDNA-b25111,205,13.8,0.1,1.3e-06,0.0015,161,188,117,144,105,164,0.86,27,27,59
OceanDNA-b34299,307,11.0,0.0,1.8e-05,0.018,108,180,452,528,449,542,0.86,72,76,93
OceanDNA-b4494,680,6.7,0.0,0.00038,0.22,192,256,219,282,213,288,0.86,64,63,75
OceanDNA-b30046,1421,3.9,0.0,0.0027,4.0,151,185,175,209,166,220,0.86,34,34,54
OceanDNA-b3624,700,3.0,0.0,0.0025,2.0,145,189,139,184,131,191,0.86,44,45,60
OceanDNA-b32757,170,11.3,0.0,7.1e-06,0.0035,150,191,209,250,197,266,0.86,41,41,69
OceanDNA-b31694,127,16.7,0.0,1.6e-07,0.00022,154,181,124,151,108,163,0.86,27,27,55
OceanDNA-b32757,170,-0.3,0.0,0.026,13.0,197,218,293,314,287,327,0.86,21,21,40
OceanDNA-b34725,188,12.3,0.0,7.2e-06,0.0025,197,245,564,612,558,631,0.86,48,48,73
OceanDNA-b16265,572,3.3,0.0,0.002,2.4,91,119,124,152,111,168,0.86,28,28,57
OceanDNA-b21004,1525,12.1,0.0,1.2e-05,0.0079,181,261,188,264,183,267,0.86,80,76,84
OceanDNA-b20913,6767,11.2,0.1,1.6e-05,0.061,161,184,133,156,126,168,0.86,23,23,42
OceanDNA-b26750,148,9.7,0.0,2.2e-05,0.014,181,215,236,271,225,286,0.86,34,35,61
OceanDNA-b26750,148,0.7,0.2,0.012,7.6,161,175,126,140,121,143,0.86,14,14,22
OceanDNA-b20657,47,50.0,0.1,2.3e-17,3.6e-15,54,190,64,207,60,214,0.86,136,143,154
OceanDNA-b6558,462,10.7,0.0,2.2e-05,0.012,154,185,406,437,390,443,0.86,31,31,53
OceanDNA-b22965,2488,11.1,0.0,8.8e-06,0.039,149,180,96,127,78,135,0.86,31,31,57
OceanDNA-b10067,117,3.5,0.0,0.0018,0.85,153,190,535,572,520,582,0.86,37,37,62
OceanDNA-b46702,1106,13.8,0.0,2.6e-06,0.0023,151,186,159,194,146,206,0.86,35,35,60
OceanDNA-b9937,387,8.9,0.0,4e-05,0.017,134,187,99,150,86,156,0.86,53,51,70
OceanDNA-b32271,1556,18.5,0.0,4.9e-08,8.7e-05,155,182,145,172,129,191,0.86,27,27,62
OceanDNA-b23344,1819,13.3,0.1,1.8e-06,0.0035,160,182,100,122,87,132,0.86,22,22,45
OceanDNA-b2837,2702,11.5,0.1,6.5e-06,0.02,160,187,72,99,47,105,0.86,27,27,58
OceanDNA-b2837,2702,3.3,0.1,0.0021,6.3,199,217,185,203,175,210,0.86,18,18,35
OceanDNA-b25279,160,13.6,0.0,1.4e-06,0.0003,160,187,95,122,87,131,0.86,27,27,44
OceanDNA-b16133,1080,12.0,0.0,1.4e-05,0.0052,158,181,156,179,137,200,0.86,23,23,63
OceanDNA-b24680,406,-1.0,0.0,0.04,34.0,248,286,278,316,271,320,0.86,38,38,49
OceanDNA-b14467,90,16.4,0.1,2.1e-07,5.2e-05,109,184,113,187,100,196,0.86,75,74,96
OceanDNA-b22859,218,12.7,0.0,2.7e-06,0.0077,146,185,241,280,228,286,0.86,39,39,58
OceanDNA-b31510,971,2.5,0.0,0.007,3.9,155,190,493,529,486,539,0.86,35,36,53
OceanDNA-b27612,1540,11.7,0.0,5.7e-06,0.014,154,176,153,175,135,198,0.86,22,22,63
OceanDNA-b22131,703,18.1,0.0,1.2e-07,5.1e-05,154,217,410,473,401,488,0.86,63,63,87
OceanDNA-b4488,407,12.4,0.1,3.4e-06,0.0091,156,191,93,129,76,137,0.86,35,36,61
OceanDNA-b31076,1192,7.3,0.0,0.00036,0.36,150,194,264,309,255,316,0.86,44,45,61
OceanDNA-a4358,55,1.3,0.0,0.0081,2.9,92,120,234,262,224,327,0.86,28,28,103
OceanDNA-b28506,368,11.4,0.0,6.8e-06,0.0037,160,180,150,170,138,204,0.86,20,20,66
OceanDNA-b42457,240,5.4,0.0,0.00047,0.15,196,239,268,310,263,331,0.86,43,42,68
OceanDNA-b23463,1474,11.4,0.1,6.9e-06,0.013,159,185,40,66,30,74,0.86,26,26,44
OceanDNA-b37268,282,22.3,0.0,3.3e-09,5.3e-06,153,181,143,171,124,191,0.86,28,28,67
OceanDNA-b9609,10,21.1,0.1,7.4e-09,2.3e-06,151,195,136,183,45,189,0.86,44,47,144
OceanDNA-b16121,452,9.4,0.0,2.8e-05,0.021,148,181,341,374,321,387,0.86,33,33,66
OceanDNA-b22498,2435,14.5,0.0,7.9e-07,0.0024,148,187,150,190,139,199,0.86,39,40,60
OceanDNA-b5623,189,15.5,0.0,3.9e-07,0.00012,151,232,145,225,134,246,0.86,81,80,112
OceanDNA-b38157,624,14.3,0.3,9.2e-07,0.00066,42,76,48,82,21,90,0.86,34,34,69
OceanDNA-b47086,2846,3.0,0.0,0.0049,10.0,194,219,225,250,217,278,0.86,25,25,61
OceanDNA-b23966,184,7.4,0.1,0.00012,0.26,153,182,177,206,167,221,0.86,29,29,54
OceanDNA-b23517,316,10.5,0.0,1.3e-05,0.019,152,180,92,120,74,128,0.86,28,28,54
OceanDNA-b23825,839,9.7,0.1,4.6e-05,0.037,159,188,133,162,116,194,0.86,29,29,78
OceanDNA-b1773,1318,11.0,0.1,9.3e-06,0.019,159,186,4,31,2,50,0.86,27,27,48
OceanDNA-b5399,377,43.4,0.1,1.2e-15,6.3e-13,156,245,147,239,124,250,0.86,89,92,126
OceanDNA-b22548,674,12.6,0.0,6.1e-06,0.0039,109,185,518,593,510,636,0.86,76,75,126
OceanDNA-b9835,190,13.3,0.0,1.8e-06,0.00052,144,188,69,113,39,124,0.86,44,44,85
OceanDNA-b34949,338,11.5,0.0,1.9e-05,0.0062,71,122,19,70,4,158,0.86,51,51,154
OceanDNA-b22993,1301,17.4,0.0,1e-07,0.00014,130,174,91,137,17,150,0.86,44,46,133
OceanDNA-b33388,2817,18.7,0.0,1.3e-07,0.00016,154,185,414,445,400,466,0.86,31,31,66
OceanDNA-b46684,393,10.5,0.0,2.5e-05,0.0096,153,186,135,168,121,202,0.86,33,33,81
OceanDNA-b9797,260,3.4,0.0,0.0018,0.92,147,189,124,166,111,179,0.86,42,42,68
OceanDNA-b30722,230,13.2,0.0,2e-06,0.0019,153,179,143,169,128,189,0.86,26,26,61
OceanDNA-b9009,46,16.8,0.0,3.2e-07,3.5e-05,150,188,146,185,135,193,0.86,38,39,58
OceanDNA-b19665,86,-0.4,0.0,0.027,13.0,91,120,227,256,219,262,0.86,29,29,43
OceanDNA-b22478,1038,9.9,0.0,4e-05,0.047,150,191,136,177,123,187,0.86,41,41,64
OceanDNA-b1657,50,13.2,0.0,3.8e-06,0.0016,126,188,89,147,71,212,0.86,62,58,141
OceanDNA-b15470,77,10.2,0.0,1.6e-05,0.015,148,193,161,206,141,226,0.86,45,45,85
OceanDNA-b24705,1141,13.6,0.0,1.5e-06,0.0034,153,213,213,275,185,293,0.86,60,62,108
OceanDNA-b22478,650,12.4,0.0,7e-06,0.0082,153,188,226,260,214,343,0.86,35,34,129
OceanDNA-b33394,1170,15.3,0.1,8.9e-07,0.0012,157,184,70,97,62,108,0.86,27,27,46
OceanDNA-b6501,409,7.5,0.0,0.00021,0.053,150,185,238,273,219,281,0.85,35,35,62
OceanDNA-b35823,451,14.1,0.0,3.2e-06,0.0047,146,180,139,173,127,183,0.85,34,34,56
OceanDNA-b22885,443,11.7,0.0,5.7e-06,0.024,149,181,241,273,222,284,0.85,32,32,62
OceanDNA-b3681,100,6.2,0.0,0.00026,0.39,161,187,122,148,55,165,0.85,26,26,110
OceanDNA-b44609,332,5.1,0.0,0.0011,1.0,154,182,546,574,530,581,0.85,28,28,51
OceanDNA-b30095,1634,11.1,0.0,2.5e-05,0.021,160,183,83,106,73,132,0.85,23,23,59
OceanDNA-b23525,1023,7.9,0.0,8.1e-05,0.16,197,268,200,269,193,276,0.85,71,69,83
OceanDNA-b17609,3614,-1.0,0.0,0.042,200.0,202,220,306,324,302,365,0.85,18,18,63
OceanDNA-b26901,3435,8.2,0.1,6.5e-05,0.25,160,187,139,166,85,183,0.85,27,27,98
OceanDNA-b22760,2709,1.1,0.0,0.0095,34.0,105,122,186,203,172,208,0.85,17,17,36
OceanDNA-b37433,682,9.0,0.0,3.6e-05,0.043,146,187,125,166,114,180,0.85,41,41,66
OceanDNA-b36740,366,2.3,0.0,0.0041,2.3,197,238,265,305,260,309,0.85,41,40,49
OceanDNA-b17579,139,21.7,0.0,4.9e-09,1.5e-05,145,192,161,210,145,223,0.85,47,49,78
OceanDNA-b15108,1673,11.5,0.0,6.6e-06,0.011,150,197,307,355,292,383,0.85,47,48,91
OceanDNA-b11625,571,16.3,0.0,2.3e-07,0.00036,135,191,250,307,221,318,0.85,56,57,97
OceanDNA-b36617,25,10.4,0.0,2.7e-05,0.013,160,192,199,231,165,243,0.85,32,32,78
OceanDNA-b22386,1518,17.6,0.0,3.6e-07,0.00019,142,192,79,129,68,141,0.85,50,50,73
OceanDNA-b22387,1226,14.4,0.0,1.7e-06,0.0019,145,192,260,307,247,318,0.85,47,47,71
OceanDNA-b46717,981,18.9,0.0,7e-08,0.00012,152,187,222,258,213,273,0.85,35,36,60
OceanDNA-b13084,1039,16.1,0.2,5.1e-07,0.00065,82,168,60,147,10,155,0.85,86,87,145
OceanDNA-b10366,399,1.0,0.0,0.02,16.0,158,175,149,166,134,225,0.85,17,17,91
OceanDNA-b30045,558,18.7,0.0,4.2e-08,0.00011,140,179,154,195,150,207,0.85,39,41,57
OceanDNA-b30046,2482,6.1,0.0,0.00057,0.85,195,235,192,232,184,244,0.85,40,40,60
OceanDNA-b15711,143,17.3,0.0,2.3e-07,0.00013,122,197,82,150,53,161,0.85,75,68,108
OceanDNA-b36649,521,24.2,0.0,8.6e-10,7e-07,154,190,261,298,246,356,0.85,36,37,110
OceanDNA-b46939,472,-3.8,0.0,0.3,390.0,155,168,38,51,36,56,0.85,13,13,20
OceanDNA-b15333,114,7.7,0.0,9.4e-05,0.029,155,181,136,162,122,170,0.85,26,26,48
OceanDNA-b36646,1282,-0.2,0.0,0.023,47.0,196,217,247,268,223,275,0.85,21,21,52
OceanDNA-b22178,122,9.2,0.0,3.3e-05,0.011,152,196,489,533,472,555,0.85,44,44,83
OceanDNA-b43704,915,11.0,0.0,9e-06,0.0097,158,187,119,149,108,162,0.85,29,30,54
OceanDNA-b30408,365,13.1,0.0,2.1e-06,0.0048,165,231,282,350,265,375,0.85,66,68,110
OceanDNA-b9654,563,12.7,0.0,5.7e-06,0.0016,160,183,157,180,140,190,0.85,23,23,50
OceanDNA-b23909,99,7.4,0.0,0.00023,0.22,197,243,272,317,268,323,0.85,46,45,55
OceanDNA-b30001,1264,3.6,0.0,0.0032,2.6,148,183,129,164,113,178,0.85,35,35,65
OceanDNA-b27570,926,15.8,0.0,3.1e-07,0.00087,154,180,150,176,133,190,0.85,26,26,57
OceanDNA-b16121,452,3.5,0.0,0.0017,1.3,89,122,262,295,247,315,0.85,33,33,68
OceanDNA-b39186,25,20.9,0.0,9e-09,4.9e-06,139,185,129,177,123,187,0.85,46,48,64
OceanDNA-b1719,2754,13.8,0.0,2.6e-06,0.0038,155,182,105,132,87,139,0.85,27,27,52
OceanDNA-b23292,1686,11.5,0.0,1.3e-05,0.013,144,182,69,110,52,126,0.85,38,41,74
OceanDNA-b22383,761,10.5,0.0,2.6e-05,0.045,135,173,241,273,224,286,0.85,38,32,62
OceanDNA-b5580,188,42.7,0.1,3.9e-15,9.2e-13,158,244,148,237,120,250,0.85,86,89,130
OceanDNA-b35240,640,5.4,0.0,0.00047,0.5,159,190,162,194,151,204,0.85,31,32,53
OceanDNA-b20893,1271,14.0,0.0,1.1e-06,0.0065,178,245,320,389,314,398,0.85,67,69,84
OceanDNA-b394,393,20.9,0.0,8.5e-09,8.6e-06,129,188,182,236,100,262,0.85,59,54,162
OceanDNA-b23559,253,2.5,0.0,0.0034,5.5,202,223,239,260,234,275,0.85,21,21,41
OceanDNA-b31115,69,11.2,0.0,7.7e-06,0.0062,192,233,197,237,181,252,0.85,41,40,71
OceanDNA-b27525,1050,12.0,0.0,1.8e-05,0.012,176,245,337,411,324,466,0.85,69,74,142
OceanDNA-b20413,301,1.1,0.0,0.0094,3.0,160,179,147,166,129,180,0.85,19,19,51
OceanDNA-b32734,108,0.1,0.0,0.019,7.2,197,215,202,220,196,233,0.85,18,18,37
OceanDNA-b23103,4082,16.1,0.0,2.6e-07,0.0013,149,196,92,140,84,145,0.85,47,48,61
OceanDNA-b19767,37,3.5,0.0,0.0018,0.55,85,120,35,70,26,89,0.85,35,35,63
OceanDNA-b32762,963,18.3,0.1,5.3e-08,8.3e-05,88,196,65,176,20,185,0.85,108,111,165
OceanDNA-b22449,284,16.4,0.0,4e-07,0.00032,107,182,144,220,134,239,0.85,75,76,105
OceanDNA-b47086,2846,9.5,0.1,5.3e-05,0.11,150,189,103,142,91,161,0.85,39,39,70
OceanDNA-b24680,406,10.3,0.1,1.5e-05,0.013,77,118,45,88,38,97,0.85,41,43,59
OceanDNA-b30373,1656,13.8,0.0,1.3e-06,0.0033,154,177,169,192,161,227,0.85,23,23,66
OceanDNA-b3934,51,1.7,0.0,0.012,4.4,254,282,363,391,356,404,0.85,28,28,48
OceanDNA-b41340,879,3.5,0.0,0.0034,2.5,197,217,227,247,219,265,0.85,20,20,46
OceanDNA-b4116,368,2.0,0.0,0.005,3.3,153,181,135,163,125,171,0.85,28,28,46
OceanDNA-b22890,1494,12.1,0.0,1.3e-05,0.0088,148,212,61,124,46,144,0.85,64,63,98
OceanDNA-b27586,1040,11.2,0.1,8.1e-06,0.016,161,184,183,206,170,218,0.85,23,23,48
OceanDNA-b15461,1544,9.3,0.0,3e-05,0.057,195,245,231,278,143,286,0.85,50,47,143
OceanDNA-b38495,642,10.3,0.0,4.5e-05,0.012,152,184,131,163,114,178,0.85,32,32,64
OceanDNA-b19786,331,10.1,0.0,1.8e-05,0.007,153,195,164,206,154,240,0.85,42,42,86
OceanDNA-b41695,55,14.3,0.0,1.8e-06,0.00017,141,187,89,137,66,150,0.85,46,48,84
OceanDNA-b2923,446,10.3,0.1,2.9e-05,0.028,158,187,350,379,333,389,0.85,29,29,56
OceanDNA-b23489,873,10.4,0.1,1.4e-05,0.031,159,184,134,159,127,169,0.85,25,25,42
OceanDNA-b22840,3818,0.3,0.0,0.051,72.0,195,230,270,304,258,327,0.85,35,34,69
OceanDNA-b40552,42,23.9,0.0,1e-09,4.6e-07,139,185,123,171,114,190,0.85,46,48,76
OceanDNA-b21040,1032,17.5,0.0,3e-07,0.00046,146,197,395,447,386,454,0.85,51,52,68
OceanDNA-b20908,8483,1.5,0.0,0.0069,68.0,253,285,283,315,266,320,0.85,32,32,54
OceanDNA-b46908,1333,10.1,0.0,1.7e-05,0.058,155,190,390,426,378,434,0.85,35,36,56
OceanDNA-b31685,2065,0.2,0.1,0.035,41.0,152,185,181,216,162,251,0.85,33,35,89
OceanDNA-b36084,2329,0.2,0.0,0.018,48.0,254,266,449,461,440,464,0.85,12,12,24
OceanDNA-b34301,471,12.5,0.0,3.1e-06,0.0023,197,265,334,404,302,406,0.85,68,70,104
OceanDNA-b6205,629,11.5,0.0,6.3e-06,0.0045,113,144,47,78,38,89,0.85,31,31,51
OceanDNA-b23003,1276,16.5,0.0,7.9e-07,0.00049,153,188,285,321,264,375,0.85,35,36,111
OceanDNA-b23364,1374,-2.6,0.0,0.13,300.0,61,76,97,112,92,119,0.85,15,15,27
OceanDNA-b30854,1876,21.8,0.7,9.6e-09,1.1e-05,88,183,112,214,29,227,0.85,95,102,198
OceanDNA-b46558,138,15.4,0.0,8.4e-07,0.00026,144,193,44,93,30,120,0.85,49,49,90
OceanDNA-b22249,621,8.9,0.0,3.9e-05,0.12,159,183,166,190,152,196,0.85,24,24,44
OceanDNA-b13590,1708,2.7,0.0,0.012,9.0,200,237,227,263,220,272,0.85,37,36,52
OceanDNA-b22396,1374,11.4,0.0,6.9e-06,0.019,150,193,215,258,202,264,0.85,43,43,62
OceanDNA-b21002,2996,10.4,0.0,2.8e-05,0.08,197,245,352,398,324,413,0.85,48,46,89
OceanDNA-b13204,619,14.3,0.0,9e-07,0.00072,140,185,154,199,150,210,0.85,45,45,60
OceanDNA-b22461,3942,19.4,0.0,7.8e-08,0.00012,153,188,180,216,158,245,0.85,35,36,87
OceanDNA-b202,123,17.5,0.0,2.9e-07,0.00022,152,215,458,523,434,536,0.85,63,65,102
OceanDNA-b3192,1198,10.6,0.0,1.2e-05,0.018,53,116,625,691,617,698,0.85,63,66,81
OceanDNA-b202,248,5.5,0.0,0.0013,0.99,158,177,81,100,65,114,0.85,19,19,49
OceanDNA-b30710,1009,10.7,0.0,1.1e-05,0.026,159,187,163,191,137,197,0.85,28,28,60
OceanDNA-b26167,208,14.0,0.0,1.1e-06,0.00097,87,183,60,160,51,175,0.85,96,100,124
OceanDNA-b29503,1498,5.4,0.0,0.00094,1.9,156,183,70,97,57,134,0.85,27,27,77
OceanDNA-b28045,26,16.3,0.0,2.3e-07,0.00028,153,181,170,198,149,217,0.85,28,28,68
OceanDNA-b10365,327,15.2,0.0,4.7e-07,0.00032,159,235,147,225,132,231,0.85,76,78,99
OceanDNA-b31573,692,12.4,0.0,6.9e-06,0.0064,154,181,161,188,145,205,0.85,27,27,60
OceanDNA-b22840,3818,-1.8,0.0,0.22,310.0,212,241,21,50,18,64,0.85,29,29,46
OceanDNA-b22840,1018,13.7,0.0,4.2e-06,0.0059,146,180,227,261,211,269,0.85,34,34,58
OceanDNA-b31120,118,11.8,0.0,1.6e-05,0.0058,159,181,145,167,125,186,0.85,22,22,61
OceanDNA-b7470,187,17.3,0.0,1.1e-07,6.2e-05,133,183,99,148,85,165,0.85,50,49,80
OceanDNA-b36139,1700,13.5,0.0,3.1e-06,0.003,139,198,130,188,118,196,0.85,59,58,78
OceanDNA-b22944,383,10.8,0.0,1e-05,0.044,148,180,296,328,279,336,0.85,32,32,57
OceanDNA-b46819,1594,11.5,0.0,6.3e-06,0.023,148,187,244,285,225,341,0.85,39,41,116
OceanDNA-b23907,1575,7.1,0.0,0.00028,0.28,195,231,254,290,242,316,0.85,36,36,74
OceanDNA-b16227,471,-0.6,0.0,0.096,33.0,89,120,300,331,288,338,0.85,31,31,50
OceanDNA-b23907,1575,7.0,0.1,0.0003,0.3,160,182,134,156,124,166,0.85,22,22,42
OceanDNA-b16127,558,12.0,0.0,4.5e-06,0.0028,151,185,166,200,148,219,0.85,34,34,71
OceanDNA-b20820,150,10.6,0.0,1.2e-05,0.0071,154,192,240,278,207,287,0.85,38,38,80
OceanDNA-b22976,1905,30.6,0.0,9.8e-12,4.6e-08,153,247,186,284,170,291,0.85,94,98,121
OceanDNA-b10020,85,10.2,0.0,3.2e-05,0.0079,193,266,194,265,186,279,0.85,73,71,93
OceanDNA-b15517,600,13.0,0.0,2.3e-06,0.0026,123,196,87,153,59,161,0.85,73,66,102
OceanDNA-b34918,448,11.6,0.0,1.8e-05,0.0064,178,246,312,386,307,450,0.85,68,74,143
OceanDNA-b3695,832,2.7,0.0,0.0059,5.4,148,180,158,190,145,198,0.85,32,32,53
OceanDNA-b46919,1190,9.2,0.0,3.2e-05,0.05,136,185,204,254,197,258,0.85,49,50,61
OceanDNA-b26071,297,13.0,0.0,2.2e-06,0.00069,158,180,151,173,130,196,0.85,22,22,66
OceanDNA-b35243,734,5.3,0.0,0.00051,0.49,159,190,170,202,159,213,0.85,31,32,54
OceanDNA-b2585,1160,11.3,0.0,7.4e-06,0.018,53,120,421,491,412,497,0.85,67,70,85
OceanDNA-b46265,1268,10.9,0.0,1.9e-05,0.018,153,185,239,271,224,275,0.85,32,32,51
OceanDNA-b40548,301,3.2,0.0,0.0022,2.5,195,238,303,347,295,354,0.85,43,44,59
OceanDNA-b31535,300,16.0,0.0,2.8e-07,0.00078,155,180,161,186,142,207,0.85,25,25,65
OceanDNA-b11002,150,15.9,0.0,2.9e-07,7.7e-05,153,217,151,217,144,243,0.85,64,66,99
OceanDNA-b4726,421,12.7,0.0,2.7e-06,0.0021,158,181,114,137,109,187,0.85,23,23,78
OceanDNA-b22656,602,2.2,0.0,0.0045,3.7,105,122,198,215,184,220,0.85,17,17,36
OceanDNA-b2854,2986,2.0,0.0,0.01,18.0,192,231,239,277,227,290,0.85,39,38,63
OceanDNA-b32055,868,11.7,0.0,5.4e-06,0.011,152,186,191,225,100,234,0.85,34,34,134
OceanDNA-b18473,63,1.3,0.0,0.0081,3.8,83,118,215,250,210,264,0.85,35,35,54
OceanDNA-b20922,6387,13.9,0.1,2.5e-06,0.0085,138,185,160,207,146,230,0.85,47,47,84
OceanDNA-b37510,372,-1.5,0.0,0.12,98.0,157,189,544,576,527,582,0.85,32,32,55
OceanDNA-b27523,377,12.3,0.0,7.3e-06,0.0048,153,179,204,230,187,253,0.85,26,26,66
OceanDNA-b38602,444,11.5,0.0,6.6e-06,0.0038,118,191,83,159,77,200,0.85,73,76,123
OceanDNA-b1347,104,11.5,0.0,1.9e-05,0.009,151,189,98,134,23,156,0.85,38,36,133
OceanDNA-b288,2663,33.7,0.0,1.1e-12,3.3e-09,151,245,221,317,208,326,0.85,94,96,118
OceanDNA-b37653,1001,-3.6,0.0,0.25,270.0,255,278,376,399,369,404,0.85,23,23,35
OceanDNA-b29,914,13.3,0.0,7.4e-06,0.0094,153,188,113,148,82,186,0.85,35,35,104
OceanDNA-b46530,745,-2.9,0.0,0.16,190.0,226,257,288,319,287,320,0.85,31,31,33
OceanDNA-b29285,62,6.9,0.0,0.00017,0.28,195,220,173,198,158,213,0.85,25,25,55
OceanDNA-b2928,1170,9.4,0.1,2.8e-05,0.034,152,180,144,172,90,175,0.85,28,28,85
OceanDNA-b11706,669,10.1,0.0,1.7e-05,0.015,186,216,217,247,205,256,0.85,30,30,51
OceanDNA-b16198,1641,12.3,0.0,3.7e-06,0.0065,131,176,25,70,8,77,0.85,45,45,69
OceanDNA-b23401,359,17.2,0.0,1.2e-07,0.00026,147,187,550,592,539,595,0.85,40,42,56
OceanDNA-b40457,1543,10.2,0.1,1.6e-05,0.025,199,250,283,330,278,341,0.85,51,47,63
OceanDNA-b39304,776,17.9,0.0,7.4e-08,9e-05,150,187,164,201,110,224,0.85,37,37,114
OceanDNA-b46921,2182,12.4,0.1,1e-05,0.0082,25,104,22,104,3,116,0.85,79,82,113
OceanDNA-b35286,34,18.2,0.0,5.8e-08,3.9e-05,139,182,128,172,120,192,0.85,43,44,72
OceanDNA-b30703,272,13.7,0.0,1.3e-06,0.0024,154,180,144,170,127,189,0.85,26,26,62
OceanDNA-b11624,517,12.0,0.0,4.7e-06,0.0047,186,220,294,328,282,332,0.85,34,34,50
OceanDNA-b24103,1975,13.8,0.0,1.3e-06,0.0033,160,185,85,110,56,120,0.85,25,25,64
OceanDNA-b10018,226,10.5,0.0,1.3e-05,0.0093,175,224,153,204,135,228,0.85,49,51,93
OceanDNA-b13261,228,52.5,0.0,4.2e-18,2.5e-15,107,270,184,344,168,364,0.85,163,160,196
OceanDNA-b36751,119,8.6,0.0,9.9e-05,0.031,149,187,78,116,62,123,0.85,38,38,61
OceanDNA-b37076,208,7.1,0.0,0.00014,0.16,89,121,150,182,134,189,0.85,32,32,55
OceanDNA-b4114,21,10.9,0.0,1e-05,0.006,147,184,162,199,152,240,0.85,37,37,88
OceanDNA-b7194,370,21.9,0.2,1.3e-08,3.6e-06,158,248,131,222,126,256,0.85,90,91,130
OceanDNA-b36751,119,0.2,0.0,0.036,11.0,197,212,192,207,186,214,0.85,15,15,28
OceanDNA-b7194,522,11.3,0.0,2.3e-05,0.0064,152,185,149,182,120,220,0.85,33,33,100
OceanDNA-b26761,515,17.0,0.0,1.4e-07,0.00012,139,185,127,174,121,184,0.85,46,47,63
OceanDNA-b3605,370,20.9,0.0,8.6e-09,1.7e-05,154,215,152,212,133,221,0.85,61,60,88
OceanDNA-b22380,1283,32.4,0.0,5.5e-12,4.3e-09,153,217,216,284,205,291,0.85,64,68,86
OceanDNA-b20043,202,105.4,0.0,3.1e-34,5.2e-32,54,282,225,465,213,474,0.85,228,240,261
OceanDNA-b12544,188,126.9,0.1,4.5e-41,1.5e-38,66,281,73,298,42,310,0.85,215,225,268
OceanDNA-b26845,3023,14.2,0.1,1.9e-06,0.003,154,179,148,173,126,187,0.85,25,25,61
OceanDNA-b26845,3023,-2.7,0.0,0.27,410.0,163,177,4,18,3,21,0.85,14,14,18
OceanDNA-b46656,646,12.7,0.0,5.5e-06,0.0093,146,188,226,268,216,277,0.85,42,42,61
OceanDNA-b16208,255,13.2,0.1,1.9e-06,0.0021,88,122,289,323,213,399,0.85,34,34,186
OceanDNA-b14324,393,9.3,0.0,3e-05,0.015,195,215,230,250,212,265,0.85,20,20,53
OceanDNA-b26926,1267,26.1,0.3,2.2e-10,6.5e-07,86,181,129,231,48,236,0.85,95,102,188
OceanDNA-b30022,2137,17.7,0.0,8.3e-08,0.00027,153,179,169,195,151,216,0.85,26,26,65
OceanDNA-b3820,2333,12.7,0.0,2.7e-06,0.0068,186,218,54,86,40,102,0.85,32,32,62
OceanDNA-b26794,727,12.5,0.0,3.1e-06,0.0073,140,187,80,127,71,137,0.85,47,47,66
OceanDNA-b2668,146,13.3,0.0,1.8e-06,0.00071,149,188,6,46,1,53,0.85,39,40,52
OceanDNA-b12722,62,10.3,0.0,1.5e-05,0.0035,192,243,209,256,202,268,0.85,51,47,66
OceanDNA-b22092,161,10.8,0.0,1e-05,0.013,158,192,337,371,315,388,0.85,34,34,73
OceanDNA-b29209,436,0.6,0.0,0.013,7.5,197,218,313,334,301,359,0.85,21,21,58
OceanDNA-b3626,407,8.8,0.1,4.2e-05,0.053,196,228,229,261,207,273,0.85,32,32,66
OceanDNA-b16135,34,14.6,0.0,2.1e-06,0.00066,154,181,146,173,128,205,0.85,27,27,77
OceanDNA-b3983,730,13.2,0.0,5.8e-06,0.002,151,187,346,383,331,403,0.85,36,37,72
OceanDNA-b28240,1776,11.1,0.2,8.6e-06,0.022,128,183,211,267,204,271,0.85,55,56,67
OceanDNA-b5721,663,8.8,0.0,4.3e-05,0.044,187,216,291,320,283,330,0.85,29,29,47
OceanDNA-b23850,1049,8.5,0.1,0.00016,0.079,159,185,110,137,98,143,0.85,26,27,45
OceanDNA-b46641,1672,-0.8,0.0,0.036,71.0,199,223,181,205,177,222,0.85,24,24,45
OceanDNA-b32108,133,22.5,0.0,5.9e-09,7.6e-06,137,203,133,198,66,237,0.85,66,65,171
OceanDNA-b23037,640,16.5,0.0,1.9e-07,0.00034,149,185,32,68,20,100,0.85,36,36,80
OceanDNA-b43429,626,11.5,0.1,6.2e-06,0.0047,143,187,106,153,72,171,0.85,44,47,99
OceanDNA-b13086,1080,11.7,0.0,5.7e-06,0.014,145,204,223,280,219,294,0.85,59,57,75
OceanDNA-b34663,386,13.0,0.0,4.4e-06,0.0018,196,247,566,617,559,635,0.85,51,51,76
OceanDNA-b33192,401,4.2,0.0,0.0022,0.47,162,197,1,40,1,57,0.85,35,39,56
OceanDNA-b31541,2238,11.5,0.3,6.3e-06,0.014,163,233,46,114,29,118,0.85,70,68,89
OceanDNA-b32911,528,5.4,0.0,0.00045,0.6,181,220,195,234,185,264,0.85,39,39,79
OceanDNA-b45271,95,14.2,0.0,2e-06,0.00048,162,194,111,145,104,152,0.85,32,34,48
OceanDNA-b6424,505,12.7,0.0,8.2e-06,0.0017,156,184,70,98,55,121,0.85,28,28,66
OceanDNA-b1825,2392,-2.5,0.0,0.12,420.0,254,279,722,747,713,752,0.85,25,25,39
OceanDNA-b19913,237,15.2,0.0,4.6e-07,0.00016,150,200,134,184,96,216,0.85,50,50,120
OceanDNA-b4882,38,114.5,0.2,2.7e-37,6.3e-35,53,286,36,283,26,291,0.85,233,247,265
OceanDNA-b35112,242,14.9,0.0,1.2e-06,0.00062,153,190,203,241,187,267,0.85,37,38,80
OceanDNA-b28321,428,12.2,0.0,3.8e-06,0.0018,154,178,2,26,1,50,0.85,24,24,49
OceanDNA-b27416,97,9.4,0.0,2.7e-05,0.0071,151,190,221,261,212,277,0.85,39,40,65
OceanDNA-b44378,1157,19.6,0.0,2.2e-08,2.9e-05,188,262,328,402,310,407,0.85,74,74,97
OceanDNA-b28203,1009,12.4,0.1,3.3e-06,0.0095,153,181,132,160,94,169,0.85,28,28,75
OceanDNA-b15938,254,12.0,0.0,4.4e-06,0.0013,157,181,100,124,66,135,0.85,24,24,69
OceanDNA-b46518,919,12.2,0.0,4e-06,0.0095,151,185,138,172,123,196,0.85,34,34,73
OceanDNA-b29526,542,4.6,0.0,0.00082,2.3,197,230,278,310,273,340,0.85,33,32,67
OceanDNA-b32606,3261,7.0,0.0,0.00015,0.65,152,169,193,210,177,223,0.85,17,17,46
OceanDNA-b22895,678,11.9,0.0,5e-06,0.0078,150,186,337,373,323,392,0.84,36,36,69
OceanDNA-b13010,20,11.6,0.0,5.9e-06,0.002,152,191,186,226,170,252,0.84,39,40,82
OceanDNA-b23644,7,-1.4,0.0,0.054,140.0,193,220,308,335,306,342,0.84,27,27,36
OceanDNA-b4488,407,10.1,0.0,1.7e-05,0.046,194,245,208,258,197,270,0.84,51,50,73
OceanDNA-b22022,855,11.0,0.0,1.9e-05,0.031,153,189,524,560,494,571,0.84,36,36,77
OceanDNA-b18640,3,24.6,0.0,1.3e-09,2.1e-07,152,185,131,164,92,183,0.84,33,33,91
OceanDNA-b22394,801,16.5,0.0,3.9e-07,0.00038,149,187,128,167,114,184,0.84,38,39,70
OceanDNA-b20491,67,2.2,0.0,0.0087,1.5,81,121,135,175,126,199,0.84,40,40,73
OceanDNA-b42439,10,15.7,0.0,3.4e-07,9.1e-05,144,189,105,151,97,155,0.84,45,46,58
OceanDNA-b16280,24,19.4,0.0,2.5e-08,7e-06,191,253,396,458,375,470,0.84,62,62,95
OceanDNA-b13296,356,8.9,0.0,3.9e-05,0.039,149,185,228,264,155,269,0.84,36,36,114
OceanDNA-b3624,700,7.6,0.0,0.0001,0.081,192,227,230,265,219,277,0.84,35,35,58
OceanDNA-b32,528,-0.4,0.0,0.052,16.0,196,215,262,281,258,291,0.84,19,19,33
OceanDNA-b12531,133,26.2,0.0,2.1e-10,7.7e-08,213,283,2,75,1,89,0.84,70,73,88
OceanDNA-b10027,423,11.0,0.1,9.1e-06,0.005,197,266,190,257,182,265,0.84,69,67,83
OceanDNA-b23275,379,19.0,0.0,3.4e-08,0.00012,140,181,149,192,135,204,0.84,41,43,69
OceanDNA-b30085,1262,13.0,0.0,7e-06,0.0051,159,183,120,144,102,155,0.84,24,24,53
OceanDNA-b3934,230,9.5,0.0,5.4e-05,0.019,191,266,181,254,175,259,0.84,75,73,84
OceanDNA-b289,3696,11.0,0.0,1.8e-05,0.035,195,240,184,227,176,235,0.84,45,43,59
OceanDNA-b32474,247,20.7,0.0,9.9e-09,3.2e-06,155,245,111,205,96,219,0.84,90,94,123
OceanDNA-b23165,145,24.9,0.0,5.4e-10,1.6e-06,147,245,214,308,195,315,0.84,98,94,120
OceanDNA-b40681,438,18.7,0.0,4.2e-08,2.1e-05,153,182,142,171,120,190,0.84,29,29,70
OceanDNA-b21009,2557,8.7,0.1,4.5e-05,0.14,130,175,654,703,647,717,0.84,45,49,70
OceanDNA-b23783,1703,12.7,0.0,2.8e-06,0.0053,153,181,224,252,139,263,0.84,28,28,124
OceanDNA-b22876,1950,-1.9,0.0,0.08,290.0,100,121,95,116,91,125,0.84,21,21,34
OceanDNA-b26776,1836,4.6,0.0,0.0017,2.0,155,187,137,169,122,182,0.84,32,32,60
OceanDNA-b21009,2557,0.8,0.0,0.012,38.0,48,85,326,364,315,367,0.84,37,38,52
OceanDNA-b20094,183,12.3,0.0,7.2e-06,0.0014,151,197,262,312,255,320,0.84,46,50,65
OceanDNA-b29080,323,17.1,0.0,1.2e-07,0.00019,153,179,134,160,117,198,0.84,26,26,81
OceanDNA-b26769,766,8.5,0.1,5.3e-05,0.11,196,217,244,265,237,292,0.84,21,21,55
OceanDNA-b30134,407,-2.9,0.0,0.15,350.0,228,247,187,206,183,211,0.84,19,19,28
OceanDNA-b20559,114,3.0,0.1,0.0025,0.77,78,121,131,176,124,188,0.84,43,45,64
OceanDNA-b27448,73,24.3,0.0,8.3e-10,2.2e-07,192,264,311,385,300,389,0.84,72,74,89
OceanDNA-b44448,147,12.6,0.0,3e-06,0.00078,154,185,151,182,128,196,0.84,31,31,68
OceanDNA-b22496,4234,14.4,0.1,1.7e-06,0.0039,105,178,95,166,79,174,0.84,73,71,95
OceanDNA-b22830,763,18.6,0.0,9.1e-08,0.00021,154,190,165,202,119,232,0.84,36,37,113
OceanDNA-b22827,1232,11.4,0.0,1.3e-05,0.033,151,180,221,250,206,257,0.84,29,29,51
OceanDNA-b401,641,21.0,0.0,8e-09,7.8e-06,129,188,178,232,91,258,0.84,59,54,167
OceanDNA-b9808,317,13.5,0.0,3.2e-06,0.0009,133,178,95,139,81,152,0.84,45,44,71
OceanDNA-b12541,171,132.0,0.0,1.2e-42,4.1e-40,53,283,39,284,25,298,0.84,230,245,273
OceanDNA-b6771,196,4.6,0.0,0.0024,0.75,160,181,127,148,118,158,0.84,21,21,40
OceanDNA-b44390,51,19.4,0.0,7.5e-08,1.7e-05,188,261,300,373,292,378,0.84,73,73,86
OceanDNA-b40594,236,147.1,0.1,3.2e-47,1.2e-44,69,283,78,308,12,314,0.84,214,230,302
OceanDNA-b20900,1297,15.0,0.1,5.7e-07,0.0012,146,176,59,89,5,152,0.84,30,30,147
OceanDNA-b22450,202,11.5,0.0,1.9e-05,0.0087,146,185,145,184,128,187,0.84,39,39,59
OceanDNA-b41273,1153,14.6,0.1,1.5e-06,0.0014,102,166,36,101,15,113,0.84,64,65,98
OceanDNA-b37510,372,9.9,0.0,4e-05,0.033,198,264,620,688,611,695,0.84,66,68,84
OceanDNA-b24941,2495,4.1,0.0,0.0024,3.3,197,229,262,293,257,306,0.84,32,31,49
OceanDNA-b37510,398,3.9,0.1,0.0026,2.1,199,228,154,183,149,201,0.84,29,29,52
OceanDNA-b16187,169,2.5,0.0,0.0036,3.3,194,230,417,453,396,467,0.84,36,36,71
OceanDNA-b29530,932,-2.5,0.0,0.12,380.0,197,218,236,257,226,267,0.84,21,21,41
OceanDNA-b22840,3818,8.2,0.1,0.0002,0.28,152,186,199,232,188,236,0.84,34,33,48
OceanDNA-b3610,1589,11.3,0.0,7.4e-06,0.025,82,176,94,187,72,214,0.84,94,93,142
OceanDNA-b27542,1349,11.1,0.1,1.7e-05,0.019,196,266,199,267,192,270,0.84,70,68,78
OceanDNA-b40617,78,15.4,0.0,8.3e-07,0.00017,94,182,28,110,14,123,0.84,88,82,109
OceanDNA-b26770,298,12.9,0.0,2.5e-06,0.0036,180,245,710,780,699,786,0.84,65,70,87
OceanDNA-b20511,29,8.2,0.0,6.4e-05,0.018,78,121,112,157,89,169,0.84,43,45,80
OceanDNA-b21043,56,12.9,0.0,7.4e-06,0.0044,151,186,92,127,65,134,0.84,35,35,69
OceanDNA-b37356,779,5.5,0.0,0.00043,0.75,193,235,284,325,268,333,0.84,42,41,65
OceanDNA-b44,2537,2.1,0.0,0.0096,36.0,153,180,84,111,74,119,0.84,27,27,45
OceanDNA-b4004,18,11.3,0.1,7.4e-06,0.0084,195,266,139,208,132,228,0.84,71,69,96
OceanDNA-b5520,32,143.9,0.1,2.9e-46,1.3e-43,54,283,35,279,26,290,0.84,229,244,264
OceanDNA-b35148,1178,13.6,0.0,3e-06,0.0031,140,180,121,162,114,174,0.84,40,41,60
OceanDNA-b35325,133,4.5,0.0,0.00085,0.45,182,218,193,229,188,260,0.84,36,36,72
OceanDNA-b30938,2151,21.1,0.7,2.2e-08,1.8e-05,89,181,99,198,12,201,0.84,92,99,189
OceanDNA-b22996,905,14.3,0.1,8.8e-07,0.0014,152,186,122,156,38,171,0.84,34,34,133
OceanDNA-b13299,1029,10.9,0.0,1e-05,0.011,150,185,217,252,198,262,0.84,35,35,64
OceanDNA-b31542,1510,-0.5,0.0,0.03,51.0,150,176,99,125,87,129,0.84,26,26,42
OceanDNA-b5513,155,153.8,0.0,3e-49,1.3e-46,70,283,52,277,16,287,0.84,213,225,271
OceanDNA-b34760,599,12.4,0.1,3.4e-06,0.0021,198,253,261,316,254,326,0.84,55,55,72
OceanDNA-b27545,1368,-2.9,0.0,0.16,350.0,144,158,352,366,346,370,0.84,14,14,24
OceanDNA-b18344,110,21.9,0.0,4.4e-09,8.1e-07,151,187,152,189,134,223,0.84,36,37,89
OceanDNA-b46823,158,11.0,0.0,2.8e-05,0.017,152,185,238,271,223,275,0.84,33,33,52
OceanDNA-b6503,557,7.9,0.1,0.00016,0.053,175,219,197,241,192,252,0.84,44,44,60
OceanDNA-b5857,282,8.7,0.0,4.5e-05,0.019,187,220,271,304,264,311,0.84,33,33,47
OceanDNA-b37023,300,7.8,0.0,0.00017,0.065,145,186,144,185,138,197,0.84,41,41,59
OceanDNA-b19626,358,39.7,0.0,3.4e-14,8.2e-12,72,171,77,181,54,201,0.84,99,104,147
OceanDNA-b19626,143,24.2,0.0,1.8e-09,4.3e-07,148,196,217,264,199,299,0.84,48,47,100
OceanDNA-b22378,1422,13.8,0.0,1.2e-06,0.0025,151,188,231,267,220,290,0.84,37,36,70
OceanDNA-b1345,2514,5.3,0.0,0.00048,1.3,195,231,225,260,217,281,0.84,36,35,64
OceanDNA-b20911,6129,12.2,0.3,7.9e-06,0.028,163,194,22,52,9,62,0.84,31,30,53
OceanDNA-b32645,804,13.3,0.0,1.8e-06,0.0015,61,118,19,76,2,85,0.84,57,57,83
OceanDNA-b36401,772,11.5,0.0,1.3e-05,0.0073,91,121,124,154,118,172,0.84,30,30,54
OceanDNA-b282,778,38.2,0.0,9.4e-14,6.8e-11,151,245,134,230,121,237,0.84,94,96,116
OceanDNA-b41358,795,76.4,0.0,4.2e-25,1.3e-22,43,245,36,241,6,276,0.84,202,205,270
OceanDNA-b12668,103,14.2,0.0,9.5e-07,0.00042,190,269,187,264,181,291,0.84,79,77,110
OceanDNA-b32925,605,4.8,0.0,0.00069,1.6,180,220,196,236,186,264,0.84,40,40,78
OceanDNA-b7449,915,11.3,0.0,7.2e-06,0.0072,157,185,153,181,128,221,0.84,28,28,93
OceanDNA-b40493,544,17.6,0.0,9e-08,7.9e-05,155,185,145,175,128,195,0.84,30,30,67
OceanDNA-b10080,169,15.7,0.1,6.7e-07,0.00033,145,191,76,123,70,132,0.84,46,47,62
OceanDNA-b34087,371,15.1,0.5,5e-07,0.00025,193,267,187,259,180,262,0.84,74,72,82
OceanDNA-b1353,3339,-3.4,0.0,0.43,840.0,155,172,295,312,293,314,0.84,17,17,21
OceanDNA-b34924,232,11.3,0.0,1.5e-05,0.0076,180,247,273,345,266,355,0.84,67,72,89
OceanDNA-b28232,217,14.4,0.0,8.5e-07,0.0021,154,179,139,164,121,177,0.84,25,25,56
OceanDNA-b3608,2049,11.7,0.0,5.6e-06,0.012,184,265,231,309,220,311,0.84,81,78,91
OceanDNA-b46695,1180,44.6,0.0,2.6e-15,1.1e-12,153,245,150,245,142,258,0.84,92,95,116
OceanDNA-b31464,1668,4.0,0.0,0.0013,2.4,200,265,196,259,186,275,0.84,65,63,89
OceanDNA-b46834,1327,40.2,0.0,1.1e-14,1.5e-11,153,244,118,212,109,224,0.84,91,94,115
OceanDNA-b17083,134,10.5,0.0,1.3e-05,0.013,69,190,21,147,10,152,0.84,121,126,142
OceanDNA-b32047,2007,13.2,0.0,6e-06,0.0071,155,184,210,239,193,249,0.84,29,29,56
OceanDNA-b36666,625,13.5,0.0,3.1e-06,0.0019,159,185,155,181,143,188,0.84,26,26,45
OceanDNA-b37349,143,1.5,0.0,0.0073,4.8,90,121,142,173,132,179,0.84,31,31,47
OceanDNA-b29381,649,6.8,0.0,0.00017,0.16,195,244,261,310,253,315,0.84,49,49,62
OceanDNA-b37960,533,3.2,0.0,0.0043,1.2,152,180,170,199,151,214,0.84,28,29,63
OceanDNA-b44576,177,10.5,0.0,1.3e-05,0.0028,125,168,154,197,129,210,0.84,43,43,81
OceanDNA-b12631,200,10.0,0.0,1.8e-05,0.0066,143,180,75,112,64,126,0.84,37,37,62
OceanDNA-b45747,1546,17.3,0.0,1.1e-07,0.00024,150,188,156,195,139,229,0.84,38,39,90
OceanDNA-b20290,149,11.4,0.0,7.1e-06,0.0034,153,198,597,646,592,651,0.84,45,49,59
OceanDNA-b40473,241,10.6,0.0,3.6e-05,0.013,142,186,107,153,95,179,0.84,44,46,84
OceanDNA-b33100,1988,12.8,0.0,2.7e-06,0.0061,154,182,146,174,132,182,0.84,28,28,50
OceanDNA-b37447,293,3.6,0.0,0.0016,1.1,197,235,266,303,254,320,0.84,38,37,66
OceanDNA-b46970,790,15.2,0.0,4.8e-07,0.00039,151,186,172,207,140,220,0.84,35,35,80
OceanDNA-b41152,1030,2.2,0.0,0.0089,10.0,195,218,208,231,185,251,0.84,23,23,66
OceanDNA-b2811,1320,0.3,0.0,0.017,25.0,196,216,347,367,333,378,0.84,20,20,45
OceanDNA-b11388,59,12.0,0.0,4.4e-06,0.0026,143,184,82,123,74,134,0.84,41,41,60
OceanDNA-b37298,671,11.9,0.0,9.9e-06,0.0048,197,245,241,287,217,305,0.84,48,46,88
OceanDNA-b30044,1624,28.8,0.0,3.5e-11,5.8e-08,85,180,30,131,22,136,0.84,95,101,114
OceanDNA-b20951,936,16.9,0.0,2.9e-07,0.00036,181,247,245,313,236,354,0.84,66,68,118
OceanDNA-b45813,470,19.1,0.0,3.1e-08,3.4e-05,152,193,206,247,173,257,0.84,41,41,84
OceanDNA-b15190,1474,8.7,0.0,4.5e-05,0.1,154,182,122,150,96,159,0.84,28,28,63
OceanDNA-b9010,182,7.0,0.0,0.00015,0.037,198,265,189,258,177,263,0.84,67,69,86
OceanDNA-b25306,13,11.5,0.0,6.5e-06,0.0015,154,185,88,119,83,128,0.84,31,31,45
OceanDNA-b37527,1378,12.5,0.2,6.2e-06,0.0071,105,176,83,156,61,168,0.84,71,73,107
OceanDNA-b46867,343,2.9,0.1,0.0027,3.1,77,121,68,111,50,144,0.84,44,43,94
OceanDNA-b23394,910,0.6,0.1,0.027,34.0,53,105,295,347,254,356,0.84,52,52,102
OceanDNA-b20056,332,11.5,0.0,1.3e-05,0.0025,152,197,596,645,591,653,0.84,45,49,62
OceanDNA-b36947,1021,12.0,0.0,4.4e-06,0.0048,95,157,67,129,22,134,0.84,62,62,112
OceanDNA-b26155,41,21.2,0.0,7e-09,3.5e-06,86,185,67,170,59,219,0.84,99,103,160
OceanDNA-b13147,274,13.7,0.0,1.4e-06,0.00054,140,181,129,170,123,189,0.84,41,41,66
OceanDNA-b17743,2586,-3.8,0.0,0.9,1100.0,223,234,280,291,275,293,0.84,11,11,18
OceanDNA-b10199,1,14.5,0.0,7.8e-07,0.00029,143,183,73,113,67,128,0.84,40,40,61
OceanDNA-b26763,786,12.3,0.0,3.6e-06,0.0046,160,185,99,124,82,147,0.84,25,25,65
OceanDNA-b46252,1757,16.4,0.0,8e-07,0.00046,148,187,164,204,149,214,0.84,39,40,65
OceanDNA-b3313,1278,17.2,0.3,1.2e-07,0.00034,60,185,92,208,63,214,0.84,125,116,151
OceanDNA-b229,508,26.5,0.0,1.8e-10,1.6e-07,153,244,120,212,93,218,0.84,91,92,125
OceanDNA-b4116,368,8.8,0.0,4.4e-05,0.029,194,236,263,303,240,313,0.84,42,40,73
OceanDNA-b5526,273,147.8,0.0,4e-47,1e-44,71,282,94,317,60,328,0.84,211,223,268
OceanDNA-b22322,2331,16.8,0.0,3.2e-07,0.00062,132,186,221,276,215,287,0.84,54,55,72
OceanDNA-b3696,1147,12.7,0.0,2.7e-06,0.0068,186,215,324,353,307,379,0.84,29,29,72
OceanDNA-b19130,353,17.7,0.0,1.7e-07,3.7e-05,152,187,127,163,89,194,0.84,35,36,105
OceanDNA-b1522,444,4.3,0.1,0.0029,0.97,145,188,134,177,131,186,0.84,43,43,55
OceanDNA-b46206,314,11.4,0.0,7e-06,0.0084,160,187,110,137,88,142,0.84,27,27,54
OceanDNA-b23261,218,12.2,0.0,8e-06,0.0094,161,198,125,166,102,178,0.84,37,41,76
OceanDNA-b31575,1583,0.8,0.0,0.012,21.0,197,214,264,281,261,291,0.84,17,17,30
OceanDNA-b22806,629,12.4,0.0,1e-05,0.016,150,185,246,282,233,303,0.84,35,36,70
OceanDNA-b28166,2674,3.0,0.0,0.0025,6.9,160,186,140,166,114,175,0.84,26,26,61
OceanDNA-b33329,1259,15.1,0.0,1.6e-06,0.00083,140,185,126,172,119,186,0.84,45,46,67
OceanDNA-b1333,585,8.7,0.0,0.00014,0.073,143,188,84,129,66,141,0.84,45,45,75
OceanDNA-b30136,297,16.5,0.0,2e-07,0.00043,153,179,167,193,151,209,0.84,26,26,58
OceanDNA-b34544,56,15.6,0.0,7.3e-07,0.00027,159,187,130,158,89,176,0.84,28,28,87
OceanDNA-b1588,529,9.5,0.1,2.6e-05,0.021,151,188,109,146,92,156,0.84,37,37,64
OceanDNA-b32753,11,8.0,0.0,7.6e-05,0.036,151,192,214,255,203,273,0.84,41,41,70
OceanDNA-b32753,11,0.6,0.0,0.013,6.3,197,218,297,318,288,327,0.84,21,21,39
OceanDNA-b41307,1384,9.0,0.0,3.8e-05,0.16,180,218,209,245,194,256,0.84,38,36,62
OceanDNA-b22922,367,11.1,0.0,8.3e-06,0.014,153,187,226,259,214,281,0.84,34,33,67
OceanDNA-b32747,410,5.9,0.0,0.00033,0.16,147,185,218,256,201,274,0.84,38,38,73
OceanDNA-b16139,377,5.3,0.0,0.00048,0.39,195,224,430,460,413,493,0.84,29,30,80
OceanDNA-b20404,296,10.0,0.0,1.9e-05,0.0079,154,193,248,287,223,311,0.84,39,39,88
OceanDNA-b6300,45,1.3,0.0,0.0081,4.5,193,214,206,227,202,242,0.84,21,21,40
OceanDNA-b37582,1724,14.3,0.1,1.8e-06,0.0022,137,185,162,212,156,220,0.84,48,50,64
OceanDNA-b38574,185,-2.1,0.0,0.091,62.0,197,215,245,263,229,270,0.84,18,18,41
OceanDNA-b44633,3550,4.4,0.0,0.00094,3.4,197,229,242,274,226,294,0.84,32,32,68
OceanDNA-b32108,317,16.4,0.0,4e-07,0.00052,154,185,140,171,123,181,0.84,31,31,58
OceanDNA-b31123,254,8.0,0.0,7.6e-05,0.08,151,179,249,277,219,301,0.84,28,28,82
OceanDNA-b29209,436,10.0,0.0,1.8e-05,0.01,151,195,214,261,145,271,0.84,44,47,126
OceanDNA-b46641,1672,14.5,0.0,7.7e-07,0.0015,149,196,90,137,83,147,0.84,47,47,64
OceanDNA-b32156,2476,14.1,0.0,2.1e-06,0.0029,154,181,152,179,133,193,0.84,27,27,60
OceanDNA-b31229,288,14.1,0.0,2.1e-06,0.0016,154,181,141,168,123,182,0.84,27,27,59
OceanDNA-b37665,933,18.5,0.0,4.6e-08,7.2e-05,139,182,140,185,129,205,0.84,43,45,76
OceanDNA-b32786,1051,18.4,0.1,5.2e-08,8.3e-05,88,196,46,157,18,164,0.84,108,111,146
OceanDNA-b3975,757,12.3,0.0,1.5e-05,0.0031,160,183,159,182,141,193,0.84,23,23,52
OceanDNA-b512,233,-4.0,0.0,0.69,580.0,56,72,150,166,146,169,0.84,16,16,23
OceanDNA-b23312,2294,9.6,0.1,2.4e-05,0.067,151,216,140,208,124,215,0.84,65,68,91
OceanDNA-b46625,176,14.5,0.0,2.3e-06,0.0007,146,193,299,346,286,372,0.84,47,47,86
OceanDNA-b18642,124,26.5,0.0,1.7e-10,6e-08,152,185,131,164,97,180,0.84,33,33,83
OceanDNA-b45789,15,9.8,0.0,4.4e-05,0.012,155,189,97,131,23,142,0.84,34,34,119
OceanDNA-b22117,2422,13.6,0.0,1.5e-06,0.0041,137,204,175,236,166,258,0.84,67,61,92
OceanDNA-b29622,615,11.2,0.0,8.1e-06,0.0064,159,184,112,139,85,158,0.84,25,27,73
OceanDNA-b13585,50,19.5,0.0,9.5e-08,3.6e-05,139,180,138,181,127,215,0.84,41,43,88
OceanDNA-b16224,1390,2.8,0.0,0.0028,4.4,152,178,343,369,318,377,0.84,26,26,59
OceanDNA-b35127,740,12.0,0.0,4.4e-06,0.0044,197,264,621,690,599,693,0.84,67,69,94
OceanDNA-b36415,957,11.8,0.0,1e-05,0.008,127,191,139,203,132,210,0.84,64,64,78
OceanDNA-b44496,119,19.4,0.0,2.5e-08,9.4e-06,139,185,123,171,116,184,0.84,46,48,68
OceanDNA-b24003,129,16.2,0.0,4.9e-07,0.00036,140,182,123,167,119,188,0.84,42,44,69
OceanDNA-b260,485,-0.1,0.0,0.044,72.0,152,185,167,200,136,208,0.84,33,33,72
OceanDNA-b6820,3,2.7,0.0,0.003,1.5,195,221,214,240,207,274,0.84,26,26,67
OceanDNA-b36408,291,2.9,0.0,0.0026,5.9,197,219,280,302,239,317,0.84,22,22,78
OceanDNA-b31229,252,11.3,0.0,1.5e-05,0.011,133,187,98,151,20,195,0.84,54,53,175
OceanDNA-b515,1005,15.8,0.1,3.2e-07,0.00081,139,180,3,46,1,58,0.84,41,43,57
OceanDNA-b40018,534,20.5,0.0,1.2e-08,6.4e-06,153,180,138,165,118,190,0.84,27,27,72
OceanDNA-b20676,199,50.0,0.2,2.5e-17,4.2e-15,53,190,65,209,62,219,0.84,137,144,157
OceanDNA-b12858,57,11.1,0.0,8.4e-06,0.0041,159,186,73,100,66,136,0.84,27,27,70
OceanDNA-b8082,149,12.7,0.0,2.7e-06,0.00076,137,186,114,161,104,169,0.84,49,47,65
OceanDNA-b38062,924,12.8,0.0,2.6e-06,0.0024,198,265,177,246,141,252,0.84,67,69,111
OceanDNA-b4053,568,10.6,0.0,2.4e-05,0.0085,145,181,115,151,99,174,0.84,36,36,75
OceanDNA-b22654,701,14.6,0.0,3.6e-06,0.00089,149,177,248,276,240,285,0.84,28,28,45
OceanDNA-b9792,87,10.2,0.0,1.6e-05,0.008,144,182,65,106,45,143,0.84,38,41,98
OceanDNA-b47071,444,13.2,0.0,4e-06,0.0015,147,186,202,241,175,245,0.84,39,39,70
OceanDNA-b22220,1345,14.5,0.0,1.6e-06,0.0013,139,190,12,64,10,71,0.84,51,52,61
OceanDNA-b46939,472,9.8,0.0,2.1e-05,0.028,194,263,191,256,177,258,0.84,69,65,81
OceanDNA-b15651,514,18.2,0.0,5.7e-08,3.1e-05,107,189,205,293,179,320,0.84,82,88,141
OceanDNA-b22823,1208,-1.8,0.0,0.071,300.0,93,110,268,286,254,289,0.84,17,18,35
OceanDNA-b41242,2283,14.0,0.1,1.1e-06,0.0037,104,182,58,139,54,142,0.84,78,81,88
OceanDNA-b20676,16,106.6,0.0,1.4e-34,2.3e-32,53,282,19,257,14,268,0.84,229,238,254
OceanDNA-b39325,137,34.6,0.0,5.7e-13,1.6e-10,153,251,160,262,149,270,0.84,98,102,121
OceanDNA-b22207,45,10.7,0.0,1.1e-05,0.014,155,190,376,412,362,419,0.84,35,36,57
OceanDNA-b30773,857,8.4,0.0,5.5e-05,0.16,199,265,249,313,237,317,0.83,66,64,80
OceanDNA-b36577,573,9.9,0.0,4e-05,0.039,147,180,88,121,76,133,0.83,33,33,57
OceanDNA-b19689,47,23.8,0.0,1.1e-09,4.6e-07,150,243,125,220,114,230,0.83,93,95,116
OceanDNA-b26604,235,17.3,0.1,1.1e-07,5.5e-05,150,185,143,178,126,216,0.83,35,35,90
OceanDNA-b17735,2830,12.7,0.0,2.7e-06,0.0084,147,191,165,211,146,223,0.83,44,46,77
OceanDNA-b37246,288,22.1,0.0,3.9e-09,3.4e-06,153,218,109,176,96,207,0.83,65,67,111
OceanDNA-b7450,995,2.4,0.0,0.0074,4.8,250,282,368,400,355,414,0.83,32,32,59
OceanDNA-b26917,1112,3.3,0.0,0.004,3.2,231,271,233,274,198,289,0.83,40,41,91
OceanDNA-b31529,2007,12.2,0.0,4e-06,0.0084,136,190,186,239,175,254,0.83,54,53,79
OceanDNA-b41687,150,12.3,0.0,3.8e-06,0.00084,199,254,293,348,285,356,0.83,55,55,71
OceanDNA-b41998,118,20.6,0.0,1.1e-08,1.8e-06,84,176,67,164,55,192,0.83,92,97,137
OceanDNA-b33512,2615,12.7,0.0,2.7e-06,0.011,154,183,164,193,148,211,0.83,29,29,63
OceanDNA-b40457,1543,-1.9,0.0,0.078,120.0,159,184,158,183,150,188,0.83,25,25,38
OceanDNA-b10305,433,3.5,0.0,0.0018,0.79,152,190,262,300,242,310,0.83,38,38,68
OceanDNA-b42,4272,10.3,0.0,1.5e-05,0.082,157,189,137,170,72,176,0.83,32,33,104
OceanDNA-b10059,343,4.0,0.0,0.0012,0.56,153,190,41,78,25,88,0.83,37,37,63
OceanDNA-b29530,932,13.0,0.2,2.3e-06,0.0076,152,190,104,143,99,164,0.83,38,39,65
OceanDNA-b4594,24,10.9,0.0,1e-05,0.0048,194,268,185,257,179,271,0.83,74,72,92
OceanDNA-b46852,925,14.0,0.0,3.3e-06,0.0013,151,186,237,272,223,289,0.83,35,35,66
OceanDNA-b6561,429,12.6,0.0,5.8e-06,0.0039,159,189,172,203,159,213,0.83,30,31,54
OceanDNA-b24045,2236,11.4,0.0,6.6e-06,0.017,157,184,68,95,50,102,0.83,27,27,52
OceanDNA-b26298,393,1.4,0.0,0.0079,5.0,198,219,276,297,263,333,0.83,21,21,70
OceanDNA-b37023,300,1.8,0.0,0.011,4.2,197,238,296,336,289,341,0.83,41,40,52
OceanDNA-b37833,607,18.0,0.0,6.5e-08,6.7e-05,153,181,148,176,125,224,0.83,28,28,99
OceanDNA-b17743,2586,11.4,0.0,2.1e-05,0.027,146,191,164,211,150,223,0.83,45,47,73
OceanDNA-b22943,3679,11.1,0.0,8.5e-06,0.032,133,177,218,262,182,274,0.83,44,44,92
OceanDNA-b36885,333,17.0,0.0,1.4e-07,9.4e-05,146,192,215,261,185,283,0.83,46,46,98
OceanDNA-b29385,2659,22.6,0.0,2.7e-09,8.9e-06,86,172,341,431,333,437,0.83,86,90,104
OceanDNA-b20510,60,6.8,0.0,0.00017,0.059,78,121,114,159,90,171,0.83,43,45,81
OceanDNA-b15879,188,10.1,0.1,3.5e-05,0.031,151,222,153,227,138,268,0.83,71,74,130
OceanDNA-b20510,60,10.7,0.0,1.1e-05,0.0038,126,190,212,278,207,324,0.83,64,66,117
OceanDNA-b26845,827,12.0,0.1,8.8e-06,0.014,102,175,142,216,120,225,0.83,73,74,105
OceanDNA-b32861,681,12.1,0.1,8.4e-06,0.0052,123,191,113,184,105,196,0.83,68,71,91
OceanDNA-b17082,426,4.8,0.0,0.00069,1.1,198,247,232,277,222,288,0.83,49,45,66
OceanDNA-b22893,2288,11.4,0.0,2.1e-05,0.016,108,169,174,239,163,247,0.83,61,65,84
OceanDNA-b11479,73,9.5,0.1,2.6e-05,0.013,197,268,192,261,184,287,0.83,71,69,103
OceanDNA-b15777,892,0.5,0.0,0.043,24.0,160,178,141,159,130,169,0.83,18,18,39
OceanDNA-b10294,774,9.3,0.0,5.8e-05,0.025,197,265,195,261,187,269,0.83,68,66,82
OceanDNA-a1153,65,10.8,0.0,1e-05,0.0016,183,264,219,298,214,303,0.83,81,79,89
OceanDNA-b19697,279,-2.3,0.0,0.099,33.0,86,120,202,236,196,244,0.83,34,34,48
OceanDNA-b13250,3720,3.2,0.0,0.019,8.7,157,182,132,157,122,165,0.83,25,25,43
OceanDNA-b13250,797,48.5,0.1,3.2e-16,1.5e-13,109,231,106,227,102,243,0.83,122,121,141
OceanDNA-b37750,321,26.0,0.0,2.4e-10,1.9e-07,140,184,134,181,127,215,0.83,44,47,88
OceanDNA-b20944,992,-0.4,0.0,0.026,47.0,197,216,208,227,198,237,0.83,19,19,39
OceanDNA-b45891,116,-0.5,0.0,0.028,9.4,148,183,71,107,64,111,0.83,35,36,47
OceanDNA-b29389,999,9.0,0.1,3.7e-05,0.085,166,230,267,333,248,351,0.83,64,66,103
OceanDNA-b46887,583,10.5,0.0,1.3e-05,0.0087,126,176,128,178,111,198,0.83,50,50,87
OceanDNA-b38376,1555,70.6,0.2,2.5e-23,1.6e-20,73,245,67,244,58,285,0.83,172,177,227
OceanDNA-b34564,654,9.7,0.0,2.2e-05,0.016,139,192,118,172,111,175,0.83,53,54,64
OceanDNA-b33419,741,14.6,0.0,7.4e-07,0.0012,155,188,142,176,116,187,0.83,33,34,71
OceanDNA-b440,2424,12.9,0.1,4.7e-06,0.0057,149,185,113,150,94,156,0.83,36,37,62
OceanDNA-b31170,1207,7.5,0.0,0.00011,0.13,150,177,76,103,40,122,0.83,27,27,82
OceanDNA-a3751,172,3.1,0.0,0.0024,0.43,92,121,231,260,154,334,0.83,29,29,180
OceanDNA-b28010,562,8.6,0.0,4.8e-05,0.15,162,198,127,167,124,181,0.83,36,40,57
OceanDNA-b20349,336,45.3,0.1,3.2e-16,1.3e-13,69,180,71,188,53,204,0.83,111,117,151
OceanDNA-b25045,394,-1.4,0.0,0.053,47.0,192,219,266,293,262,311,0.83,27,27,49
OceanDNA-b37060,975,-0.8,0.0,0.035,36.0,198,221,264,286,259,307,0.83,23,22,48
OceanDNA-b38370,238,79.9,0.0,9.5e-27,1.6e-23,52,276,33,267,27,282,0.83,224,234,255
OceanDNA-b6750,317,16.0,0.0,8.1e-07,0.0002,83,189,157,265,152,290,0.83,106,108,138
OceanDNA-b12469,78,11.6,0.0,5.8e-06,0.0023,152,182,230,261,110,278,0.83,30,31,168
OceanDNA-b20668,130,46.3,0.1,3.1e-16,4.2e-14,55,190,65,207,61,215,0.83,135,142,154
OceanDNA-b38572,538,4.3,0.0,0.001,0.58,197,221,234,258,226,273,0.83,24,24,47
OceanDNA-b37839,408,20.1,0.0,1.6e-08,1.4e-05,151,181,173,203,150,227,0.83,30,30,77
OceanDNA-b13570,390,19.5,0.0,4.6e-08,3e-05,91,178,21,106,10,125,0.83,87,85,115
OceanDNA-b22801,278,10.0,0.2,3.6e-05,0.045,55,110,191,243,181,248,0.83,55,52,67
OceanDNA-b16123,88,11.2,0.0,1.6e-05,0.0058,155,181,144,170,126,196,0.83,26,26,70
OceanDNA-b46741,194,36.7,0.0,2.8e-13,2.5e-10,153,244,147,241,139,254,0.83,91,94,115
OceanDNA-b506,59,13.6,0.0,1.5e-06,0.0029,147,189,130,172,121,181,0.83,42,42,60
OceanDNA-b23312,2294,-0.4,0.1,0.027,76.0,68,83,77,92,17,109,0.83,15,15,92
OceanDNA-b22817,1889,10.4,0.0,1.4e-05,0.059,154,188,135,170,121,206,0.83,34,35,85
OceanDNA-b260,485,-3.7,0.0,0.54,880.0,197,211,271,285,265,289,0.83,14,14,24
OceanDNA-b36415,378,3.0,0.0,0.0049,3.8,197,219,245,267,205,284,0.83,22,22,79
OceanDNA-b34895,715,9.0,0.0,3.7e-05,0.032,158,188,71,102,58,107,0.83,30,31,49
OceanDNA-b34551,807,9.7,0.0,4.5e-05,0.02,139,192,120,174,113,177,0.83,53,54,64
OceanDNA-b20894,3731,2.2,0.0,0.0087,19.0,160,188,118,147,104,160,0.83,28,29,56
OceanDNA-b36755,104,6.3,0.0,0.0005,0.93,147,177,79,112,68,123,0.83,30,33,55
OceanDNA-b46733,84,14.5,0.0,7.8e-07,0.0014,155,189,137,172,125,230,0.83,34,35,105
OceanDNA-b32031,516,1.0,0.0,0.01,19.0,190,265,145,221,138,228,0.83,75,76,90
OceanDNA-b13457,695,11.2,0.0,1.6e-05,0.0057,148,197,26,77,17,84,0.83,49,51,67
OceanDNA-b15168,127,6.4,0.0,0.00023,0.22,176,215,158,198,154,203,0.83,39,40,49
OceanDNA-b46656,816,-2.8,0.0,0.29,480.0,139,168,139,168,137,171,0.83,29,29,34
OceanDNA-b45823,1602,18.6,0.0,9e-08,8e-05,150,188,427,466,396,472,0.83,38,39,76
OceanDNA-b8260,51,12.4,0.0,3.5e-06,0.00094,89,180,23,109,17,124,0.83,91,86,107
OceanDNA-b26935,170,15.6,0.1,3.7e-07,9.5e-05,197,262,329,396,319,401,0.83,65,67,82
OceanDNA-b46303,3235,23.0,0.0,4e-09,7.2e-06,150,187,176,214,166,236,0.83,37,38,70
OceanDNA-b30031,2048,6.9,0.0,0.00032,0.36,197,220,180,203,172,240,0.83,23,23,68
OceanDNA-b23093,2393,12.8,0.0,7.5e-06,0.015,153,233,268,351,207,363,0.83,80,83,156
OceanDNA-b31519,410,8.3,0.0,6.2e-05,0.04,194,246,576,628,566,641,0.83,52,52,75
OceanDNA-b36658,307,15.9,0.0,5.9e-07,0.00026,157,181,56,80,34,94,0.83,24,24,60
OceanDNA-b27597,1121,16.5,0.0,1.9e-07,0.00033,140,185,145,192,134,213,0.83,45,47,79
OceanDNA-b41349,858,74.1,0.0,1.1e-24,6.5e-22,43,245,36,241,5,276,0.83,202,205,271
OceanDNA-b46823,1322,13.5,0.1,4.6e-06,0.0028,159,204,97,147,86,162,0.83,45,50,76
OceanDNA-b35796,702,-2.1,0.0,0.091,93.0,197,217,253,273,247,276,0.83,20,20,29
OceanDNA-b42626,228,9.4,0.0,2.9e-05,0.0072,193,218,201,226,193,242,0.83,25,25,49
OceanDNA-b32,392,12.8,0.0,5.2e-06,0.0016,150,188,226,264,206,280,0.83,38,38,74
OceanDNA-b24003,608,8.7,0.0,8.9e-05,0.066,197,251,578,632,567,637,0.83,54,54,70
OceanDNA-b23966,184,8.7,0.0,4.7e-05,0.1,193,245,302,354,289,364,0.83,52,52,75
OceanDNA-b45647,130,10.2,0.0,1.6e-05,0.01,194,261,175,239,171,244,0.83,67,64,73
OceanDNA-b47086,269,2.1,0.0,0.0095,20.0,106,123,209,226,198,231,0.83,17,17,33
OceanDNA-b27289,163,16.4,0.0,2.1e-07,4.7e-05,153,188,97,132,66,147,0.83,35,35,81
OceanDNA-b12521,140,124.5,0.0,2.5e-40,6.1e-38,55,283,44,287,33,301,0.83,228,243,268
OceanDNA-b12085,434,49.4,0.0,1.9e-17,8.9e-15,109,244,86,226,44,245,0.83,135,140,201
OceanDNA-b30346,1949,7.3,0.1,0.00012,0.27,166,230,202,268,196,284,0.83,64,66,88
OceanDNA-b46972,580,13.7,0.0,1.3e-06,0.001,154,188,234,269,219,317,0.83,34,35,98
OceanDNA-b3607,603,17.3,0.0,1.1e-07,0.00029,153,216,106,168,76,195,0.83,63,62,119
OceanDNA-b3337,1561,14.5,0.0,1.5e-06,0.0027,153,189,27,64,9,80,0.83,36,37,71
OceanDNA-b36166,1695,20.3,0.0,2.7e-08,3e-05,151,186,138,173,110,181,0.83,35,35,71
OceanDNA-b31526,855,21.2,0.0,2.2e-08,7.5e-06,80,123,206,249,199,274,0.83,43,43,75
OceanDNA-b44359,339,6.5,0.0,0.00022,0.27,58,122,62,125,48,149,0.83,64,63,101
OceanDNA-b26737,1207,11.5,0.0,6.2e-06,0.015,156,180,153,177,135,195,0.83,24,24,60
OceanDNA-b1353,1053,-0.2,0.1,0.047,91.0,138,177,37,76,22,88,0.83,39,39,66
OceanDNA-b41358,957,10.8,0.1,4.1e-05,0.012,159,185,87,113,10,127,0.83,26,26,117
OceanDNA-b211,630,4.0,0.1,0.0013,1.2,197,229,305,337,300,346,0.83,32,32,46
OceanDNA-b41655,231,19.6,0.0,2.2e-08,5.1e-06,88,176,70,162,37,189,0.83,88,92,152
OceanDNA-b24608,76,3.5,0.0,0.0018,0.95,83,120,52,89,42,99,0.83,37,37,57
OceanDNA-b23655,661,4.4,0.0,0.0018,1.7,149,180,135,166,116,175,0.83,31,31,59
OceanDNA-b1510,849,10.8,0.1,1e-05,0.01,126,187,90,147,81,155,0.83,61,57,74
OceanDNA-b23634,108,4.9,0.0,0.002,1.6,150,180,129,159,116,168,0.83,30,30,52
OceanDNA-b34824,164,13.1,0.0,2e-06,0.0012,152,186,89,124,29,153,0.83,34,35,124
OceanDNA-b33328,1067,8.8,0.0,4.2e-05,0.049,146,174,21,49,3,90,0.83,28,28,87
OceanDNA-b40444,469,17.8,0.0,2.4e-07,0.00014,140,184,128,173,122,184,0.83,44,45,62
OceanDNA-b26571,659,18.6,0.0,8.6e-08,3.4e-05,74,189,33,153,23,157,0.83,115,120,134
OceanDNA-b34187,445,13.5,0.2,1.6e-06,0.00072,63,135,37,111,27,189,0.83,72,74,162
OceanDNA-b23101,3276,35.3,0.2,3.7e-13,1.2e-09,86,225,177,318,153,327,0.83,139,141,174
OceanDNA-b22108,67,12.7,0.2,8.5e-06,0.0058,152,195,137,180,116,271,0.83,43,43,155
OceanDNA-b14324,393,-0.9,0.0,0.039,20.0,154,188,118,152,110,164,0.83,34,34,54
OceanDNA-b4256,145,-0.1,0.0,0.022,5.9,154,189,149,184,142,194,0.83,35,35,52
OceanDNA-b45612,488,3.2,0.0,0.0021,1.1,198,218,266,286,239,317,0.83,20,20,78
OceanDNA-b1435,454,8.5,0.1,0.0001,0.043,154,188,120,154,106,168,0.83,34,34,62
OceanDNA-b10408,194,26.3,0.0,2.1e-10,6.2e-08,142,198,193,248,188,270,0.83,56,55,82
OceanDNA-b28501,49,14.6,0.0,7.2e-07,0.00032,154,184,147,177,130,192,0.83,30,30,62
OceanDNA-b41341,36,10.5,0.1,1.3e-05,0.022,96,175,98,179,92,274,0.83,79,81,182
OceanDNA-b13091,1267,15.6,0.0,3.6e-07,0.00097,153,215,177,241,166,251,0.83,62,64,85
OceanDNA-b35883,168,21.4,0.0,6e-09,2.2e-06,154,182,151,179,133,201,0.83,28,28,68
OceanDNA-b17032,419,15.0,0.0,5.7e-07,0.00076,87,188,37,139,29,158,0.83,101,102,129
OceanDNA-b23175,3987,15.9,0.0,2.9e-07,0.0021,89,191,103,199,92,207,0.83,102,96,115
OceanDNA-b39796,352,18.2,0.0,6e-08,4.2e-05,154,181,142,169,123,199,0.83,27,27,76
OceanDNA-b15286,254,10.7,0.0,1.1e-05,0.0029,152,187,111,146,98,152,0.83,35,35,54
OceanDNA-b20627,234,11.7,0.0,5.8e-06,0.0018,139,192,224,277,206,299,0.83,53,53,93
OceanDNA-b42531,121,16.6,0.0,1.8e-07,4.3e-05,153,188,155,190,149,254,0.83,35,35,105
OceanDNA-b44435,1547,15.4,0.0,4.3e-07,0.0011,154,185,148,179,122,187,0.83,31,31,65
OceanDNA-b46728,883,12.6,0.0,8.9e-06,0.0049,151,186,177,212,164,229,0.83,35,35,65
OceanDNA-b20674,70,51.0,0.0,6.1e-18,1.9e-15,55,190,71,213,68,220,0.83,135,142,152
OceanDNA-b22917,1949,13.1,0.0,8.5e-06,0.0061,108,169,172,237,163,244,0.83,61,65,81
OceanDNA-b30724,1252,12.7,0.1,2.7e-06,0.0046,165,229,239,305,214,331,0.83,64,66,117
OceanDNA-b44744,465,12.5,0.0,3.2e-06,0.0026,89,189,45,143,33,162,0.83,100,98,129
OceanDNA-b23399,1369,10.8,0.3,1.1e-05,0.025,150,180,132,163,121,196,0.83,30,31,75
OceanDNA-b25087,664,15.9,0.0,2.8e-07,0.00022,74,189,33,153,21,158,0.83,115,120,137
OceanDNA-b36739,316,2.7,0.0,0.003,1.8,146,196,85,135,80,150,0.83,50,50,70
OceanDNA-b17374,593,12.9,0.0,2.3e-06,0.0044,153,216,227,292,195,320,0.83,63,65,125
OceanDNA-b9778,658,13.7,0.0,1.4e-06,0.0019,158,188,155,186,144,218,0.83,30,31,74
OceanDNA-b17424,1206,7.8,0.0,0.00017,0.15,155,175,214,234,197,241,0.83,20,20,44
OceanDNA-b24678,261,13.5,0.0,1.6e-06,0.0014,154,185,145,176,125,192,0.83,31,31,67
OceanDNA-b40523,459,15.5,0.0,3.9e-07,0.0004,158,185,151,178,130,195,0.83,27,27,65
OceanDNA-b30221,1445,12.4,0.1,7e-06,0.0076,157,182,91,116,32,165,0.83,25,25,133
OceanDNA-a3195,798,-2.2,0.0,0.099,110.0,204,229,261,286,252,299,0.83,25,25,47
OceanDNA-b23415,1001,10.7,0.1,1.1e-05,0.023,154,187,208,241,198,249,0.83,33,33,51
OceanDNA-b44,4810,8.0,0.0,0.00015,0.58,197,262,613,680,592,684,0.83,65,67,92
OceanDNA-b36657,158,11.7,0.0,5.7e-06,0.0023,156,181,145,170,121,184,0.83,25,25,63
OceanDNA-b13300,331,0.7,0.0,0.013,20.0,196,229,260,292,244,303,0.83,33,32,59
OceanDNA-b4197,39,25.4,0.0,3.7e-10,2.4e-07,153,196,225,269,215,304,0.83,43,44,89
OceanDNA-b30085,540,10.6,0.2,3.7e-05,0.027,161,197,129,169,77,212,0.83,36,40,135
OceanDNA-b45437,549,3.3,0.0,0.002,2.4,104,123,29,48,15,53,0.83,19,19,38
OceanDNA-b44719,526,-2.1,0.0,0.09,54.0,189,213,197,221,187,229,0.83,24,24,42
OceanDNA-b15134,177,15.6,0.0,3.6e-07,0.00011,152,196,240,285,228,311,0.83,44,45,83
OceanDNA-b8399,69,22.1,0.0,3.7e-09,9.5e-07,145,189,133,178,123,186,0.83,44,45,63
OceanDNA-b4655,669,10.3,0.0,1.5e-05,0.011,148,188,86,126,60,136,0.83,40,40,76
OceanDNA-b32076,1774,15.8,0.0,6.3e-07,0.00099,154,185,162,193,138,203,0.83,31,31,65
OceanDNA-b46625,322,15.0,0.0,1.7e-06,0.00051,149,187,120,159,107,168,0.83,38,39,61
OceanDNA-b40755,73,3.4,0.0,0.0019,1.2,194,223,286,317,264,325,0.83,29,31,61
OceanDNA-b33108,794,-0.6,0.0,0.032,43.0,152,180,100,128,94,142,0.83,28,28,48
OceanDNA-b22383,363,12.8,0.0,5.3e-06,0.0092,147,188,140,182,130,192,0.83,41,42,62
OceanDNA-b20726,68,41.6,0.0,4.2e-15,7e-13,74,189,81,205,58,212,0.83,115,124,154
OceanDNA-b40755,73,4.8,0.0,0.0007,0.45,145,179,157,191,148,198,0.83,34,34,50
OceanDNA-b30493,1068,3.1,0.1,0.0024,3.5,160,188,151,179,103,198,0.83,28,28,95
OceanDNA-b9009,59,5.7,0.0,0.00073,0.08,197,264,614,683,593,689,0.83,67,69,96
OceanDNA-b12636,115,12.6,0.0,3e-06,0.0017,116,194,152,231,78,240,0.83,78,79,162
OceanDNA-b12581,54,126.3,0.1,6.9e-41,1.7e-38,71,275,61,276,27,290,0.83,204,215,263
OceanDNA-b23292,1732,9.9,0.0,3.8e-05,0.037,155,182,46,73,35,82,0.83,27,27,47
OceanDNA-b36648,147,8.6,0.0,4.8e-05,0.027,197,253,582,638,576,650,0.83,56,56,74
OceanDNA-b31120,158,11.2,0.0,2.3e-05,0.0084,110,183,119,193,97,226,0.83,73,74,129
OceanDNA-b35278,403,-1.6,0.0,0.12,49.0,155,185,513,544,508,550,0.83,30,31,42
OceanDNA-b40947,105,1.7,0.0,0.012,4.8,195,238,296,340,286,347,0.83,43,44,61
OceanDNA-b10366,922,11.2,0.0,1.6e-05,0.013,182,267,645,730,632,736,0.83,85,85,104
OceanDNA-b24863,113,15.2,0.0,4.9e-07,0.00013,156,245,104,197,71,206,0.83,89,93,135
OceanDNA-b22850,2445,15.9,0.0,2.9e-07,0.0008,150,181,323,354,302,372,0.83,31,31,70
OceanDNA-b35890,2812,-4.1,0.0,0.35,1400.0,198,214,378,394,373,399,0.83,16,16,26
OceanDNA-b11394,526,14.2,0.0,9.6e-07,0.00065,144,187,76,119,66,133,0.83,43,43,67
OceanDNA-b45584,658,11.9,0.0,4.9e-06,0.0067,145,193,117,165,102,179,0.83,48,48,77
OceanDNA-b23455,677,10.9,0.0,9.8e-06,0.023,150,180,167,198,157,215,0.83,30,31,58
OceanDNA-b2829,55,14.5,0.0,7.9e-07,0.0024,186,243,212,268,192,283,0.83,57,56,91
OceanDNA-b24611,64,11.5,0.1,6.5e-06,0.0028,137,186,126,169,113,188,0.83,49,43,75
OceanDNA-b26781,497,8.5,0.1,0.0001,0.089,189,229,279,321,256,327,0.83,40,42,71
OceanDNA-b28583,702,13.0,0.0,2.2e-06,0.0021,151,181,118,148,14,164,0.83,30,30,150
OceanDNA-b13078,1187,10.9,0.0,9.8e-06,0.013,107,187,99,181,70,199,0.83,80,82,129
OceanDNA-b3980,783,16.8,0.0,1.5e-07,0.00019,150,184,58,92,32,101,0.83,34,34,69
OceanDNA-b28101,1017,11.4,0.0,7.1e-06,0.014,153,184,79,109,43,130,0.83,31,30,87
OceanDNA-b37856,208,3.3,0.0,0.0021,1.7,58,121,67,129,42,146,0.83,63,62,104
OceanDNA-b37856,208,6.8,0.0,0.00018,0.14,154,190,183,221,159,237,0.83,36,38,78
OceanDNA-b29510,1279,0.2,0.0,0.035,43.0,192,245,293,343,273,350,0.83,53,50,77
OceanDNA-b22099,382,19.0,0.0,3.4e-08,6.9e-05,153,211,181,241,166,251,0.83,58,60,85
OceanDNA-b9023,329,10.5,0.0,1.3e-05,0.0044,160,185,94,119,70,136,0.83,25,25,66
OceanDNA-b27549,1961,5.9,0.2,0.00063,0.68,161,197,107,147,100,153,0.83,36,40,53
OceanDNA-b23149,1687,13.6,0.0,1.5e-06,0.0026,141,187,130,175,125,207,0.83,46,45,82
OceanDNA-b40618,151,14.7,0.0,2.7e-06,0.00041,154,181,150,177,131,194,0.83,27,27,63
OceanDNA-b3337,2399,0.5,0.0,0.029,52.0,157,171,326,340,316,368,0.83,14,14,52
OceanDNA-b34938,31,14.6,0.0,7.5e-07,0.00092,158,186,165,193,138,203,0.83,28,28,65
OceanDNA-b40254,458,11.4,0.0,1.4e-05,0.0045,151,187,168,204,104,219,0.83,36,36,115
OceanDNA-b15471,102,1.2,0.0,0.0087,4.8,34,75,28,69,7,76,0.83,41,41,69
OceanDNA-b11732,492,14.7,0.0,7e-07,0.00071,186,221,298,333,286,340,0.83,35,35,54
OceanDNA-b21737,42,14.9,0.0,6.1e-07,9.9e-05,82,181,39,142,31,154,0.83,99,103,123
OceanDNA-b22504,1657,32.2,0.0,6.4e-12,9.2e-09,154,245,230,325,217,335,0.83,91,95,118
OceanDNA-b20911,1202,11.1,0.4,1.6e-05,0.058,140,190,65,115,53,124,0.83,50,50,71
OceanDNA-b13990,392,10.5,0.0,1.3e-05,0.0059,97,174,157,240,69,253,0.83,77,83,184
OceanDNA-b28170,113,7.2,0.0,0.00013,0.34,196,220,170,194,164,233,0.83,24,24,69
OceanDNA-b39367,257,18.1,0.0,6.4e-08,4.8e-05,154,181,148,175,128,197,0.83,27,27,69
OceanDNA-b7262,219,5.4,0.0,0.00096,0.18,166,238,73,145,64,173,0.83,72,72,109
OceanDNA-b37442,373,14.4,0.0,8.2e-07,0.00081,127,191,207,273,201,280,0.83,64,66,79
OceanDNA-b32974,2789,5.2,0.0,0.0011,1.6,160,187,138,165,118,171,0.83,27,27,53
OceanDNA-b5207,24,12.2,0.0,3.8e-06,0.0012,143,179,107,141,22,152,0.83,36,34,130
OceanDNA-b36158,1500,20.1,0.0,3.2e-08,2.9e-05,151,186,163,198,135,205,0.83,35,35,70
OceanDNA-b6424,505,-1.0,0.0,0.12,25.0,189,215,163,189,151,203,0.82,26,26,52
OceanDNA-b35128,467,13.1,0.0,2.1e-06,0.0021,140,185,137,183,130,194,0.82,45,46,64
OceanDNA-b16778,1295,16.5,0.0,3.9e-07,0.00031,145,188,255,298,196,305,0.82,43,43,109
OceanDNA-b11387,576,3.9,0.0,0.0026,0.78,87,121,187,221,176,228,0.82,34,34,52
OceanDNA-a1153,65,1.1,0.0,0.0097,1.5,88,117,66,95,41,106,0.82,29,29,65
OceanDNA-b3419,139,-2.9,0.0,0.15,210.0,125,143,209,227,206,236,0.82,18,18,30
OceanDNA-b9767,735,-1.4,0.0,0.053,56.0,251,278,382,409,378,424,0.82,27,27,46
OceanDNA-b34949,622,16.1,0.0,7.5e-07,0.00024,139,184,129,175,121,194,0.82,45,46,73
OceanDNA-b30994,2728,-2.7,0.0,0.14,390.0,107,122,111,126,97,133,0.82,15,15,36
OceanDNA-b22220,1,27.4,0.0,1.9e-10,1.6e-07,154,227,84,158,71,181,0.82,73,74,110
OceanDNA-b30874,184,14.0,0.0,2.3e-06,0.0027,139,180,137,179,128,198,0.82,41,42,70
OceanDNA-b24879,657,5.2,0.0,0.0011,0.98,150,185,125,160,116,166,0.82,35,35,50
OceanDNA-b32582,919,15.2,0.1,4.7e-07,0.00094,160,188,124,152,97,163,0.82,28,28,66
OceanDNA-b23850,7,4.3,0.0,0.003,1.5,231,266,229,266,203,271,0.82,35,37,68
OceanDNA-b14104,303,10.6,0.0,3.5e-05,0.0056,151,212,153,217,135,245,0.82,61,64,110
OceanDNA-b38586,338,26.3,0.0,1.9e-10,1.1e-07,75,185,41,162,9,227,0.82,110,121,218
OceanDNA-b15450,1537,-1.2,0.1,0.094,97.0,159,176,110,127,93,137,0.82,17,17,44
OceanDNA-b36995,376,22.8,0.0,2.3e-09,1.8e-06,129,207,220,304,214,326,0.82,78,84,112
OceanDNA-b23817,324,15.4,0.1,8.3e-07,0.00064,145,196,100,151,84,160,0.82,51,51,76
OceanDNA-b37666,564,15.9,0.0,2.9e-07,0.00021,154,181,150,177,130,202,0.82,27,27,72
OceanDNA-b34288,84,17.9,0.0,1.4e-07,8.9e-05,140,184,136,181,129,207,0.82,44,45,78
OceanDNA-b9797,260,7.3,0.0,0.00012,0.061,192,219,212,239,200,257,0.82,27,27,57
OceanDNA-b46505,99,10.9,0.1,1.9e-05,0.02,153,186,264,298,247,307,0.82,33,34,60
OceanDNA-b22478,1038,-1.1,0.0,0.086,100.0,105,122,75,92,64,96,0.82,17,17,32
OceanDNA-b16135,572,11.8,0.1,1.6e-05,0.0049,187,253,21,91,10,105,0.82,66,70,95
OceanDNA-b29389,999,2.4,0.0,0.0039,9.0,153,180,173,200,157,211,0.82,27,27,54
OceanDNA-b34630,460,13.2,0.0,3.8e-06,0.0018,139,181,170,213,157,228,0.82,42,43,71
OceanDNA-b16224,1390,6.2,0.0,0.00027,0.42,78,139,248,304,222,316,0.82,61,56,94
OceanDNA-b31994,2391,-2.3,0.0,0.1,330.0,192,212,215,235,203,269,0.82,20,20,66
OceanDNA-b45818,1209,14.7,0.3,2.1e-06,0.001,90,169,76,155,56,167,0.82,79,79,111
OceanDNA-b26049,90,15.2,0.0,4.9e-07,0.00015,155,181,8,34,2,61,0.82,26,26,59
OceanDNA-b22112,1138,134.4,0.0,2.3e-43,5.2e-40,29,276,48,302,19,315,0.82,247,254,296
OceanDNA-b3717,1233,23.8,0.0,1.1e-09,1.6e-06,153,245,142,237,124,255,0.82,92,95,131
OceanDNA-b3975,475,18.2,0.0,2.4e-07,5e-05,143,184,141,182,121,194,0.82,41,41,73
OceanDNA-b44694,1736,12.0,0.0,4.4e-06,0.017,159,180,148,169,125,217,0.82,21,21,92
OceanDNA-b1738,344,1.6,0.0,0.0067,24.0,154,187,169,202,150,215,0.82,33,33,65
OceanDNA-b32197,69,12.2,0.0,3.8e-06,0.0074,158,186,149,177,130,193,0.82,28,28,63
OceanDNA-b29510,997,27.6,0.3,1.6e-10,2e-07,80,179,57,163,43,177,0.82,99,106,134
OceanDNA-b44633,3550,5.5,0.0,0.00044,1.6,148,174,109,135,97,196,0.82,26,26,99
OceanDNA-b47035,404,10.8,0.0,1e-05,0.0065,154,188,216,251,192,281,0.82,34,35,89
OceanDNA-b34288,969,12.3,0.0,7.1e-06,0.0044,197,265,619,689,598,697,0.82,68,70,99
OceanDNA-b30162,1755,11.7,0.1,5.4e-06,0.014,144,184,80,120,60,128,0.82,40,40,68
OceanDNA-b37742,52,25.9,0.0,2.7e-10,2.2e-07,140,184,104,151,97,164,0.82,44,47,67
OceanDNA-b22876,1950,12.1,0.0,4.2e-06,0.015,149,186,164,201,144,225,0.82,37,37,81
OceanDNA-b15136,655,0.0,0.0,0.02,14.0,153,189,536,572,518,584,0.82,36,36,66
OceanDNA-b24091,193,-1.3,0.0,0.053,52.0,192,216,295,319,286,336,0.82,24,24,50
OceanDNA-b14104,138,12.3,0.0,1.1e-05,0.0017,160,183,112,135,56,141,0.82,23,23,85
OceanDNA-b34879,249,12.1,0.0,4.2e-06,0.0038,139,178,132,172,125,187,0.82,39,40,62
OceanDNA-b3337,2399,9.1,0.0,7.1e-05,0.13,86,122,187,224,178,240,0.82,36,37,62
OceanDNA-b45351,1188,34.3,0.0,7.4e-13,9.5e-10,151,245,156,253,140,260,0.82,94,97,120
OceanDNA-b16117,600,5.5,0.0,0.00087,0.33,140,180,86,125,67,139,0.82,40,39,72
OceanDNA-b38572,538,16.5,0.0,1.9e-07,0.00011,77,190,27,144,18,153,0.82,113,117,135
OceanDNA-b4143,1413,12.2,0.0,1.2e-05,0.0064,196,266,194,262,184,293,0.82,70,68,109
OceanDNA-b13084,750,19.9,0.0,3.7e-08,4.6e-05,104,176,222,299,143,305,0.82,72,77,162
OceanDNA-b4143,174,24.3,0.0,2.4e-09,1.3e-06,86,187,139,243,133,253,0.82,101,104,120
OceanDNA-b7352,307,12.2,0.0,4.1e-06,0.0014,135,187,114,164,68,172,0.82,52,50,104
OceanDNA-b46252,1934,14.3,0.0,3.5e-06,0.002,152,184,231,263,211,274,0.82,32,32,63
OceanDNA-b17763,2384,12.9,0.1,2.5e-06,0.01,141,183,189,230,157,240,0.82,42,41,83
OceanDNA-b23287,922,10.7,0.8,1.1e-05,0.028,149,187,209,250,204,253,0.82,38,41,49
OceanDNA-b7645,100,12.4,0.0,3.4e-06,0.00062,138,185,157,205,148,236,0.82,47,48,88
OceanDNA-b41231,1572,11.0,0.1,9.3e-06,0.029,105,182,11,91,4,98,0.82,77,80,94
OceanDNA-b23148,1734,13.7,0.0,2.7e-06,0.0035,142,188,158,204,150,219,0.82,46,46,69
OceanDNA-b15188,166,11.6,0.0,5.8e-06,0.0012,146,182,84,119,75,126,0.82,36,35,51
OceanDNA-b3887,273,17.0,0.0,1.3e-07,0.00011,154,215,179,243,155,271,0.82,61,64,116
OceanDNA-b37118,444,17.6,0.2,8.9e-08,7.4e-05,89,173,89,180,58,193,0.82,84,91,135
OceanDNA-b3670,106,10.6,0.0,1.2e-05,0.0092,143,180,91,128,79,138,0.82,37,37,59
OceanDNA-b6846,218,15.6,0.0,3.6e-07,0.00021,187,262,269,339,251,340,0.82,75,70,89
OceanDNA-b36666,772,15.6,0.0,7.1e-07,0.00043,157,186,161,190,140,210,0.82,29,29,70
OceanDNA-b8602,166,13.9,0.0,1.2e-06,0.0002,160,231,8,81,3,95,0.82,71,73,92
OceanDNA-b36666,625,-2.7,0.0,0.27,160.0,178,217,257,296,242,310,0.82,39,39,68
OceanDNA-b37349,143,10.7,0.0,1.1e-05,0.0073,128,191,211,276,205,285,0.82,63,65,80
OceanDNA-b22226,977,27.1,0.0,1.1e-10,1.9e-07,152,223,162,234,150,260,0.82,71,72,110
OceanDNA-b35110,497,10.9,0.0,9.7e-06,0.0076,153,187,72,106,48,124,0.82,34,34,76
OceanDNA-b11963,1108,40.0,0.5,1.3e-14,2.6e-11,85,243,126,289,115,302,0.82,158,163,187
OceanDNA-b30217,1058,7.3,0.0,0.00012,0.28,176,246,267,342,254,348,0.82,70,75,94
OceanDNA-b3645,564,13.2,0.0,1.9e-06,0.0017,187,228,280,319,274,355,0.82,41,39,81
OceanDNA-b31685,148,10.8,0.0,2.1e-05,0.025,130,187,97,153,73,171,0.82,57,56,98
OceanDNA-b38518,99,17.8,0.0,7.9e-08,7.3e-05,148,186,137,175,116,195,0.82,38,38,79
OceanDNA-b41544,1033,12.6,0.1,3e-06,0.0033,98,169,75,144,65,161,0.82,71,69,96
OceanDNA-b4290,7,1.4,0.0,0.0077,1.9,153,189,36,72,22,83,0.82,36,36,61
OceanDNA-b40235,671,15.6,0.0,3.5e-07,0.00026,154,183,150,180,130,200,0.82,29,30,70
OceanDNA-b24040,1710,7.9,0.1,8e-05,0.14,154,175,7,28,2,44,0.82,21,21,42
OceanDNA-b23519,926,8.0,0.0,0.00015,0.12,160,187,228,255,193,285,0.82,27,27,92
OceanDNA-b20595,175,47.2,0.1,8.4e-17,2.3e-14,68,190,90,217,70,225,0.82,122,127,155
OceanDNA-b28010,562,4.6,0.1,0.00083,2.6,199,266,209,274,201,277,0.82,67,65,76
OceanDNA-b23519,926,-1.9,0.1,0.15,120.0,10,46,62,98,56,113,0.82,36,36,57
OceanDNA-b34299,271,16.6,0.0,3.6e-07,0.00037,139,180,124,167,112,181,0.82,41,43,69
OceanDNA-b39181,167,14.8,0.0,6.2e-07,0.00028,140,183,135,180,125,191,0.82,43,45,66
OceanDNA-b1751,2372,22.6,0.1,2.6e-09,7.5e-06,149,185,72,108,64,138,0.82,36,36,74
OceanDNA-b21580,140,18.3,0.0,5.3e-08,1.9e-05,152,194,157,200,102,211,0.82,42,43,109
OceanDNA-b33096,702,16.4,0.0,4.2e-07,0.00027,153,181,162,190,142,217,0.82,28,28,75
OceanDNA-b46252,556,11.1,0.0,3.5e-05,0.02,150,190,238,278,221,292,0.82,40,40,71
OceanDNA-b30073,1107,7.4,0.0,0.00011,0.26,192,231,258,297,228,319,0.82,39,39,91
OceanDNA-b46693,1129,37.7,0.0,6.9e-14,1.6e-10,153,243,263,356,254,370,0.82,90,93,116
OceanDNA-b32148,502,11.8,0.1,5.4e-06,0.0099,97,187,36,128,28,133,0.82,90,92,105
OceanDNA-b38596,380,16.9,0.0,1.4e-07,6.7e-05,140,186,15,62,9,107,0.82,46,47,98
OceanDNA-b23169,1844,12.8,0.0,5e-06,0.0056,149,187,153,192,143,223,0.82,38,39,80
OceanDNA-b22607,431,11.3,0.0,2.2e-05,0.0065,215,279,12,77,4,87,0.82,64,65,83
OceanDNA-b29385,2659,-0.6,0.0,0.031,100.0,250,288,579,619,568,621,0.82,38,40,53
OceanDNA-b40618,366,14.9,0.0,2.4e-06,0.00036,100,182,34,110,22,122,0.82,82,76,100
OceanDNA-b37433,682,-0.4,0.0,0.027,32.0,197,238,266,306,252,316,0.82,41,40,64
OceanDNA-b40639,544,18.5,0.0,9.5e-08,3.4e-05,153,189,145,182,87,235,0.82,36,37,148
OceanDNA-b31504,233,12.2,0.0,4e-06,0.0018,194,245,244,293,222,314,0.82,51,49,92
OceanDNA-b23549,1297,12.1,0.2,1.2e-05,0.0081,160,189,132,162,112,173,0.82,29,30,61
OceanDNA-b38574,185,10.4,0.0,1.3e-05,0.0093,135,189,97,151,18,160,0.82,54,54,142
OceanDNA-b5161,252,-1.1,0.0,0.044,12.0,194,216,211,233,205,248,0.82,22,22,43
OceanDNA-b62,258,12.6,0.1,3e-06,0.0014,157,186,178,207,163,212,0.82,29,29,49
OceanDNA-b23725,806,10.4,0.0,4.3e-05,0.031,162,187,118,143,111,162,0.82,25,25,51
OceanDNA-b13256,1037,-3.6,0.0,1.2,490.0,263,281,83,101,80,106,0.82,18,18,26
OceanDNA-b40237,535,14.4,0.0,8.1e-07,0.0006,154,183,148,178,130,198,0.82,29,30,68
OceanDNA-b11434,237,10.8,0.0,1.1e-05,0.0049,142,182,79,119,73,133,0.82,40,40,60
OceanDNA-b32834,486,10.7,0.0,2.2e-05,0.0091,159,192,180,214,154,223,0.82,33,34,69
OceanDNA-b32861,681,3.8,0.0,0.0028,1.8,190,229,271,310,243,318,0.82,39,39,75
OceanDNA-b13256,77,16.3,0.0,1.1e-06,0.00043,140,180,134,176,126,190,0.82,40,42,64
OceanDNA-b22787,1319,11.0,0.0,8.8e-06,0.012,151,217,117,185,100,192,0.82,66,68,92
OceanDNA-b22893,2192,2.6,0.1,0.0098,7.6,37,81,138,182,113,190,0.82,44,44,77
OceanDNA-b9793,474,12.7,0.0,2.7e-06,0.0015,188,255,209,271,190,283,0.82,67,62,93
OceanDNA-b12532,131,126.0,0.0,8.4e-41,2.6e-38,53,283,51,296,41,310,0.82,230,245,269
OceanDNA-b40250,557,15.6,0.0,7.5e-07,0.00027,180,245,283,353,278,358,0.82,65,70,80
OceanDNA-b29385,2659,4.9,0.0,0.00064,2.1,177,245,470,543,453,549,0.82,68,73,96
OceanDNA-b23643,888,15.9,0.0,2.8e-07,0.00071,140,192,106,158,84,170,0.82,52,52,86
OceanDNA-b22306,1201,1.0,0.0,0.02,17.0,96,122,175,201,159,206,0.82,26,26,47
OceanDNA-b37960,533,7.2,0.0,0.00027,0.075,58,120,56,117,28,126,0.82,62,61,98
OceanDNA-b11187,24,25.3,0.0,4.1e-10,2e-07,152,227,147,223,132,247,0.82,75,76,115
OceanDNA-b42293,157,10.4,0.0,1.4e-05,0.0028,153,221,96,167,85,185,0.82,68,71,100
OceanDNA-b22249,621,1.3,0.0,0.008,24.0,191,236,264,307,247,328,0.82,45,43,81
OceanDNA-b1140,552,11.7,0.0,5.5e-06,0.0085,148,188,96,136,83,167,0.82,40,40,84
OceanDNA-b46722,616,14.3,0.0,1.8e-06,0.0015,153,188,165,201,155,240,0.82,35,36,85
OceanDNA-b23484,982,7.4,0.0,0.00023,0.2,183,247,225,285,218,307,0.82,64,60,89
OceanDNA-b42188,85,11.7,0.0,5.4e-06,0.0016,154,217,126,191,114,234,0.82,63,65,120
OceanDNA-b46638,296,10.8,0.0,3.1e-05,0.017,153,188,127,163,114,193,0.82,35,36,79
OceanDNA-b36456,1321,5.3,0.0,0.0005,1.1,195,219,275,299,236,314,0.82,24,24,78
OceanDNA-b23634,126,6.5,0.0,0.00063,0.52,194,239,269,314,250,330,0.82,45,45,80
OceanDNA-b35111,5,13.8,0.0,1.2e-06,0.00065,140,183,124,168,111,205,0.82,43,44,94
OceanDNA-b9760,691,19.5,0.0,2.3e-08,2e-05,75,211,94,241,76,250,0.82,136,147,174
OceanDNA-b43678,719,14.3,0.0,9e-07,0.00089,148,190,76,118,55,139,0.82,42,42,84
OceanDNA-b41599,745,10.3,0.0,1.5e-05,0.011,154,181,143,170,120,187,0.82,27,27,67
OceanDNA-b32200,2047,7.9,0.0,8.2e-05,0.19,149,187,108,149,94,161,0.82,38,41,67
OceanDNA-b30149,3169,13.0,1.0,2.2e-06,0.0078,126,180,248,302,240,308,0.82,54,54,68
OceanDNA-b11517,108,13.1,0.0,2.1e-06,0.001,152,217,172,239,147,289,0.82,65,67,142
OceanDNA-b6569,486,6.4,0.1,0.00023,0.2,161,197,109,149,50,155,0.82,36,40,105
OceanDNA-b6771,803,13.9,0.0,3.7e-06,0.0011,152,233,125,210,119,239,0.82,81,85,120
OceanDNA-b34671,566,37.3,0.5,8.9e-14,6.7e-11,69,172,155,272,130,276,0.82,103,117,146
OceanDNA-b8277,70,12.8,0.0,2.6e-06,0.00054,160,234,121,197,109,211,0.82,74,76,102
OceanDNA-b30622,11,16.6,0.0,1.8e-07,0.00012,154,181,146,173,127,204,0.82,27,27,77
OceanDNA-b17766,436,7.1,4.2,0.00014,0.64,148,178,34,64,13,76,0.82,30,30,63
OceanDNA-b40548,301,9.4,0.1,2.7e-05,0.031,107,179,142,210,139,225,0.82,72,68,86
OceanDNA-b17590,334,16.8,0.0,1.5e-07,0.00054,152,223,147,218,125,232,0.82,71,71,107
OceanDNA-b29,4639,17.0,0.1,5.4e-07,0.00068,70,172,41,139,15,228,0.82,102,98,213
OceanDNA-b46852,56,13.2,0.0,5.9e-06,0.0024,154,189,150,186,134,243,0.82,35,36,109
OceanDNA-b33328,1067,1.5,0.0,0.0074,8.6,195,233,185,222,182,252,0.82,38,37,70
OceanDNA-b36739,316,7.1,0.0,0.00014,0.088,195,238,232,274,218,286,0.82,43,42,68
OceanDNA-b23104,2618,10.3,0.0,3e-05,0.06,153,188,7,43,3,56,0.82,35,36,53
OceanDNA-b30783,1420,12.0,0.0,4.6e-06,0.0066,149,197,98,146,78,153,0.82,48,48,75
OceanDNA-b28545,234,19.7,0.0,2e-08,4.1e-05,140,181,124,167,121,186,0.82,41,43,65
OceanDNA-b43875,440,13.7,0.0,1.4e-06,0.00079,153,185,113,145,95,154,0.82,32,32,59
OceanDNA-b9687,398,-0.1,0.0,0.023,20.0,152,189,540,577,520,585,0.82,37,37,65
OceanDNA-b40210,208,10.1,0.0,1.8e-05,0.0095,151,215,184,251,174,261,0.82,64,67,87
OceanDNA-b4256,145,11.0,0.0,9.3e-06,0.0024,198,266,228,298,218,298,0.82,68,70,80
OceanDNA-b13057,271,13.1,0.0,2.1e-06,0.0018,157,181,148,172,137,183,0.82,24,24,46
OceanDNA-b37345,482,13.4,0.0,5e-06,0.0023,197,245,264,310,240,331,0.82,48,46,91
OceanDNA-b2796,1858,1.0,0.0,0.02,21.0,197,218,331,352,324,373,0.82,21,21,49
OceanDNA-b17396,1318,30.1,0.0,1.4e-11,2.5e-08,152,243,207,302,188,314,0.82,91,95,126
OceanDNA-b6771,196,11.8,0.1,1.5e-05,0.0047,174,239,219,282,215,295,0.82,65,63,80
OceanDNA-b22517,2947,37.3,0.0,1.8e-13,3e-10,153,249,189,289,176,295,0.82,96,100,119
OceanDNA-b20988,1339,12.1,0.0,4.2e-06,0.0082,138,182,630,674,623,678,0.82,44,44,55
OceanDNA-b30095,1825,10.6,0.0,3.6e-05,0.03,160,185,89,114,30,129,0.82,25,25,99
OceanDNA-b1820,904,20.2,0.2,2.9e-08,3.1e-05,80,186,19,125,3,143,0.82,106,106,140
OceanDNA-b17572,742,5.3,0.0,0.00051,0.49,158,188,9,39,2,49,0.82,30,30,47
OceanDNA-b32851,680,19.3,0.3,2.7e-08,2.1e-05,95,188,33,121,14,131,0.82,93,88,117
OceanDNA-a1742,512,15.4,0.0,4.1e-07,0.00042,160,194,42,76,26,83,0.82,34,34,57
OceanDNA-b41321,32,0.8,0.0,0.012,8.2,189,217,195,224,183,233,0.82,28,29,50
OceanDNA-b27518,1644,15.2,0.0,4.9e-07,0.0009,153,179,144,170,126,183,0.82,26,26,57
OceanDNA-b3564,323,11.2,0.0,7.7e-06,0.0043,161,194,108,142,103,158,0.82,33,34,55
OceanDNA-b41321,32,7.6,0.0,9.8e-05,0.069,160,185,73,98,64,116,0.82,25,25,52
OceanDNA-b35278,403,10.8,0.0,2.2e-05,0.0087,197,251,589,643,585,653,0.82,54,54,68
OceanDNA-a3737,266,9.4,0.0,2.9e-05,0.0082,182,216,156,193,151,206,0.82,34,37,55
OceanDNA-b34674,221,35.0,0.1,4.4e-13,2.7e-10,67,172,134,253,113,258,0.82,105,119,145
OceanDNA-b47081,476,15.8,0.0,6.4e-07,0.00018,149,193,250,294,236,305,0.82,44,44,69
OceanDNA-b13269,232,8.4,0.0,5.5e-05,0.054,159,185,198,224,186,229,0.82,26,26,43
OceanDNA-b13269,232,2.1,0.0,0.0046,4.5,193,243,316,365,311,371,0.82,50,49,60
OceanDNA-b26893,2035,24.4,0.0,1.5e-09,2.5e-06,87,180,92,192,84,204,0.82,93,100,120
OceanDNA-b46534,918,15.3,0.0,4.3e-07,0.00065,138,185,123,168,113,177,0.82,47,45,64
OceanDNA-b7494,551,16.4,0.0,2e-07,0.00024,96,180,21,101,14,111,0.82,84,80,97
OceanDNA-b3242,329,2.8,0.0,0.003,2.5,196,245,253,302,244,312,0.82,49,49,68
OceanDNA-b9096,35,40.1,0.0,1.2e-14,4.3e-12,82,176,131,236,101,245,0.82,94,105,144
OceanDNA-b24219,68,-1.0,0.0,0.04,47.0,251,284,281,314,271,321,0.82,33,33,50
OceanDNA-b41587,251,18.8,0.0,7.8e-08,2.6e-05,156,254,221,318,174,337,0.82,98,97,163
OceanDNA-b33329,584,6.4,0.0,0.00069,0.36,143,173,145,175,113,185,0.82,30,30,72
OceanDNA-b19701,335,15.7,0.0,1e-06,0.00014,146,191,22,67,4,89,0.82,45,45,85
OceanDNA-b35250,67,11.4,0.0,6.8e-06,0.0046,197,251,583,637,578,647,0.82,54,54,69
OceanDNA-b28718,16,14.1,0.0,1e-06,0.00051,153,179,148,174,132,191,0.82,26,26,59
OceanDNA-b3641,425,-2.2,0.0,0.094,48.0,203,230,16,46,7,49,0.82,27,30,42
OceanDNA-b26605,363,16.6,0.1,1.8e-07,9.9e-05,151,185,144,178,126,213,0.82,34,34,87
OceanDNA-b510,1001,5.6,0.1,0.0008,0.86,155,185,138,168,79,172,0.82,30,30,93
OceanDNA-b2854,2986,11.4,0.0,1.4e-05,0.025,155,185,112,142,77,171,0.82,30,30,94
OceanDNA-b24591,1847,9.5,0.7,5.3e-05,0.073,104,175,68,142,50,154,0.82,71,74,104
OceanDNA-b35946,297,16.4,0.0,2e-07,9.1e-05,139,181,124,167,110,185,0.82,42,43,75
OceanDNA-b45059,186,12.8,0.0,2.6e-06,0.0017,89,189,33,131,28,148,0.82,100,98,120
OceanDNA-b32152,3251,11.5,0.0,1.2e-05,0.021,154,180,233,259,215,272,0.82,26,26,57
OceanDNA-b32152,821,17.5,0.0,1.9e-07,0.00033,108,173,155,218,56,238,0.82,65,63,182
OceanDNA-b9684,441,13.0,0.0,4.6e-06,0.0017,159,183,150,174,132,184,0.82,24,24,52
OceanDNA-b22477,939,12.1,0.4,4.3e-06,0.0073,65,177,10,124,2,136,0.82,112,114,134
OceanDNA-b36330,589,10.9,0.0,9.7e-06,0.0067,144,180,145,181,113,204,0.82,36,36,91
OceanDNA-b31304,96,14.2,0.0,9.5e-07,0.0011,149,187,75,113,41,126,0.82,38,38,85
OceanDNA-b33195,96,13.5,0.0,1.5e-06,0.0011,161,193,117,153,90,166,0.82,32,36,76
OceanDNA-b20036,28,15.1,0.0,1.5e-06,0.0002,157,181,141,165,117,173,0.82,24,24,56
OceanDNA-b22022,2999,19.5,0.0,4.6e-08,7.7e-05,153,212,159,225,140,241,0.82,59,66,101
OceanDNA-b2928,1170,-0.8,0.0,0.036,43.0,200,221,292,312,284,321,0.82,21,20,37
OceanDNA-b40947,105,9.9,0.1,3.9e-05,0.015,107,181,135,205,132,219,0.82,74,70,87
OceanDNA-b6300,45,8.0,0.0,7.3e-05,0.04,134,177,98,139,22,152,0.82,43,41,130
OceanDNA-b3983,883,7.4,0.0,0.00034,0.12,153,181,150,178,132,187,0.82,28,28,55
OceanDNA-b16165,665,14.7,0.0,6.6e-07,0.00058,106,202,193,290,170,298,0.82,96,97,128
OceanDNA-b26917,1112,7.0,0.0,0.0003,0.24,161,187,121,147,65,185,0.82,26,26,120
OceanDNA-b22905,549,11.8,0.0,1.6e-05,0.014,108,169,188,253,180,261,0.82,61,65,81
OceanDNA-b22905,1224,9.8,0.0,6.2e-05,0.057,150,183,237,270,225,276,0.82,33,33,51
OceanDNA-b34611,71,18.5,0.0,4.8e-08,6.1e-05,197,264,613,682,599,688,0.82,67,69,89
OceanDNA-b40624,141,17.3,0.0,2.2e-07,0.00011,154,183,143,172,121,196,0.82,29,29,75
OceanDNA-b4282,21,26.3,0.0,2e-10,5.5e-08,152,243,144,237,132,247,0.82,91,93,115
OceanDNA-b44368,64,12.7,0.0,2.7e-06,0.00061,152,186,170,205,137,217,0.82,34,35,80
OceanDNA-b2578,226,11.9,0.0,4.7e-06,0.0018,155,185,244,275,210,294,0.82,30,31,84
OceanDNA-b21507,90,3.4,0.0,0.0019,0.33,57,82,287,311,270,316,0.82,25,24,46
OceanDNA-b28564,1477,9.2,0.0,3.3e-05,0.09,192,230,246,284,218,294,0.82,38,38,76
OceanDNA-b18463,143,12.4,0.0,3.4e-06,0.0011,152,185,121,154,34,193,0.82,33,33,159
OceanDNA-b32721,1677,4.6,0.0,0.0017,1.9,196,239,323,365,316,379,0.82,43,42,63
OceanDNA-b44359,339,5.2,0.1,0.00054,0.66,153,181,177,206,153,212,0.82,28,29,59
OceanDNA-b1008,2019,17.9,0.1,7.1e-08,0.00015,138,190,62,113,42,149,0.82,52,51,107
OceanDNA-b41273,1430,10.8,0.2,2.2e-05,0.02,148,187,208,247,182,255,0.82,39,39,73
OceanDNA-b22871,3196,14.3,0.1,9e-07,0.0035,95,185,81,168,54,197,0.82,90,87,143
OceanDNA-b21018,732,7.5,0.0,0.00011,0.36,157,181,144,168,108,177,0.82,24,24,69
OceanDNA-b21017,221,11.0,0.2,1.9e-05,0.023,161,191,53,83,31,97,0.82,30,30,66
OceanDNA-b32709,1359,-3.1,0.0,0.37,310.0,197,217,315,335,310,350,0.82,20,20,40
OceanDNA-b22842,1272,3.8,0.1,0.0028,6.5,197,220,377,399,370,413,0.82,23,22,43
OceanDNA-b41695,121,14.9,0.0,1.2e-06,0.00011,98,188,33,121,28,127,0.82,90,88,99
OceanDNA-b3653,294,11.8,0.0,2.1e-05,0.012,157,217,40,99,20,120,0.82,60,59,100
OceanDNA-b37161,189,-2.6,0.0,0.13,140.0,196,215,208,227,204,231,0.82,19,19,27
OceanDNA-b5433,327,146.7,0.1,4.1e-47,1.8e-44,53,286,35,285,24,291,0.82,233,250,267
OceanDNA-b23984,1143,12.1,0.0,4.1e-06,0.0072,105,187,58,139,38,168,0.82,82,81,130
OceanDNA-b14149,56,-1.4,0.0,0.054,26.0,162,178,199,215,194,218,0.82,16,16,24
OceanDNA-b30,835,10.5,0.1,2.7e-05,0.049,145,181,187,223,158,232,0.82,36,36,74
OceanDNA-b37264,824,12.2,0.0,4e-06,0.0053,151,182,155,186,119,193,0.82,31,31,74
OceanDNA-b17054,10,13.5,0.0,1.5e-06,0.00045,89,131,136,182,128,188,0.82,42,46,60
OceanDNA-b22397,559,14.6,0.0,2.8e-06,0.0019,152,182,263,293,240,300,0.82,30,30,60
OceanDNA-b12512,193,29.6,0.0,1.9e-11,6e-09,159,244,152,240,135,255,0.82,85,88,120
OceanDNA-b12076,229,-2.9,0.0,0.16,66.0,192,213,217,238,214,243,0.82,21,21,29
OceanDNA-b30001,346,2.1,0.0,0.0096,7.8,194,244,279,330,259,333,0.82,50,51,74
OceanDNA-b34767,147,22.2,0.0,6.9e-09,3.1e-06,153,188,210,246,196,285,0.82,35,36,89
OceanDNA-b38975,199,51.2,0.4,5.2e-18,1.1e-14,74,272,106,294,46,310,0.82,198,188,264
OceanDNA-b42457,240,7.6,0.0,9.6e-05,0.031,145,180,127,162,117,171,0.82,35,35,54
OceanDNA-b34300,355,11.3,0.0,7.6e-06,0.0067,152,186,99,133,56,182,0.82,34,34,126
OceanDNA-b3635,2176,12.7,0.0,5.4e-06,0.007,158,188,143,174,125,186,0.82,30,31,61
OceanDNA-b28050,935,11.3,0.0,7.6e-06,0.0088,156,270,107,225,78,225,0.82,114,118,147
OceanDNA-b23379,895,12.2,0.0,7.8e-06,0.0089,152,187,329,365,313,374,0.82,35,36,61
OceanDNA-a4358,55,1.9,0.0,0.0054,1.9,53,88,169,205,162,217,0.82,35,36,55
OceanDNA-b30570,249,18.4,0.0,5e-08,0.00014,140,180,173,215,169,234,0.82,40,42,65
OceanDNA-b3654,348,11.1,0.0,8.3e-06,0.011,176,248,281,359,269,384,0.82,72,78,115
OceanDNA-b22250,1966,13.9,0.0,1.2e-06,0.0038,153,188,139,175,107,185,0.82,35,36,78
OceanDNA-b23556,470,-2.2,0.0,0.097,220.0,196,228,314,346,311,350,0.82,32,32,39
OceanDNA-b5274,115,-1.8,0.0,0.073,48.0,258,285,687,714,679,720,0.82,27,27,41
OceanDNA-b36771,228,5.6,0.0,0.0004,0.44,90,121,137,168,125,174,0.82,31,31,49
OceanDNA-b23401,359,0.7,0.0,0.013,28.0,198,244,645,691,626,709,0.82,46,46,83
OceanDNA-b36411,1312,13.5,0.0,3.1e-06,0.0031,138,181,122,166,110,180,0.82,43,44,70
OceanDNA-b40920,956,8.5,0.0,0.0001,0.064,160,187,88,115,82,126,0.82,27,27,44
OceanDNA-a2259,510,12.4,0.0,3.5e-06,0.0029,92,181,102,192,93,200,0.82,89,90,107
OceanDNA-b39196,629,17.0,0.0,1.3e-07,0.0001,140,183,141,186,136,203,0.82,43,45,67
OceanDNA-b44,2537,8.4,0.0,0.00011,0.42,195,228,201,233,193,260,0.82,33,32,67
OceanDNA-b20894,3731,10.3,0.1,3.1e-05,0.066,197,254,245,299,233,308,0.82,57,54,75
OceanDNA-b36951,151,12.4,0.1,3.5e-06,0.0032,175,223,73,122,68,132,0.82,48,49,64
OceanDNA-b36411,1726,3.3,0.0,0.0041,4.1,197,219,249,271,207,286,0.82,22,22,79
OceanDNA-b22615,4797,10.6,0.0,3.5e-05,0.069,153,188,160,196,139,216,0.82,35,36,77
OceanDNA-b20894,1026,5.0,0.0,0.0012,2.6,197,228,252,283,240,290,0.82,31,31,50
OceanDNA-b45857,2941,1.4,0.1,0.016,31.0,153,176,128,151,89,166,0.82,23,23,77
OceanDNA-b12699,83,3.5,0.0,0.0018,0.73,198,232,197,229,187,251,0.82,34,32,64
OceanDNA-b35148,1840,-3.5,0.0,0.49,510.0,198,210,328,340,311,356,0.82,12,12,45
OceanDNA-b4060,640,15.8,0.0,6.3e-07,0.00025,156,190,154,189,110,199,0.81,34,35,89
OceanDNA-b17640,25,19.3,0.0,2.7e-08,1.9e-05,148,197,184,232,159,283,0.81,49,48,124
OceanDNA-b36079,214,12.5,0.0,3.1e-06,0.0078,98,162,179,242,167,248,0.81,64,63,81
OceanDNA-b30215,1666,10.4,0.1,2.7e-05,0.025,86,189,50,159,40,173,0.81,103,109,133
OceanDNA-b26776,660,14.2,0.0,2e-06,0.0023,153,197,30,75,20,97,0.81,44,45,77
OceanDNA-b22398,1431,14.7,0.0,6.8e-07,0.002,151,212,580,647,544,673,0.81,61,67,129
OceanDNA-b41301,4206,15.6,0.0,1.1e-06,0.0017,177,246,219,289,211,300,0.81,69,70,89
OceanDNA-b22481,2461,14.2,0.4,9.9e-07,0.0034,121,192,157,231,145,238,0.81,71,74,93
OceanDNA-b23556,470,16.2,0.1,2.4e-07,0.00055,159,185,192,218,175,231,0.81,26,26,56
OceanDNA-b44852,144,20.6,0.0,1.1e-08,7.1e-06,70,186,18,145,3,188,0.81,116,127,185
OceanDNA-b22283,131,15.2,0.0,4.6e-07,0.00066,152,184,134,166,108,182,0.81,32,32,74
OceanDNA-b20992,1880,12.0,0.0,4.7e-06,0.0093,144,175,171,202,95,249,0.81,31,31,154
OceanDNA-b15137,533,11.0,0.0,2.7e-05,0.019,157,217,141,203,117,235,0.81,60,62,118
OceanDNA-b18118,196,17.5,0.0,9.9e-08,2e-05,151,209,55,117,28,125,0.81,58,62,97
OceanDNA-b31464,1668,7.6,0.0,0.0001,0.2,161,196,111,150,90,174,0.81,35,39,84
OceanDNA-b30006,1262,12.9,0.0,2.3e-06,0.0084,154,180,350,376,332,404,0.81,26,26,72
OceanDNA-b20708,83,5.8,0.0,0.00034,0.074,139,191,242,300,233,324,0.81,52,58,91
OceanDNA-b36730,1280,16.5,0.0,1.9e-07,0.00061,154,194,609,653,601,662,0.81,40,44,61
OceanDNA-b20703,336,2.0,0.0,0.005,2.0,86,121,141,176,134,184,0.81,35,35,50
OceanDNA-b36577,1192,12.7,0.0,5.4e-06,0.0052,182,222,228,268,205,293,0.81,40,40,88
OceanDNA-b3031,205,9.8,0.0,2.1e-05,0.0048,157,179,98,120,90,148,0.81,22,22,58
OceanDNA-b33288,263,14.5,0.0,1.5e-06,0.0022,80,187,49,161,43,192,0.81,107,112,149
OceanDNA-b47053,235,-3.6,0.0,0.25,170.0,156,168,30,42,9,47,0.81,12,12,38
OceanDNA-b36071,1758,14.4,0.0,1.6e-06,0.0017,139,181,138,181,126,192,0.81,42,43,66
OceanDNA-a3040,26,13.0,0.0,2.3e-06,0.0017,157,192,168,203,91,214,0.81,35,35,123
OceanDNA-b27544,463,6.8,0.1,0.00017,0.27,200,266,183,247,174,251,0.81,66,64,77
OceanDNA-a4831,35,10.5,0.1,1.3e-05,0.0055,135,170,316,354,309,359,0.81,35,38,50
OceanDNA-b22415,436,12.7,0.0,2.8e-06,0.0073,158,182,235,259,209,273,0.81,24,24,64
OceanDNA-b18639,160,7.6,0.0,0.00019,0.039,147,192,235,280,213,290,0.81,45,45,77
OceanDNA-b15326,263,-2.1,0.0,0.088,25.0,193,227,238,272,229,284,0.81,34,34,55
OceanDNA-b36402,186,11.7,0.1,5.7e-06,0.0039,153,188,163,200,150,213,0.81,35,37,63
OceanDNA-b13281,1799,16.4,0.0,4.1e-07,0.00037,153,187,115,149,103,188,0.81,34,34,85
OceanDNA-b22528,305,9.3,0.0,3e-05,0.024,192,245,140,190,123,200,0.81,53,50,77
OceanDNA-b9684,662,-2.8,0.0,0.3,110.0,198,215,208,225,202,244,0.81,17,17,42
OceanDNA-b13175,254,11.3,0.0,7.4e-06,0.0067,154,180,145,171,127,205,0.81,26,26,78
OceanDNA-a3708,129,11.8,0.0,5.1e-06,0.0017,180,216,366,405,356,420,0.81,36,39,64
OceanDNA-b23832,3,3.2,0.0,0.0043,3.7,153,216,140,208,69,226,0.81,63,68,157
OceanDNA-b16674,643,10.8,0.0,1e-05,0.0083,136,184,480,529,442,544,0.81,48,49,102
OceanDNA-b8078,199,15.9,0.0,3e-07,6.3e-05,149,186,165,203,145,234,0.81,37,38,89
OceanDNA-b31575,1583,9.4,0.1,2.8e-05,0.049,149,185,159,195,81,204,0.81,36,36,123
OceanDNA-b4027,527,22.7,0.0,2.5e-09,2.1e-06,101,212,132,253,98,275,0.81,111,121,177
OceanDNA-b29542,14,17.3,0.0,2.2e-07,0.00024,153,185,138,170,121,210,0.81,32,32,89
OceanDNA-b44,4810,0.4,0.0,0.032,120.0,151,189,532,570,520,579,0.81,38,38,59
OceanDNA-b45014,133,-1.5,0.0,0.059,42.0,196,219,221,244,216,292,0.81,23,23,76
OceanDNA-b23519,427,3.8,0.0,0.0028,2.1,195,267,201,271,193,292,0.81,72,70,99
OceanDNA-b44662,1421,20.7,0.9,2.1e-08,2.8e-05,89,180,582,679,573,690,0.81,91,97,117
OceanDNA-b38932,129,15.0,0.0,5.4e-07,0.00033,147,186,104,143,90,173,0.81,39,39,83
OceanDNA-b17578,527,12.4,0.0,7.1e-06,0.005,140,190,175,230,138,237,0.81,50,55,99
OceanDNA-b4491,128,15.4,0.0,8.2e-07,0.00029,142,189,123,171,83,183,0.81,47,48,100
OceanDNA-b3656,205,10.5,0.0,1.3e-05,0.0069,134,180,117,162,100,175,0.81,46,45,75
OceanDNA-b30869,2097,17.2,0.2,1.2e-07,0.00027,89,178,146,242,128,248,0.81,89,96,120
OceanDNA-b259,1119,18.0,0.1,6.6e-08,9.5e-05,70,211,85,237,71,248,0.81,141,152,177
OceanDNA-b23519,427,-3.7,0.2,0.54,410.0,73,93,302,322,295,326,0.81,20,20,31
OceanDNA-b22533,692,39.5,0.0,1.8e-14,2.5e-11,153,245,158,254,149,263,0.81,92,96,114
OceanDNA-b15551,1054,1.0,0.0,0.021,22.0,28,73,60,105,35,119,0.81,45,45,84
OceanDNA-b44609,779,11.7,0.0,1.2e-05,0.011,155,181,150,176,126,195,0.81,26,26,69
OceanDNA-b6424,614,64.2,0.0,1.7e-21,3.5e-19,51,159,41,154,7,155,0.81,108,113,148
OceanDNA-b27525,414,4.9,0.1,0.0027,1.8,197,231,249,283,231,307,0.81,34,34,76
OceanDNA-a4837,44,15.1,0.1,5e-07,0.0002,135,170,316,354,309,359,0.81,35,38,50
OceanDNA-b30021,940,9.4,0.2,2.8e-05,0.052,161,198,127,168,72,190,0.81,37,41,118
OceanDNA-b42626,228,2.6,0.0,0.0034,0.85,152,181,83,112,69,122,0.81,29,29,53
OceanDNA-b26870,727,4.7,0.0,0.00075,2.3,178,245,275,347,260,357,0.81,67,72,97
OceanDNA-b16046,1508,12.3,0.1,3.6e-06,0.011,77,190,54,171,39,194,0.81,113,117,155
OceanDNA-b4102,811,7.0,0.0,0.00015,0.15,194,229,228,261,223,267,0.81,35,33,44
OceanDNA-b44390,51,-3.3,0.0,0.61,140.0,156,180,187,211,177,221,0.81,24,24,44
OceanDNA-b17611,2958,12.3,0.0,1.1e-05,0.012,151,188,111,149,93,160,0.81,37,38,67
OceanDNA-b1575,593,10.5,0.0,1.3e-05,0.011,159,187,84,112,71,122,0.81,28,28,51
OceanDNA-b260,485,9.6,0.1,4.7e-05,0.077,58,120,46,110,22,115,0.81,62,64,93
OceanDNA-b45796,2024,21.6,0.0,5.6e-09,1.2e-05,152,219,154,222,141,251,0.81,67,68,110
OceanDNA-b22377,1876,21.9,0.0,4.2e-09,9.7e-06,152,214,195,259,179,270,0.81,62,64,91
OceanDNA-b24935,1054,14.3,0.2,9.2e-07,0.0023,125,191,109,180,88,204,0.81,66,71,116
OceanDNA-b34894,620,12.2,0.2,3.9e-06,0.0034,165,218,2,54,1,92,0.81,53,52,91
OceanDNA-b27525,414,6.8,0.2,0.00069,0.46,151,181,118,148,105,209,0.81,30,30,104
OceanDNA-b19769,209,28.0,0.0,1.2e-10,2.9e-08,153,240,137,225,126,248,0.81,87,88,122
OceanDNA-b30970,2355,8.3,0.0,6.2e-05,0.15,152,188,102,137,51,167,0.81,36,35,116
OceanDNA-b30970,2355,2.6,0.0,0.0034,8.2,230,266,221,258,195,280,0.81,36,37,85
OceanDNA-b45859,2819,1.0,0.1,0.02,36.0,154,177,223,246,183,260,0.81,23,23,77
OceanDNA-b16147,423,0.8,0.0,0.023,8.1,192,232,405,445,384,469,0.81,40,40,85
OceanDNA-b33525,417,1.6,0.0,0.0066,25.0,195,249,282,333,270,347,0.81,54,51,77
OceanDNA-b16138,515,15.3,0.0,4.3e-07,0.00034,86,145,272,325,260,396,0.81,59,53,136
OceanDNA-b11316,235,10.7,0.0,2.2e-05,0.0036,151,232,170,251,146,279,0.81,81,81,133
OceanDNA-b46933,2408,18.0,0.0,6.7e-08,0.00026,149,186,244,281,223,313,0.81,37,37,90
OceanDNA-b27598,443,3.5,0.0,0.0034,3.5,148,188,157,198,131,221,0.81,40,41,90
OceanDNA-b24051,228,18.6,0.0,4.5e-08,2.5e-05,79,178,21,125,8,213,0.81,99,104,205
OceanDNA-b1738,344,9.2,0.0,3.3e-05,0.12,189,249,296,351,279,369,0.81,60,55,90
OceanDNA-b32133,1141,9.0,0.0,3.8e-05,0.094,151,185,390,425,374,431,0.81,34,35,57
OceanDNA-b38376,703,6.0,0.0,0.0012,0.77,148,187,143,182,113,192,0.81,39,39,79
OceanDNA-b45634,653,8.3,0.0,0.00012,0.044,198,262,98,159,86,163,0.81,64,61,77
OceanDNA-b34789,327,16.8,0.0,1.6e-07,0.00012,138,185,134,182,121,208,0.81,47,48,87
OceanDNA-b41002,133,39.5,0.0,1.8e-14,5.3e-11,100,274,97,272,5,290,0.81,174,175,285
OceanDNA-b13178,83,3.5,0.0,0.0018,1.4,159,183,110,134,97,153,0.81,24,24,56
OceanDNA-b17743,1373,11.7,0.0,1.6e-05,0.021,153,188,500,535,492,559,0.81,35,35,67
OceanDNA-b32156,919,13.2,0.1,3.9e-06,0.0054,18,85,45,115,31,125,0.81,67,70,94
OceanDNA-b38033,431,16.7,0.0,1.7e-07,0.00015,140,180,8,50,5,70,0.81,40,42,65
OceanDNA-b1719,179,15.2,0.1,9.4e-07,0.0014,192,267,292,365,286,381,0.81,75,73,95
OceanDNA-b15889,227,22.1,0.0,3.8e-09,1.1e-06,153,213,123,192,107,214,0.81,60,69,107
OceanDNA-b37960,390,14.8,0.0,1.3e-06,0.00037,144,192,77,125,66,134,0.81,48,48,68
OceanDNA-b7431,155,11.1,0.0,8.6e-06,0.003,159,227,127,198,120,217,0.81,68,71,97
OceanDNA-b1132,1605,11.4,0.0,7e-06,0.011,149,195,442,492,392,498,0.81,46,50,106
OceanDNA-b10305,433,10.4,0.0,1.4e-05,0.006,199,264,344,411,325,412,0.81,65,67,87
OceanDNA-b46728,1637,22.5,0.0,8.7e-09,4.8e-06,154,243,197,288,187,296,0.81,89,91,109
OceanDNA-b35901,22,6.7,0.0,0.00038,0.11,194,230,221,257,195,265,0.81,36,36,70
OceanDNA-b23417,1309,15.3,0.1,1.3e-06,0.0013,152,187,580,616,563,619,0.81,35,36,56
OceanDNA-b423,584,10.9,0.0,9.5e-06,0.0093,193,254,339,398,312,408,0.81,61,59,96
OceanDNA-b29503,1498,5.8,0.0,0.0007,1.4,195,220,183,208,178,237,0.81,25,25,59
OceanDNA-b43426,332,13.0,0.0,2.3e-06,0.00091,143,185,94,139,41,156,0.81,42,45,115
OceanDNA-b38376,703,2.6,0.0,0.014,8.5,196,219,266,289,259,313,0.81,23,23,54
OceanDNA-b45220,1971,17.0,0.1,1.4e-07,0.00053,135,190,98,147,83,165,0.81,55,49,82
OceanDNA-b31003,385,10.1,0.1,1.7e-05,0.05,158,191,223,258,201,268,0.81,33,35,67
OceanDNA-b4498,638,23.1,0.0,5.5e-09,1.9e-06,85,186,88,198,66,215,0.81,101,110,149
OceanDNA-b3315,305,21.5,0.7,1.2e-08,2.1e-05,74,186,437,561,412,571,0.81,112,124,159
OceanDNA-b23819,1158,0.7,0.0,0.025,21.0,198,244,254,298,240,316,0.81,46,44,76
OceanDNA-b30031,2225,17.5,0.0,1.8e-07,0.00021,153,180,26,53,8,68,0.81,27,27,60
OceanDNA-b512,417,10.1,0.0,3.4e-05,0.028,161,189,94,124,83,134,0.81,28,30,51
OceanDNA-b28588,364,12.0,0.0,4.6e-06,0.0039,140,176,124,162,120,178,0.81,36,38,58
OceanDNA-b13180,128,3.7,0.0,0.0015,1.2,159,184,122,147,107,165,0.81,25,25,58
OceanDNA-b21017,1453,32.6,0.0,4.7e-12,5.7e-09,89,177,110,205,102,216,0.81,88,95,114
OceanDNA-b22842,3424,14.0,0.0,2.2e-06,0.0051,151,210,550,614,501,626,0.81,59,64,125
OceanDNA-b10034,202,28.1,0.0,5.5e-11,2.6e-08,152,230,180,259,167,275,0.81,78,79,108
OceanDNA-b19825,42,28.6,0.0,4e-11,2e-08,154,222,157,227,140,248,0.81,68,70,108
OceanDNA-b27542,1053,12.1,0.0,8.6e-06,0.0095,152,179,145,172,124,185,0.81,27,27,61
OceanDNA-b19607,22,25.5,0.0,3.4e-10,1.1e-07,153,236,138,222,131,238,0.81,83,84,107
OceanDNA-b22382,1222,11.9,0.0,9.7e-06,0.019,157,182,137,162,78,174,0.81,25,25,96
OceanDNA-b27826,351,12.9,0.0,2.4e-06,0.0011,158,183,82,107,60,131,0.81,25,25,71
OceanDNA-b31471,284,11.7,0.1,5.4e-06,0.011,149,189,112,154,100,163,0.81,40,42,63
OceanDNA-b45854,1983,-0.5,0.0,0.06,63.0,26,61,100,134,80,140,0.81,35,34,60
OceanDNA-b22074,381,13.3,0.0,1.9e-06,0.0031,39,95,12,70,5,87,0.81,56,58,82
OceanDNA-b30134,407,9.9,0.2,2e-05,0.045,149,185,116,152,88,168,0.81,36,36,80
OceanDNA-b23905,603,4.7,0.0,0.00073,1.0,157,180,146,169,138,182,0.81,23,23,44
OceanDNA-b30927,17,18.8,0.1,7.6e-08,7.9e-05,89,177,125,220,108,226,0.81,88,95,118
OceanDNA-b32834,306,17.8,0.5,1.6e-07,6.5e-05,94,191,32,124,13,136,0.81,97,92,123
OceanDNA-b16215,916,13.0,0.2,2.3e-06,0.0027,154,184,55,85,10,96,0.81,30,30,86
OceanDNA-b35892,2526,10.5,0.0,1.3e-05,0.045,140,185,275,319,242,325,0.81,45,44,83
OceanDNA-b3695,832,18.4,0.0,1e-07,9.4e-05,192,248,283,337,276,354,0.81,56,54,78
OceanDNA-b34918,94,10.7,0.0,3.3e-05,0.012,124,185,51,113,45,139,0.81,61,62,94
OceanDNA-b31981,888,6.5,0.0,0.00044,0.51,187,215,247,275,236,304,0.81,28,28,68
OceanDNA-b32084,1484,0.3,0.0,0.033,55.0,102,118,202,218,192,223,0.81,16,16,31
OceanDNA-b496,1153,12.9,0.1,4.8e-06,0.0061,149,185,85,122,77,128,0.81,36,37,51
OceanDNA-b4007,753,4.1,0.0,0.0012,1.2,161,193,117,150,51,179,0.81,32,33,128
OceanDNA-b22613,197,9.3,0.2,2.9e-05,0.1,150,185,819,854,805,873,0.81,35,35,68
OceanDNA-b22613,197,8.4,0.0,5.5e-05,0.19,144,180,273,309,264,324,0.81,36,36,60
OceanDNA-b44464,77,17.2,0.0,1.2e-07,4.3e-05,154,185,140,171,109,186,0.81,31,31,77
OceanDNA-b46309,1863,11.9,0.0,1.5e-05,0.011,151,185,209,243,194,281,0.81,34,34,87
OceanDNA-b37058,112,13.0,0.0,2.2e-06,0.0014,130,192,261,325,253,353,0.81,62,64,100
OceanDNA-a842,222,19.6,0.0,4.3e-08,7.9e-06,105,219,62,186,48,218,0.81,114,124,170
OceanDNA-b45848,879,11.7,0.0,5.6e-06,0.011,153,188,192,227,175,248,0.81,35,35,73
OceanDNA-b357,456,17.7,0.0,8.1e-08,4.4e-05,86,190,55,166,26,174,0.81,104,111,148
OceanDNA-b23817,324,4.5,0.0,0.0018,1.4,183,214,220,250,208,281,0.81,31,30,73
OceanDNA-b30427,1668,17.4,0.0,2e-07,0.00021,153,180,200,227,183,261,0.81,27,27,78
OceanDNA-b24073,156,4.5,0.0,0.00087,0.77,28,72,29,73,2,86,0.81,44,44,84
OceanDNA-b23043,1917,12.9,0.2,4.8e-06,0.0093,150,187,64,101,45,104,0.81,37,37,59
OceanDNA-b20744,16,69.7,0.1,1.2e-23,3.2e-21,53,282,78,334,71,347,0.81,229,256,276
OceanDNA-b23725,1,-2.7,0.0,0.41,290.0,195,228,252,285,249,288,0.81,33,33,39
OceanDNA-b43826,61,9.3,0.7,2.9e-05,0.047,143,184,74,118,28,133,0.81,41,44,105
OceanDNA-b2829,55,-1.3,0.0,0.051,160.0,149,172,93,116,76,137,0.81,23,23,61
OceanDNA-b37976,273,19.0,0.0,3.4e-08,6.1e-05,139,181,140,184,128,204,0.81,42,44,76
OceanDNA-b26842,552,5.8,0.0,0.00036,0.81,178,245,309,381,294,389,0.81,67,72,95
OceanDNA-b23017,1958,13.4,0.0,1.7e-06,0.0083,151,182,205,236,180,252,0.81,31,31,72
OceanDNA-b15167,1945,-2.2,0.0,0.19,190.0,198,215,247,265,238,280,0.81,17,18,42
OceanDNA-b9171,380,20.0,0.0,1.6e-08,6.7e-06,158,197,114,154,95,159,0.81,39,40,64
OceanDNA-b13256,114,36.9,0.0,5.7e-13,2.3e-10,45,226,94,276,62,296,0.81,181,182,234
OceanDNA-b13229,420,9.8,0.0,4.2e-05,0.014,196,229,226,258,216,269,0.81,33,32,53
OceanDNA-b22406,920,10.5,0.0,6.3e-05,0.037,152,186,159,194,141,234,0.81,34,35,93
OceanDNA-b10700,95,10.6,0.0,1.2e-05,0.0035,151,193,126,168,115,191,0.81,42,42,76
OceanDNA-b24040,1710,8.6,0.0,5.1e-05,0.089,175,245,60,135,54,141,0.81,70,75,87
OceanDNA-b3653,2121,15.0,0.0,2.3e-06,0.0013,153,229,301,384,283,397,0.81,76,83,114
OceanDNA-b29526,542,8.9,0.1,3.9e-05,0.11,144,178,165,199,146,219,0.81,34,34,73
OceanDNA-b16212,559,11.1,0.0,8.7e-06,0.01,157,185,160,188,128,198,0.81,28,28,70
OceanDNA-b3969,389,22.7,0.0,2.4e-09,2e-06,78,212,94,238,69,258,0.81,134,144,189
OceanDNA-b10967,76,11.6,0.0,6e-06,0.0022,151,217,148,216,134,235,0.81,66,68,101
OceanDNA-b7208,478,0.2,0.0,0.018,12.0,154,186,95,127,85,140,0.81,32,32,55
OceanDNA-b15777,593,14.0,0.0,3.3e-06,0.0019,151,217,175,244,162,291,0.81,66,69,129
OceanDNA-b7395,173,18.5,0.0,4.8e-08,1.3e-05,151,189,142,181,123,220,0.81,38,39,97
OceanDNA-b24798,1913,14.6,0.0,7.1e-07,0.0022,149,180,146,177,113,190,0.81,31,31,77
OceanDNA-b35886,286,2.0,0.0,0.005,2.0,196,217,217,238,207,271,0.81,21,21,64
OceanDNA-b22946,3695,12.0,0.0,4.4e-06,0.02,137,177,222,262,209,274,0.81,40,40,65
OceanDNA-b24172,3373,11.0,0.3,9.3e-06,0.035,68,168,93,192,87,207,0.81,100,99,120
OceanDNA-b34760,599,-0.0,0.0,0.02,12.0,153,180,182,209,165,219,0.81,27,27,54
OceanDNA-b33315,39,32.7,0.0,2.3e-12,9.6e-09,98,211,127,250,70,300,0.81,113,123,230
OceanDNA-b44384,279,-3.7,0.0,0.28,280.0,157,180,216,239,209,249,0.81,23,23,40
OceanDNA-b41030,2010,11.6,0.1,1.8e-05,0.015,133,178,61,105,37,120,0.81,45,44,83
OceanDNA-b20923,2810,21.4,0.0,1.8e-08,3.7e-05,146,202,1217,1276,1197,1279,0.81,56,59,82
OceanDNA-b30115,454,5.8,0.0,0.00035,0.91,152,185,122,155,106,181,0.81,33,33,75
OceanDNA-b37747,985,17.9,0.0,7.1e-08,7.1e-05,141,184,135,181,128,204,0.81,43,46,76
OceanDNA-b21019,707,11.9,0.2,1e-05,0.015,53,111,126,185,78,198,0.81,58,59,120
OceanDNA-b36726,158,19.9,0.0,1.7e-08,1.4e-05,139,190,129,182,120,198,0.81,51,53,78
OceanDNA-b20963,4201,16.9,0.3,2.8e-07,0.00094,75,179,223,337,220,355,0.81,104,114,135
OceanDNA-b36948,1090,2.8,0.0,0.0029,3.4,88,121,136,169,127,179,0.81,33,33,52
OceanDNA-b4489,579,11.6,0.0,6e-06,0.0038,156,185,63,92,45,100,0.81,29,29,55
OceanDNA-b32143,845,15.9,0.0,3e-07,0.00062,155,187,213,245,198,293,0.81,32,32,95
OceanDNA-b23143,876,27.9,0.0,1.3e-10,1.8e-07,145,244,231,326,207,334,0.81,99,95,127
OceanDNA-b40617,14,15.4,0.0,8.3e-07,0.00017,153,182,146,175,125,199,0.81,29,29,74
OceanDNA-b46702,865,21.4,0.0,1.2e-08,1.1e-05,154,243,235,326,228,333,0.81,89,91,105
OceanDNA-b22827,3848,13.7,0.0,2.7e-06,0.0067,154,184,152,182,138,226,0.81,30,30,88
OceanDNA-b22324,3930,24.9,0.0,1.1e-09,2.2e-06,58,211,71,237,42,257,0.81,153,166,215
OceanDNA-b35141,781,12.4,0.0,3.5e-06,0.0039,140,185,141,187,132,199,0.81,45,46,67
OceanDNA-b17033,808,19.7,0.0,4.2e-08,3.3e-05,93,172,99,184,84,191,0.81,79,85,107
OceanDNA-b30852,157,11.4,0.0,1.3e-05,0.013,145,185,103,142,86,164,0.81,40,39,78
OceanDNA-b41011,471,10.2,0.1,3.3e-05,0.04,89,185,58,152,53,167,0.8,96,94,114
OceanDNA-b20340,342,12.0,0.0,4.5e-06,0.0019,141,174,154,187,137,207,0.8,33,33,70
OceanDNA-b4134,377,12.9,0.0,4.7e-06,0.002,152,185,79,112,64,194,0.8,33,33,130
OceanDNA-b10059,343,12.1,0.0,4.2e-06,0.002,198,269,121,194,98,195,0.8,71,73,97
OceanDNA-b15480,240,12.4,0.1,6.8e-06,0.0018,195,243,206,252,141,276,0.8,48,46,135
OceanDNA-b30681,143,1.8,0.1,0.0056,3.7,192,264,185,255,159,292,0.8,72,70,133
OceanDNA-b20944,992,10.9,0.0,9.8e-06,0.017,148,184,91,127,76,148,0.8,36,36,72
OceanDNA-b28166,2674,13.6,0.1,1.4e-06,0.0039,166,234,229,299,209,323,0.8,68,70,114
OceanDNA-b20976,3532,3.2,0.0,0.0021,13.0,198,236,240,277,230,290,0.8,38,37,60
OceanDNA-b19679,279,16.3,0.0,2.1e-07,7.3e-05,155,234,138,218,128,244,0.8,79,80,116
OceanDNA-b22353,82,15.1,0.0,1e-06,0.00057,153,189,158,195,146,230,0.8,36,37,84
OceanDNA-b35886,286,7.2,0.0,0.00013,0.054,157,188,101,132,88,147,0.8,31,31,59
OceanDNA-b20922,2978,4.4,0.0,0.0019,6.6,222,267,215,259,187,262,0.8,45,44,75
OceanDNA-b34384,466,10.6,0.0,4.9e-05,0.01,159,181,145,167,121,178,0.8,22,22,57
OceanDNA-b17034,755,10.8,0.1,2.1e-05,0.0096,151,176,189,214,173,236,0.8,25,25,63
OceanDNA-b34266,1658,10.1,0.2,1.8e-05,0.047,157,183,93,119,70,126,0.8,26,26,56
OceanDNA-b31464,1668,-2.8,0.0,0.14,280.0,39,51,309,321,297,329,0.8,12,12,32
OceanDNA-b22917,2318,-1.7,0.0,0.28,200.0,178,193,272,287,232,291,0.8,15,15,59
OceanDNA-b37047,313,0.5,0.0,0.014,10.0,106,121,105,120,81,132,0.8,15,15,51
OceanDNA-b28238,1788,12.7,0.1,5.6e-06,0.0065,89,175,165,258,161,277,0.8,86,93,116
OceanDNA-b20962,1837,15.7,0.8,6.8e-07,0.0018,92,180,399,494,373,499,0.8,88,95,126
OceanDNA-b41581,30,7.6,0.0,9.9e-05,0.058,200,244,238,283,230,291,0.8,44,45,61
OceanDNA-b23015,1474,11.9,0.0,5e-06,0.032,138,184,173,220,160,225,0.8,46,47,65
OceanDNA-b1719,2754,6.9,0.0,0.00031,0.47,192,231,229,267,221,287,0.8,39,38,66
OceanDNA-b20922,2978,6.1,0.0,0.00055,1.9,161,193,110,146,84,171,0.8,32,36,87
OceanDNA-b20897,2001,10.3,0.0,1.5e-05,0.04,197,257,253,310,237,321,0.8,60,57,84
OceanDNA-b265,134,35.3,0.0,7.5e-13,6.6e-10,149,244,149,247,123,253,0.8,95,98,130
OceanDNA-b44390,296,17.4,0.0,3.1e-07,7.1e-05,59,196,10,154,7,158,0.8,137,144,151
OceanDNA-b36617,613,15.7,0.0,6.8e-07,0.00034,134,181,135,180,123,192,0.8,47,45,69
OceanDNA-b37855,698,12.9,0.0,2.5e-06,0.0018,195,262,326,393,320,396,0.8,67,67,76
OceanDNA-b23551,393,8.4,0.0,0.00011,0.085,156,190,53,86,28,99,0.8,34,33,71
OceanDNA-b1776,514,12.5,0.1,6.4e-06,0.012,129,183,235,289,198,294,0.8,54,54,96
OceanDNA-b20491,67,10.3,0.0,3e-05,0.005,145,192,233,280,205,324,0.8,47,47,119
OceanDNA-b21179,205,13.4,0.0,1.7e-06,0.00082,151,249,129,228,73,254,0.8,98,99,181
OceanDNA-b3023,43,11.8,0.0,5.4e-06,0.0015,156,204,97,146,27,176,0.8,48,49,149
OceanDNA-b23020,260,12.6,0.1,2.9e-06,0.01,152,184,855,887,843,917,0.8,32,32,74
OceanDNA-b16121,452,-2.8,0.0,0.15,120.0,253,277,509,533,507,543,0.8,24,24,36
OceanDNA-b10080,169,-0.3,0.0,0.051,25.0,195,215,205,225,196,253,0.8,20,20,57
OceanDNA-b4763,414,-1.0,0.0,0.041,20.0,199,217,38,57,29,63,0.8,18,19,34
OceanDNA-b22650,1574,1.4,0.0,0.015,18.0,148,175,76,103,45,114,0.8,27,27,69
OceanDNA-b27523,751,-1.1,0.0,0.091,60.0,195,215,293,313,272,326,0.8,20,20,54
OceanDNA-b23819,1158,11.9,0.0,9.5e-06,0.0082,146,188,117,158,98,210,0.8,42,41,112
OceanDNA-b23176,6781,20.1,0.0,4.8e-08,0.00012,58,211,77,244,48,256,0.8,153,167,208
OceanDNA-b22348,286,40.4,0.0,1e-14,1.1e-11,152,256,149,259,137,266,0.8,104,110,129
OceanDNA-b22800,299,9.2,0.0,3.3e-05,0.055,159,184,193,218,180,229,0.8,25,25,49
OceanDNA-a1335,150,2.2,0.0,0.0045,0.71,192,244,221,275,200,285,0.8,52,54,85
OceanDNA-b37433,682,-1.4,0.0,0.054,65.0,142,164,195,217,169,227,0.8,22,22,58
OceanDNA-b29381,649,20.3,0.0,1.4e-08,1.3e-05,91,179,103,198,99,208,0.8,88,95,109
OceanDNA-b22394,92,30.1,0.0,2.7e-11,2.7e-08,153,244,210,303,196,309,0.8,91,93,113
OceanDNA-b33290,1244,12.6,0.1,2.9e-06,0.0082,155,181,18,44,9,66,0.8,26,26,57
OceanDNA-b27598,443,13.9,0.0,2.4e-06,0.0025,166,231,258,325,228,338,0.8,65,67,110
OceanDNA-b40249,8,23.0,0.0,2e-09,1.4e-06,140,185,135,182,127,206,0.8,45,47,79
OceanDNA-b23522,1260,15.0,0.0,5.4e-07,0.00074,159,207,159,207,137,212,0.8,48,48,75
OceanDNA-b2796,1858,13.7,0.0,2.8e-06,0.0028,158,187,214,243,187,271,0.8,29,29,84
OceanDNA-b26928,2381,10.0,0.4,1.8e-05,0.061,155,187,95,127,80,136,0.8,32,32,56
OceanDNA-b4498,474,13.4,0.0,5.2e-06,0.0017,156,188,140,173,129,182,0.8,32,33,53
OceanDNA-b3635,774,23.6,0.0,2.7e-09,3.5e-06,153,216,158,226,147,252,0.8,63,68,105
OceanDNA-b28141,234,12.5,0.0,6.5e-06,0.0054,190,231,244,285,214,305,0.8,41,41,91
OceanDNA-b15137,529,0.3,0.0,0.05,35.0,195,228,184,215,173,242,0.8,33,31,69
OceanDNA-b42307,214,16.4,0.1,2.1e-07,4.8e-05,81,176,61,160,52,184,0.8,95,99,132
OceanDNA-b4102,811,2.4,0.0,0.0039,3.8,131,187,107,164,97,171,0.8,56,57,74
OceanDNA-b32883,871,22.5,0.0,2.8e-09,4.7e-06,141,182,133,176,129,195,0.8,41,43,66
OceanDNA-b22632,979,13.3,0.1,1.8e-06,0.006,142,190,179,230,169,233,0.8,48,51,64
OceanDNA-b22890,202,11.8,0.0,1.6e-05,0.011,147,177,180,211,141,222,0.8,30,31,81
OceanDNA-b6259,3,19.8,0.0,1.9e-08,2.5e-05,87,187,148,251,142,256,0.8,100,103,114
OceanDNA-b13575,549,20.0,0.0,1.7e-08,1.8e-05,91,191,22,120,12,134,0.8,100,98,122
OceanDNA-b28564,1477,5.1,0.1,0.00058,1.6,152,188,121,158,112,171,0.8,36,37,59
OceanDNA-b3920,492,-3.4,0.0,0.45,430.0,24,40,243,259,234,263,0.8,16,16,29
OceanDNA-b3920,1177,16.3,0.0,4.6e-07,0.00044,93,187,123,226,82,285,0.8,94,103,203
OceanDNA-b22890,202,0.1,0.0,0.058,40.0,195,243,257,308,246,315,0.8,48,51,69
OceanDNA-b11306,47,18.6,0.0,4.4e-08,1.2e-05,152,224,146,219,129,239,0.8,72,73,110
OceanDNA-b34793,517,14.9,0.0,5.9e-07,0.00048,140,185,132,178,124,188,0.8,45,46,64
OceanDNA-b20157,86,15.8,0.0,3.2e-07,0.00012,152,232,128,209,107,224,0.8,80,81,117
OceanDNA-b22314,123,11.2,0.0,7.9e-06,0.037,156,182,110,136,93,150,0.8,26,26,57
OceanDNA-b9654,484,10.2,0.1,3.1e-05,0.0088,175,225,202,252,196,287,0.8,50,50,91
OceanDNA-b27549,938,16.0,0.0,5.6e-07,0.0006,153,183,340,370,323,379,0.8,30,30,56
OceanDNA-b17318,2277,12.4,0.0,6.7e-06,0.0081,105,211,133,249,104,271,0.8,106,116,167
OceanDNA-b40265,779,36.1,0.0,4.2e-13,2e-10,153,243,165,262,153,282,0.8,90,97,129
OceanDNA-b46557,237,13.7,0.0,1.3e-06,0.00064,153,191,143,184,132,199,0.8,38,41,67
OceanDNA-b8217,164,10.0,0.0,1.9e-05,0.0046,149,185,121,157,101,167,0.8,36,36,66
OceanDNA-b22840,3847,-2.4,0.0,0.34,470.0,105,122,175,192,165,194,0.8,17,17,29
OceanDNA-b38575,589,17.7,0.0,8.3e-08,5.6e-05,77,190,27,144,21,154,0.8,113,117,133
OceanDNA-b16227,919,15.3,0.0,1.3e-06,0.00046,88,187,52,162,37,180,0.8,99,110,143
OceanDNA-b31526,1023,11.6,0.0,1.8e-05,0.0063,197,264,51,120,25,121,0.8,67,69,96
OceanDNA-b16227,638,20.1,0.0,4.7e-08,1.6e-05,136,186,139,183,105,228,0.8,50,44,123
OceanDNA-b6211,233,14.5,0.0,8.1e-07,0.0003,135,185,108,155,97,168,0.8,50,47,71
OceanDNA-b36139,1255,17.4,0.0,2.1e-07,0.00021,150,184,346,382,332,387,0.8,34,36,55
OceanDNA-b24117,2173,1.1,0.0,0.019,25.0,159,180,89,110,80,122,0.8,21,21,42
OceanDNA-b23396,1251,-1.0,0.0,0.083,85.0,197,222,269,294,234,299,0.8,25,25,65
OceanDNA-b22127,244,35.5,1.3,3.2e-13,5.4e-10,53,173,247,375,243,382,0.8,120,128,139
OceanDNA-b3684,19,7.6,0.0,9.8e-05,0.12,175,228,196,249,191,267,0.8,53,53,76
OceanDNA-b4249,812,9.2,0.0,3.2e-05,0.045,194,265,200,269,192,274,0.8,71,69,82
OceanDNA-b24591,1677,13.3,0.0,3.7e-06,0.0051,153,182,148,177,125,197,0.8,29,29,72
OceanDNA-b18400,31,11.6,0.0,6.1e-06,0.0024,160,207,97,144,48,151,0.8,47,47,103
OceanDNA-b282,312,23.0,0.0,4.1e-09,2.9e-06,165,245,1,83,1,89,0.8,80,82,88
OceanDNA-b23907,61,10.3,0.0,2.9e-05,0.029,197,249,612,664,605,681,0.8,52,52,76
OceanDNA-b37447,293,8.1,0.1,7e-05,0.051,148,197,127,176,116,236,0.8,49,49,120
OceanDNA-b34859,125,13.5,0.0,3.2e-06,0.0012,145,191,122,169,114,191,0.8,46,47,77
OceanDNA-b30,3126,12.0,0.3,9.3e-06,0.017,141,173,47,82,33,98,0.8,32,35,65
OceanDNA-b19147,356,11.1,0.0,1.7e-05,0.003,182,216,268,302,255,337,0.8,34,34,82
OceanDNA-b35076,458,14.7,0.0,6.9e-07,0.00051,140,181,127,169,121,205,0.8,41,42,84
OceanDNA-b50,2159,0.3,0.0,0.017,43.0,98,122,164,188,130,193,0.8,24,24,63
OceanDNA-b41227,1263,10.3,0.2,1.5e-05,0.024,152,191,133,173,119,240,0.8,39,40,121
OceanDNA-b2592,854,11.3,0.1,1.5e-05,0.019,134,190,164,217,154,229,0.8,56,53,75
OceanDNA-b16224,1390,1.8,0.0,0.0056,8.7,195,223,433,462,415,481,0.8,28,29,66
OceanDNA-b30,835,2.3,0.0,0.0083,15.0,195,225,311,340,305,364,0.8,30,29,59
OceanDNA-b22997,745,9.9,0.0,5.8e-05,0.02,148,182,141,176,129,185,0.8,34,35,56
OceanDNA-b41808,115,13.9,0.0,1.2e-06,0.00027,151,190,107,146,75,180,0.8,39,39,105
OceanDNA-b47056,481,6.6,0.0,0.0002,0.11,152,201,90,139,77,152,0.8,49,49,75
OceanDNA-b44719,526,11.0,0.0,9e-06,0.0054,89,188,44,141,33,162,0.8,99,97,129
OceanDNA-b8783,80,-2.6,0.0,0.13,23.0,79,104,22,47,19,54,0.8,25,25,35
OceanDNA-b23850,7,5.2,0.0,0.0016,0.8,161,185,117,141,97,164,0.8,24,24,67
OceanDNA-b26781,497,7.1,0.1,0.00029,0.25,154,186,160,192,148,201,0.8,32,32,53
OceanDNA-b40641,953,144.8,0.2,1.6e-46,2.1e-43,56,285,103,347,44,354,0.8,229,244,310
OceanDNA-b32609,844,16.9,0.1,1.4e-07,0.00016,56,186,21,160,5,178,0.8,130,139,173
OceanDNA-b41358,206,7.0,0.0,0.0006,0.18,188,218,320,350,310,390,0.8,30,30,80
OceanDNA-b37412,308,12.9,0.1,4.8e-06,0.0016,146,180,121,155,96,171,0.8,34,34,75
OceanDNA-b46695,368,19.0,0.0,1.7e-07,7.2e-05,155,240,145,232,135,245,0.8,85,87,110
OceanDNA-b22858,2614,-1.5,0.0,0.058,200.0,103,122,173,192,163,195,0.8,19,19,32
OceanDNA-b9644,567,13.6,0.0,1.4e-06,0.0011,152,191,595,635,543,646,0.8,39,40,103
OceanDNA-b19120,158,20.4,0.0,2.6e-08,4.2e-06,151,218,116,185,83,232,0.8,67,69,149
OceanDNA-b7699,41,20.6,0.0,1.1e-08,3.5e-06,151,215,136,203,117,223,0.8,64,67,106
OceanDNA-b26770,298,27.1,0.1,1.2e-10,1.7e-07,81,172,569,671,566,682,0.8,91,102,116
OceanDNA-b44384,279,18.8,0.0,3.7e-08,3.7e-05,187,262,327,402,277,406,0.8,75,75,129
OceanDNA-b23942,1984,10.8,0.0,1e-05,0.022,157,183,128,154,115,164,0.8,26,26,49
OceanDNA-b31716,2338,15.6,0.1,3.5e-07,0.00086,155,181,171,197,70,215,0.8,26,26,145
OceanDNA-b20967,119,20.5,0.0,1.2e-08,1.8e-05,183,247,286,352,269,362,0.8,64,66,93
OceanDNA-b20995,1937,14.0,0.1,1.1e-06,0.0056,151,209,387,448,360,493,0.8,58,61,133
OceanDNA-b35156,466,16.1,0.0,2.6e-07,0.00046,140,178,127,166,117,184,0.8,38,39,67
OceanDNA-b6501,215,-1.1,0.0,0.091,23.0,151,189,529,567,515,574,0.8,38,38,59
OceanDNA-b37859,480,-0.8,0.0,0.036,35.0,153,189,625,661,612,673,0.8,36,36,61
OceanDNA-b45647,130,3.7,0.1,0.0015,0.95,156,187,96,127,19,140,0.8,31,31,121
OceanDNA-b36934,678,29.8,0.1,1.8e-11,1.8e-08,85,171,191,288,170,300,0.8,86,97,130
OceanDNA-b12280,47,31.3,0.0,6e-12,2.3e-09,159,240,146,231,122,247,0.8,81,85,125
OceanDNA-b45233,1211,-4.0,0.0,0.69,500.0,198,214,301,317,298,321,0.8,16,16,23
OceanDNA-b46222,1352,11.5,0.0,1.3e-05,0.011,160,197,126,163,111,168,0.8,37,37,57
OceanDNA-b46222,883,10.8,0.0,2e-05,0.016,141,187,214,261,196,301,0.8,46,47,105
OceanDNA-b37895,345,14.0,0.0,1.1e-06,0.00087,156,196,89,130,54,138,0.8,40,41,84
OceanDNA-b13570,912,15.0,0.0,1.1e-06,0.00074,95,185,138,230,127,235,0.8,90,92,108
OceanDNA-b23139,2350,11.2,0.4,1.6e-05,0.019,136,172,152,182,91,199,0.8,36,30,108
OceanDNA-b16265,572,8.7,0.0,4.5e-05,0.055,196,247,298,348,291,359,0.8,51,50,68
OceanDNA-b22407,1618,15.1,0.0,5e-07,0.0015,133,186,406,459,375,478,0.8,53,53,103
OceanDNA-b31987,1725,11.5,0.0,6.5e-06,0.014,154,223,348,426,287,450,0.8,69,78,163
OceanDNA-b30086,99,16.2,0.0,2.4e-07,0.00053,152,179,133,160,117,174,0.8,27,27,57
OceanDNA-b32166,2396,0.6,0.0,0.014,38.0,196,220,376,400,369,417,0.8,24,24,48
OceanDNA-b24719,1459,12.3,0.3,3.8e-06,0.0058,40,108,148,219,104,234,0.8,68,71,130
OceanDNA-b496,923,5.6,0.0,0.00083,1.1,193,225,231,262,224,280,0.8,32,31,56
OceanDNA-b37977,501,14.1,0.0,1e-06,0.00087,139,196,126,182,113,186,0.8,57,56,73
OceanDNA-b517,1813,16.2,0.1,2.4e-07,0.00095,153,189,227,264,211,267,0.8,36,37,56
OceanDNA-b34923,521,13.8,0.0,1.3e-06,0.00097,197,249,220,272,204,289,0.8,52,52,85
OceanDNA-b16117,600,4.0,0.0,0.0025,0.96,188,216,218,246,208,273,0.8,28,28,65
OceanDNA-b30085,1277,14.8,0.0,1.9e-06,0.0014,153,179,161,187,143,203,0.8,26,26,60
OceanDNA-b4005,959,2.5,0.0,0.0073,4.1,185,241,143,201,116,217,0.8,56,58,101
OceanDNA-b3385,1277,1.0,0.0,0.021,36.0,197,217,326,346,317,365,0.8,20,20,48
OceanDNA-a2154,360,12.0,0.0,4.5e-06,0.0019,147,182,111,149,75,160,0.8,35,38,85
OceanDNA-b23088,3754,13.9,0.0,1.2e-06,0.0048,107,193,176,268,168,277,0.8,86,92,109
OceanDNA-b13590,1708,13.1,0.0,8.5e-06,0.0062,127,183,135,192,117,198,0.8,56,57,81
OceanDNA-b28261,86,-1.8,0.0,0.073,21.0,158,183,56,81,51,96,0.8,25,25,45
OceanDNA-b25128,258,8.8,0.0,8.3e-05,0.036,152,187,110,146,94,155,0.8,35,36,61
OceanDNA-b34276,685,10.5,0.0,1.3e-05,0.014,139,182,127,171,116,202,0.8,43,44,86
OceanDNA-b23005,190,42.4,0.1,2.5e-15,8.3e-12,47,243,195,410,190,415,0.8,196,215,225
OceanDNA-b31989,707,8.0,0.0,7.4e-05,0.18,194,261,208,271,199,273,0.8,67,63,74
OceanDNA-b34263,107,-0.8,0.0,0.07,22.0,197,219,595,616,591,641,0.8,22,21,50
OceanDNA-b31056,2923,15.1,0.5,5.2e-07,0.0016,54,187,111,255,98,268,0.8,133,144,170
OceanDNA-b35825,979,17.6,0.0,9.1e-08,9e-05,88,196,31,142,14,170,0.8,108,111,156
OceanDNA-b46252,2090,11.8,0.0,2.1e-05,0.012,149,185,174,210,152,224,0.8,36,36,72
OceanDNA-b42513,128,7.7,0.0,9.4e-05,0.024,152,180,126,154,106,164,0.8,28,28,58
OceanDNA-b32047,1611,16.8,0.0,4.6e-07,0.00054,104,192,544,642,519,701,0.8,88,98,182
OceanDNA-b32139,904,1.1,0.0,0.0092,22.0,198,220,249,272,244,279,0.8,22,23,35
OceanDNA-b40442,1416,16.9,0.0,2.8e-07,0.00027,140,181,128,170,121,189,0.8,41,42,68
OceanDNA-b4494,996,20.8,0.0,1.9e-08,1.1e-05,105,193,147,242,135,251,0.8,88,95,116
OceanDNA-b26825,261,11.9,0.0,4.8e-06,0.0049,197,270,201,272,191,281,0.8,73,71,90
OceanDNA-b6756,268,14.7,0.0,6.9e-07,0.00037,158,196,147,186,124,212,0.8,38,39,88
OceanDNA-b4290,7,10.6,0.1,1.2e-05,0.003,198,256,116,174,104,186,0.8,58,58,82
OceanDNA-b15230,311,12.1,0.0,4.3e-06,0.002,157,187,96,126,25,132,0.8,30,30,107
OceanDNA-b37709,491,17.2,0.0,1.2e-07,6.2e-05,151,180,148,177,128,178,0.8,29,29,50
OceanDNA-b46697,119,14.8,0.0,1.3e-06,0.0013,155,197,146,189,134,244,0.8,42,43,110
OceanDNA-b20668,73,0.5,0.0,0.029,3.9,80,122,125,167,89,185,0.8,42,42,96
OceanDNA-b17621,378,26.8,0.0,1.4e-10,1.6e-07,150,215,180,251,158,261,0.8,65,71,103
OceanDNA-b40607,496,133.1,0.0,6e-43,3.6e-40,63,277,115,345,53,357,0.8,214,230,304
OceanDNA-b37665,933,-4.0,0.0,0.33,510.0,109,122,89,102,82,111,0.8,13,13,29
OceanDNA-b24146,108,2.8,0.1,0.0028,6.1,155,175,149,169,121,184,0.8,20,20,63
OceanDNA-b22554,190,12.3,0.0,7.6e-06,0.0045,153,181,137,165,114,218,0.8,28,28,104
OceanDNA-b9761,970,17.3,0.0,1.1e-07,0.00011,75,211,94,241,60,250,0.8,136,147,190
OceanDNA-b23552,218,8.1,0.0,6.9e-05,0.14,156,190,124,157,101,170,0.8,34,33,69
OceanDNA-b32709,628,-1.3,0.0,0.1,85.0,197,225,323,350,317,374,0.8,28,27,57
OceanDNA-b19130,5,6.9,0.0,0.00033,0.074,86,122,206,242,197,263,0.8,36,36,66
OceanDNA-b3956,990,6.8,0.0,0.00018,0.19,199,267,193,259,185,265,0.8,68,66,80
OceanDNA-b26756,121,17.9,0.0,7.4e-08,0.0001,153,181,138,166,114,182,0.8,28,28,68
OceanDNA-b22093,3173,13.6,0.0,1.4e-06,0.0051,152,222,498,569,479,608,0.8,70,71,129
OceanDNA-b36663,634,19.2,0.0,2.8e-08,3.6e-05,140,186,136,183,129,202,0.8,46,47,73
OceanDNA-b41030,800,46.0,0.1,5.9e-16,5e-13,102,269,98,265,7,280,0.8,167,167,273
OceanDNA-b28146,1182,4.5,0.1,0.00086,1.6,202,266,176,238,166,240,0.8,64,62,74
OceanDNA-b20986,2603,18.2,0.0,5.7e-08,0.00018,89,172,162,256,132,264,0.8,83,94,132
OceanDNA-b23918,1793,14.5,0.0,7.6e-07,0.0015,155,185,118,148,82,156,0.8,30,30,74
OceanDNA-b13585,163,12.7,0.0,1.1e-05,0.0042,137,206,153,226,133,232,0.8,69,73,99
OceanDNA-b23169,959,24.5,0.0,1.4e-09,1.6e-06,145,245,207,303,188,315,0.8,100,96,127
OceanDNA-b22654,724,19.1,0.0,1.5e-07,3.7e-05,153,215,62,126,37,141,0.8,62,64,104
OceanDNA-b22566,1178,19.1,0.0,6.1e-08,3.7e-05,154,198,152,197,142,253,0.8,44,45,111
OceanDNA-b23003,2097,27.3,0.5,3.9e-10,2.4e-07,71,174,326,435,308,442,0.8,103,109,134
OceanDNA-b46309,179,1.3,1.8,0.024,18.0,149,180,114,144,106,149,0.8,31,30,43
OceanDNA-b37356,779,7.0,0.0,0.00015,0.27,154,187,161,194,144,212,0.8,33,33,68
OceanDNA-b22610,773,4.4,0.0,0.00093,0.91,198,264,206,274,201,275,0.8,66,68,74
OceanDNA-b23082,299,18.7,0.1,4.3e-08,4.8e-05,84,245,75,249,12,255,0.8,161,174,243
OceanDNA-b32720,290,10.7,0.0,1.2e-05,0.036,156,189,77,111,58,124,0.8,33,34,66
OceanDNA-b45686,408,22.7,0.0,2.6e-09,1.4e-06,148,189,157,199,140,254,0.8,41,42,114
OceanDNA-b33308,1563,85.2,3.1,4.6e-28,7.5e-25,22,106,64,146,41,146,0.8,84,82,105
OceanDNA-b22755,517,11.5,0.0,6.4e-06,0.0055,152,185,558,591,519,660,0.8,33,33,141
OceanDNA-b34924,841,17.9,0.0,1.4e-07,7e-05,140,185,156,202,150,224,0.8,45,46,74
OceanDNA-b29506,1769,18.2,0.5,5.8e-08,0.00019,94,179,102,191,89,198,0.8,85,89,109
OceanDNA-b27563,76,11.4,0.0,6.7e-06,0.011,193,250,166,219,145,228,0.8,57,53,83
OceanDNA-b40250,557,34.0,0.0,1.8e-12,6.6e-10,86,171,146,242,139,246,0.8,85,96,107
OceanDNA-b31948,631,11.4,0.1,1.4e-05,0.016,131,174,287,330,254,343,0.8,43,43,89
OceanDNA-b33194,434,5.4,0.0,0.00047,0.48,152,178,201,227,186,247,0.8,26,26,61
OceanDNA-b3700,1479,21.8,0.1,4.8e-09,1.2e-05,104,187,226,312,204,335,0.8,83,86,131
OceanDNA-b17582,63,-3.5,0.0,0.24,770.0,88,99,86,97,81,98,0.8,11,11,17
OceanDNA-b40631,559,31.6,0.0,4.8e-12,2.7e-09,85,171,135,232,127,236,0.8,86,97,109
OceanDNA-b36402,186,-1.2,0.0,0.046,32.0,167,182,19,34,14,50,0.8,15,15,36
OceanDNA-b37225,637,12.4,0.0,3.3e-06,0.0044,153,192,577,620,567,631,0.8,39,43,64
OceanDNA-b310,562,16.9,0.1,2.9e-07,0.00021,152,186,142,176,122,209,0.8,34,34,87
OceanDNA-b23976,1658,13.1,0.1,2.1e-06,0.0038,105,187,63,144,51,163,0.8,82,81,112
OceanDNA-b23725,1,12.2,0.1,1.2e-05,0.0087,160,189,132,162,113,171,0.8,29,30,58
OceanDNA-b23832,1041,16.6,0.0,3.7e-07,0.00032,159,185,148,174,125,193,0.8,26,26,68
OceanDNA-b26823,1130,9.1,0.0,3.3e-05,0.12,178,249,264,340,252,356,0.8,71,76,104
OceanDNA-b20977,1358,24.6,0.0,2e-09,2.5e-06,74,184,188,302,166,308,0.8,110,114,142
OceanDNA-b34924,232,2.1,0.1,0.0092,4.6,249,280,378,409,356,420,0.8,31,31,64
OceanDNA-b20629,17,4.1,0.0,0.0011,0.21,92,121,140,169,129,185,0.8,29,29,56
OceanDNA-b22461,4000,-1.9,0.0,0.24,370.0,202,220,326,343,320,363,0.8,18,17,43
OceanDNA-b22985,494,12.6,0.0,6.1e-06,0.01,157,185,138,166,107,170,0.79,28,28,63
OceanDNA-b27579,40,8.1,0.1,0.00014,0.21,195,243,239,284,208,298,0.79,48,45,90
OceanDNA-b15465,164,14.8,0.0,1.3e-06,0.00068,196,243,204,249,193,252,0.79,47,45,59
OceanDNA-b114,76,18.7,1.3,4.1e-08,1.9e-05,67,187,261,392,242,398,0.79,120,131,156
OceanDNA-b9187,286,15.5,0.0,3.9e-07,0.00013,153,188,141,179,131,189,0.79,35,38,58
OceanDNA-b17035,8,11.5,0.0,1.3e-05,0.0062,148,185,139,176,115,223,0.79,37,37,108
OceanDNA-b6163,418,12.0,0.0,4.6e-06,0.0027,150,187,105,141,64,157,0.79,37,36,93
OceanDNA-b23064,375,46.7,0.0,1.2e-16,1.7e-13,85,244,96,267,65,275,0.79,159,171,210
OceanDNA-b44627,133,-2.8,0.0,0.29,130.0,107,122,77,92,60,102,0.79,15,15,42
OceanDNA-b46921,995,18.7,0.0,1.3e-07,0.0001,153,217,153,219,121,243,0.79,64,66,122
OceanDNA-b6844,273,15.9,0.0,2.9e-07,0.00029,142,185,125,168,110,189,0.79,43,43,79
OceanDNA-b46921,2201,27.4,0.0,2.8e-10,2.2e-07,120,223,156,260,147,282,0.79,103,104,135
OceanDNA-b3647,588,13.8,0.0,1.2e-06,0.0011,101,211,109,229,76,273,0.79,110,120,197
OceanDNA-b44721,159,10.5,0.0,1.3e-05,0.0065,140,179,123,164,114,180,0.79,39,41,66
OceanDNA-b22391,1632,29.1,0.1,5.4e-11,5.1e-08,153,213,174,238,161,248,0.79,60,64,87
OceanDNA-b3641,425,14.3,0.0,9.2e-07,0.00046,154,188,166,200,145,255,0.79,34,34,110
OceanDNA-b35069,865,13.4,0.0,3.3e-06,0.0015,143,183,65,105,39,124,0.79,40,40,85
OceanDNA-b22528,305,12.1,0.0,4.1e-06,0.0034,149,178,56,86,38,96,0.79,29,30,58
OceanDNA-b24005,575,0.9,0.0,0.011,19.0,140,189,492,541,487,556,0.79,49,49,69
OceanDNA-b18171,65,21.2,0.0,7.2e-09,1.2e-06,143,209,111,181,96,192,0.79,66,70,96
OceanDNA-b19681,171,19.0,0.0,3.3e-08,1.2e-05,152,237,142,228,104,248,0.79,85,86,144
OceanDNA-b19612,371,14.9,0.0,1.2e-06,0.00036,151,188,116,154,107,211,0.79,37,38,104
OceanDNA-b46830,927,25.0,0.0,5e-10,1.1e-06,133,218,53,142,13,150,0.79,85,89,137
OceanDNA-b3982,297,11.7,0.0,1.7e-05,0.0033,199,265,190,254,178,272,0.79,66,64,94
OceanDNA-b43907,104,6.7,1.2,0.00038,0.066,142,172,164,194,75,201,0.79,30,30,126
OceanDNA-b10747,219,10.4,0.0,1.4e-05,0.0083,150,188,166,205,150,261,0.79,38,39,111
OceanDNA-b35035,642,10.8,0.0,1e-05,0.0082,144,182,66,104,41,124,0.79,38,38,83
OceanDNA-b36891,1423,16.6,0.0,1.8e-07,0.00034,154,175,44,65,28,90,0.79,21,21,62
OceanDNA-b30493,1068,14.7,0.1,6.8e-07,0.001,167,228,240,303,231,330,0.79,61,63,99
OceanDNA-b27598,1848,10.9,0.0,1.9e-05,0.019,50,107,18,72,3,93,0.79,57,54,90
OceanDNA-b12722,62,-3.6,0.0,0.25,58.0,161,172,129,140,113,148,0.79,11,11,35
OceanDNA-b36897,631,11.6,0.0,6.1e-06,0.0075,155,180,140,165,124,183,0.79,25,25,59
OceanDNA-b29498,644,12.8,0.0,2.5e-06,0.0055,153,179,162,188,143,203,0.79,26,26,60
OceanDNA-b29285,62,1.5,0.0,0.0073,12.0,151,180,53,84,42,96,0.79,29,31,54
OceanDNA-b19821,211,29.4,0.0,2.2e-11,8e-09,147,226,97,177,82,199,0.79,79,80,117
OceanDNA-b3598,254,2.1,0.0,0.0046,1.9,174,217,198,240,177,254,0.79,43,42,77
OceanDNA-b38880,867,14.7,0.0,1.4e-06,0.00065,138,187,84,136,66,144,0.79,49,52,78
OceanDNA-b20565,177,60.6,0.1,7.3e-21,2e-18,53,282,55,311,45,322,0.79,229,256,277
OceanDNA-b3623,565,10.8,0.0,1e-05,0.0074,139,180,121,163,87,169,0.79,41,42,82
OceanDNA-b32763,549,-3.8,0.0,0.3,470.0,202,217,242,257,239,266,0.79,15,15,27
OceanDNA-b19701,130,14.6,0.0,2.2e-06,0.00029,120,199,101,180,77,189,0.79,79,79,112
OceanDNA-b41451,1253,15.1,0.1,1e-06,0.00075,138,185,71,118,32,132,0.79,47,47,100
OceanDNA-b17030,137,7.9,0.1,8e-05,0.031,192,250,179,234,151,247,0.79,58,55,96
OceanDNA-b32628,251,10.5,0.0,1.3e-05,0.0042,93,183,57,151,50,172,0.79,90,94,122
OceanDNA-b46505,115,15.0,0.0,1.1e-06,0.0012,138,218,138,218,129,226,0.79,80,80,97
OceanDNA-b4022,768,11.4,0.0,1.4e-05,0.0087,156,188,159,191,132,194,0.79,32,32,62
OceanDNA-b33525,417,8.3,0.0,5.9e-05,0.22,160,182,222,244,167,252,0.79,22,22,85
OceanDNA-b21043,1056,20.4,0.0,3.8e-08,2.3e-05,79,193,59,176,8,243,0.79,114,117,235
OceanDNA-b45790,316,7.2,0.0,0.00013,0.052,195,261,214,277,209,281,0.79,66,63,72
OceanDNA-b41014,987,68.6,1.3,7.8e-23,5.6e-20,6,269,36,304,31,321,0.79,263,268,290
OceanDNA-b31131,342,19.3,0.0,5.3e-08,1.7e-05,140,182,124,168,119,180,0.79,42,44,61
OceanDNA-b28040,422,5.2,0.1,0.00053,0.34,152,187,134,170,119,194,0.79,35,36,75
OceanDNA-b22386,1905,13.5,0.0,6.2e-06,0.0032,152,187,259,295,235,331,0.79,35,36,96
OceanDNA-b28098,354,18.1,0.0,6.3e-08,0.0001,141,180,125,166,121,182,0.79,39,41,61
OceanDNA-b23819,1194,19.5,0.0,4.8e-08,4.1e-05,154,185,148,180,128,222,0.79,31,32,94
OceanDNA-b19697,279,-3.9,0.0,0.32,110.0,121,138,154,171,146,172,0.79,17,17,26
OceanDNA-b9927,6,2.1,0.0,0.0046,1.7,194,239,212,256,207,272,0.79,45,44,65
OceanDNA-b20962,2408,10.2,0.0,3.3e-05,0.085,155,180,175,200,156,216,0.79,25,25,60
OceanDNA-b17056,36,17.1,0.0,1.2e-07,3.4e-05,138,188,125,175,99,189,0.79,50,50,90
OceanDNA-b46638,597,21.6,0.0,1.6e-08,8.6e-06,147,243,167,265,149,281,0.79,96,98,132
OceanDNA-b46188,73,6.6,0.0,0.0002,0.16,151,194,91,134,79,144,0.79,43,43,65
OceanDNA-b23261,218,5.0,0.0,0.0013,1.5,223,268,231,275,207,293,0.79,45,44,86
OceanDNA-b42676,46,17.9,0.0,7e-08,1.5e-05,87,176,59,153,32,179,0.79,89,94,147
OceanDNA-b46656,816,23.7,0.0,2.4e-09,4.1e-06,154,243,227,318,206,331,0.79,89,91,125
OceanDNA-b38590,329,13.4,0.0,1.7e-06,0.0012,76,191,29,148,10,181,0.79,115,119,171
OceanDNA-b20979,1809,28.1,0.0,5.8e-11,1.5e-07,69,185,207,326,191,371,0.79,116,119,180
OceanDNA-b3608,2049,-0.1,0.0,0.021,45.0,159,177,123,141,107,156,0.79,18,18,49
OceanDNA-b3598,254,8.4,0.0,5.7e-05,0.023,149,185,91,127,77,148,0.79,36,36,71
OceanDNA-b32666,668,10.6,0.1,1.2e-05,0.015,154,184,46,79,18,101,0.79,30,33,83
OceanDNA-b31948,360,15.0,0.1,1.1e-06,0.0012,127,185,987,1048,984,1057,0.79,58,61,73
OceanDNA-b33283,263,15.0,0.0,1.1e-06,0.0019,70,212,103,256,69,283,0.79,142,153,214
OceanDNA-b22518,1323,10.5,0.0,1.3e-05,0.048,97,169,379,449,367,466,0.79,72,70,99
OceanDNA-b44624,60,12.8,0.0,2.6e-06,0.0054,140,181,126,169,114,189,0.79,41,43,75
OceanDNA-b24725,125,13.6,0.0,1.5e-06,0.0042,154,185,125,155,89,161,0.79,31,30,72
OceanDNA-b17764,2398,13.6,0.0,1.5e-06,0.0069,107,176,128,207,115,222,0.79,69,79,107
OceanDNA-b15892,186,18.2,0.0,5.8e-08,1.8e-05,105,187,67,148,59,162,0.79,82,81,103
OceanDNA-b46530,745,9.8,0.0,2.1e-05,0.024,153,179,236,262,215,275,0.79,26,26,60
OceanDNA-b31948,360,-1.3,0.0,0.1,110.0,107,121,942,956,927,963,0.79,14,14,36
OceanDNA-b950,1681,12.1,0.1,8.2e-06,0.0087,139,185,84,129,70,164,0.79,46,45,94
OceanDNA-b30051,355,17.9,0.0,7e-08,0.00016,141,184,155,200,142,213,0.79,43,45,71
OceanDNA-b33411,1017,8.9,0.0,7.9e-05,0.052,195,247,368,416,360,432,0.79,52,48,72
OceanDNA-b45984,1104,12.7,0.0,2.7e-06,0.003,185,240,39,97,1,105,0.79,55,58,104
OceanDNA-b23482,159,12.1,0.0,4.1e-06,0.0065,159,190,155,187,138,198,0.79,31,32,60
OceanDNA-b45457,346,13.5,0.0,1.6e-06,0.00086,153,188,156,192,138,250,0.79,35,36,112
OceanDNA-b22504,1295,13.1,0.0,4.2e-06,0.0061,152,188,392,429,372,463,0.79,36,37,91
OceanDNA-b44378,1157,-3.4,0.0,0.23,300.0,157,180,216,239,209,251,0.79,23,23,42
OceanDNA-b3648,904,14.1,0.0,1.1e-06,0.001,139,183,73,118,37,134,0.79,44,45,97
OceanDNA-b43874,51,18.5,0.0,4.7e-08,2.7e-05,139,181,124,168,111,188,0.79,42,44,77
OceanDNA-b27542,1349,6.6,0.0,0.0004,0.44,161,202,119,163,60,173,0.79,41,44,113
OceanDNA-b6749,448,18.2,0.0,5.8e-08,3.8e-05,86,187,145,249,136,255,0.79,101,104,119
OceanDNA-b40228,134,17.5,0.3,9.8e-08,6.3e-05,88,176,74,167,31,172,0.79,88,93,141
OceanDNA-b38976,861,12.9,0.0,2.4e-06,0.003,59,187,34,173,5,207,0.79,128,139,202
OceanDNA-b21144,22,14.7,0.0,6.9e-07,0.00031,150,249,128,228,73,251,0.79,99,100,178
OceanDNA-b23258,83,18.2,0.0,5.7e-08,1.8e-05,146,187,231,272,202,304,0.79,41,41,102
OceanDNA-b22380,743,15.5,0.0,7.8e-07,0.00061,135,185,147,192,127,226,0.79,50,45,99
OceanDNA-b16229,52,34.0,0.0,1.7e-12,1.2e-09,77,176,248,366,189,375,0.79,99,118,186
OceanDNA-b22917,1949,-3.7,0.0,1.1,810.0,15,48,335,368,333,371,0.79,33,33,38
OceanDNA-b37351,879,1.0,0.0,0.01,13.0,150,177,152,179,137,196,0.79,27,27,59
OceanDNA-b30095,2002,17.1,0.0,3.7e-07,0.00031,153,179,141,167,123,183,0.79,26,26,60
OceanDNA-b147,45,16.6,0.0,1.8e-07,0.00016,80,172,93,194,17,199,0.79,92,101,182
OceanDNA-b44160,136,11.6,0.0,5.8e-06,0.0037,145,197,69,124,42,151,0.79,52,55,109
OceanDNA-b17217,1754,22.4,0.0,3.1e-09,5.8e-06,150,265,176,298,164,301,0.79,115,122,137
OceanDNA-b41386,175,11.7,0.0,5.7e-06,0.0039,143,187,101,148,92,163,0.79,44,47,71
OceanDNA-b19612,423,12.7,0.0,5.6e-06,0.0017,126,209,215,303,206,316,0.79,83,88,110
OceanDNA-b36076,1735,-2.5,0.0,0.23,290.0,162,196,265,299,261,312,0.79,34,34,51
OceanDNA-b23055,698,10.6,0.0,2.5e-05,0.0091,149,195,49,95,33,123,0.79,46,46,90
OceanDNA-b34275,864,12.7,0.0,5.5e-06,0.0025,158,180,156,178,134,194,0.79,22,22,60
OceanDNA-b27556,2127,3.6,0.5,0.0048,3.4,15,66,82,133,68,137,0.79,51,51,69
OceanDNA-b22419,3145,10.7,0.0,1.1e-05,0.041,147,185,111,149,86,157,0.79,38,38,71
OceanDNA-a485,127,30.2,0.0,1.2e-11,4.1e-09,75,211,158,302,110,338,0.79,136,144,228
OceanDNA-b40912,147,14.8,0.0,6.4e-07,0.00056,82,171,126,224,108,235,0.79,89,98,127
OceanDNA-b30447,350,9.8,0.2,2.1e-05,0.056,158,230,256,332,240,352,0.79,72,76,112
OceanDNA-b23909,99,1.6,0.0,0.013,13.0,155,187,156,188,138,195,0.79,32,32,57
OceanDNA-b18150,166,22.3,0.0,3.3e-09,5.4e-07,143,209,234,304,219,317,0.79,66,70,98
OceanDNA-b15551,1054,11.5,0.0,1.3e-05,0.013,125,189,131,188,123,202,0.79,64,57,79
OceanDNA-b33303,944,16.8,0.0,1.6e-07,0.00068,141,185,140,186,123,204,0.79,44,46,81
OceanDNA-b4005,959,7.7,0.0,0.00018,0.1,22,68,45,91,26,97,0.79,46,46,71
OceanDNA-b41418,435,8.9,0.0,3.9e-05,0.034,151,190,107,146,28,177,0.79,39,39,149
OceanDNA-b3658,730,11.2,0.0,1.6e-05,0.011,154,184,82,112,71,125,0.79,30,30,54
OceanDNA-b36430,1104,12.1,0.0,4.2e-06,0.0088,97,183,55,144,27,151,0.79,86,89,124
OceanDNA-b30166,781,22.7,0.2,2.5e-09,4.4e-06,137,188,147,196,98,206,0.79,51,49,108
OceanDNA-b26433,1379,15.5,0.0,3.9e-07,0.00063,89,178,56,149,50,168,0.79,89,93,118
OceanDNA-b46207,101,23.4,0.0,1.5e-09,2.1e-06,153,228,176,253,161,275,0.79,75,77,114
OceanDNA-b41152,1030,8.2,0.1,0.00013,0.15,158,192,93,131,72,141,0.79,34,38,69
OceanDNA-b31076,1340,17.0,0.1,4.1e-07,0.00041,153,213,279,346,260,367,0.79,60,67,107
OceanDNA-b22767,2015,14.2,0.0,1.9e-06,0.0026,158,224,150,220,99,228,0.79,66,70,129
OceanDNA-b31326,125,17.5,0.0,9.6e-08,2.1e-05,165,252,6,97,2,106,0.79,87,91,104
OceanDNA-b31504,233,-3.0,0.0,0.17,76.0,158,186,137,165,134,170,0.79,28,28,36
OceanDNA-b40669,443,29.7,0.0,3.5e-11,1.1e-08,153,243,160,257,112,274,0.79,90,97,162
OceanDNA-b33192,401,5.1,0.2,0.0011,0.24,230,265,111,148,87,149,0.79,35,37,62
OceanDNA-b4491,657,35.3,0.0,7.3e-13,2.6e-10,85,175,140,240,134,246,0.79,90,100,112
OceanDNA-b17578,1150,11.2,0.0,1.5e-05,0.011,74,131,142,208,130,216,0.79,57,66,86
OceanDNA-b44623,260,9.9,0.0,1.9e-05,0.042,195,247,611,663,606,679,0.79,52,52,73
OceanDNA-b32084,461,14.6,0.0,1.4e-06,0.0023,154,184,142,172,124,183,0.79,30,30,59
OceanDNA-b20819,318,14.8,0.0,1.2e-06,0.00042,144,191,132,181,108,202,0.79,47,49,94
OceanDNA-b43839,38,10.5,0.0,1.3e-05,0.022,188,261,207,276,184,280,0.79,73,69,96
OceanDNA-b32517,215,11.5,0.0,6.3e-06,0.0019,158,188,151,182,129,204,0.79,30,31,75
OceanDNA-b20674,70,16.4,0.0,2.1e-07,6.4e-05,196,275,240,322,233,337,0.79,79,82,104
OceanDNA-b37652,816,15.2,0.0,9.8e-07,0.00062,140,180,158,200,148,228,0.79,40,42,80
OceanDNA-b22905,478,18.7,0.0,1.2e-07,0.00011,59,223,81,256,57,296,0.79,164,175,239
OceanDNA-b16140,405,10.4,0.0,1.4e-05,0.013,234,279,505,552,489,565,0.79,45,47,76
OceanDNA-b16227,471,4.6,0.0,0.0024,0.83,195,225,474,505,453,529,0.79,30,31,76
OceanDNA-b20819,330,2.2,0.0,0.0087,3.0,85,121,136,172,124,194,0.79,36,36,70
OceanDNA-b40640,1386,19.4,0.0,2.6e-08,3.8e-05,140,180,134,176,129,196,0.79,40,42,67
OceanDNA-b29386,848,17.5,0.0,9.7e-08,0.00018,144,180,465,503,458,528,0.79,36,38,70
OceanDNA-b35385,206,10.5,0.0,1.3e-05,0.0099,148,217,113,190,100,228,0.79,69,77,128
OceanDNA-b939,1621,16.6,0.1,1.8e-07,0.00037,141,190,86,134,80,172,0.79,49,48,92
OceanDNA-b23453,2034,11.4,0.1,6.7e-06,0.019,117,174,71,134,63,153,0.79,57,63,90
OceanDNA-b15283,256,16.1,0.0,2.5e-07,8.1e-05,56,185,7,144,2,170,0.79,129,137,168
OceanDNA-b40713,137,-1.7,0.0,0.07,56.0,58,80,189,211,176,214,0.79,22,22,38
OceanDNA-b23293,1110,6.6,0.0,0.0002,0.28,187,263,224,298,212,301,0.79,76,74,89
OceanDNA-b41055,555,60.7,0.8,1.4e-20,1.5e-17,20,269,19,270,3,287,0.79,249,251,284
OceanDNA-b22450,341,12.9,0.2,7.4e-06,0.0034,77,175,532,632,527,638,0.79,98,100,111
OceanDNA-b20967,119,21.5,0.0,5.8e-09,8.7e-06,88,170,145,236,128,252,0.79,82,91,124
OceanDNA-b22450,507,11.4,0.0,2.1e-05,0.0097,152,185,194,227,166,240,0.79,33,33,74
OceanDNA-b22293,614,15.7,0.1,3.4e-07,0.00039,138,185,118,166,111,222,0.79,47,48,111
OceanDNA-b8073,260,15.4,0.0,4.1e-07,0.00011,147,186,138,178,122,209,0.79,39,40,87
OceanDNA-b20629,17,15.5,0.0,3.8e-07,7.1e-05,139,209,221,295,196,299,0.79,70,74,103
OceanDNA-b5270,260,47.5,1.2,7.1e-17,3.6e-14,153,244,151,244,41,257,0.79,91,93,216
OceanDNA-b28576,324,7.2,0.0,0.00013,0.064,194,263,220,287,215,297,0.79,69,67,82
OceanDNA-b38971,193,11.4,0.0,6.9e-06,0.015,140,185,133,179,129,190,0.79,45,46,61
OceanDNA-b39458,463,30.0,0.4,1.4e-11,7.7e-09,87,172,146,245,138,249,0.79,85,99,111
OceanDNA-b11418,498,6.4,0.0,0.00023,0.12,198,266,191,257,184,267,0.79,68,66,83
OceanDNA-b512,233,16.6,0.0,3.6e-07,0.0003,148,186,88,127,34,132,0.79,38,39,98
OceanDNA-b1435,542,-0.6,0.0,0.06,25.0,198,229,256,286,250,292,0.79,31,30,42
OceanDNA-b33192,401,0.4,0.0,0.031,6.6,131,150,79,98,69,110,0.79,19,19,41
OceanDNA-b23825,839,2.1,0.0,0.0095,7.4,198,254,258,312,252,324,0.79,56,54,72
OceanDNA-b17223,1015,9.8,0.1,4.1e-05,0.055,185,243,246,302,184,305,0.79,58,56,121
OceanDNA-b40713,137,9.6,0.0,2.4e-05,0.019,135,174,252,285,244,296,0.79,39,33,52
OceanDNA-b11455,288,4.6,0.0,0.00081,0.62,197,241,384,431,375,451,0.79,44,47,76
OceanDNA-b36831,738,20.6,0.0,1.1e-08,1.1e-05,153,187,143,177,116,248,0.79,34,34,132
OceanDNA-b30854,1685,16.3,0.0,4.4e-07,0.0005,88,182,88,190,80,202,0.79,94,102,122
OceanDNA-b22862,2207,13.1,0.1,2.1e-06,0.0072,153,214,174,237,162,268,0.79,61,63,106
OceanDNA-b40473,212,-0.3,0.0,0.077,27.0,195,231,302,339,299,352,0.79,36,37,53
OceanDNA-b7115,77,11.6,0.8,5.9e-06,0.0019,245,279,4,41,2,61,0.79,34,37,59
OceanDNA-b22185,127,139.2,0.0,8.2e-45,2e-41,40,282,51,310,15,322,0.79,242,259,307
OceanDNA-b15136,655,10.7,0.0,1.1e-05,0.0074,197,266,615,686,590,688,0.79,69,71,98
OceanDNA-b32650,1081,20.7,0.0,1e-08,1.9e-05,140,181,147,190,137,205,0.79,41,43,68
OceanDNA-b282,778,-3.9,0.0,0.61,440.0,216,241,25,50,21,53,0.79,25,25,32
OceanDNA-b41476,1378,14.6,0.0,1.4e-06,0.001,153,180,154,181,128,200,0.79,27,27,72
OceanDNA-b24894,844,10.6,0.1,1.2e-05,0.02,161,189,114,143,109,156,0.79,28,29,47
OceanDNA-b9789,34,14.4,0.0,8.5e-07,0.00061,151,221,138,211,124,249,0.79,70,73,125
OceanDNA-b3934,230,4.4,0.0,0.0018,0.65,160,187,105,132,50,149,0.79,27,27,99
OceanDNA-b6212,8,11.2,0.0,8e-06,0.0065,109,199,558,656,550,683,0.79,90,98,133
OceanDNA-b32730,173,12.6,0.0,6.1e-06,0.0016,150,186,220,257,206,276,0.79,36,37,70
OceanDNA-b2866,2501,-0.8,0.0,0.072,95.0,193,244,290,337,287,351,0.79,51,47,64
OceanDNA-b2835,4814,12.5,0.0,3.1e-06,0.016,148,185,89,128,81,136,0.79,37,39,55
OceanDNA-b35160,65,11.9,0.0,4.9e-06,0.0032,154,189,164,199,146,222,0.79,35,35,76
OceanDNA-b6291,245,3.2,0.0,0.0021,1.2,191,220,207,237,202,250,0.79,29,30,48
OceanDNA-b30206,381,6.6,0.0,0.00019,0.44,176,245,273,347,258,357,0.79,69,74,99
OceanDNA-b31526,385,14.9,0.0,1.8e-06,0.0006,197,253,308,364,282,378,0.79,56,56,96
OceanDNA-b46644,141,31.7,0.0,4.6e-12,6.3e-09,149,213,145,215,122,241,0.79,64,70,119
OceanDNA-b19769,45,-0.3,0.0,0.052,12.0,89,121,206,238,198,258,0.79,32,32,60
OceanDNA-b9151,162,27.1,0.0,1.1e-10,3.4e-08,86,177,129,231,95,253,0.79,91,102,158
OceanDNA-b30627,591,0.4,0.0,0.015,14.0,249,287,388,428,374,434,0.79,38,40,60
OceanDNA-b36166,456,12.1,0.2,8.4e-06,0.0093,150,192,3,47,1,59,0.79,42,44,58
OceanDNA-b13229,420,-0.3,0.0,0.05,17.0,149,181,89,121,68,131,0.79,32,32,63
OceanDNA-b34946,337,7.5,0.3,0.00011,0.078,229,268,235,275,198,277,0.79,39,40,79
OceanDNA-b19229,137,21.7,0.0,5.2e-09,1.7e-06,148,217,144,215,115,242,0.79,69,71,127
OceanDNA-b10418,245,16.3,0.0,2.3e-07,6.3e-05,151,238,140,228,124,240,0.79,87,88,116
OceanDNA-b19130,5,9.4,0.2,5.8e-05,0.013,130,190,278,342,269,406,0.79,60,64,137
OceanDNA-b32661,1278,19.2,0.0,2.8e-08,7e-05,153,184,149,180,129,191,0.79,31,31,62
OceanDNA-b22890,496,16.3,0.0,6.6e-07,0.00046,151,217,172,240,154,257,0.79,66,68,103
OceanDNA-b21048,127,-3.2,0.0,0.38,330.0,247,279,343,375,333,378,0.79,32,32,45
OceanDNA-b10294,339,18.4,0.0,1e-07,4.4e-05,74,193,51,177,34,185,0.79,119,126,151
OceanDNA-b5198,106,12.0,0.0,4.6e-06,0.0016,158,182,81,105,22,129,0.79,24,24,107
OceanDNA-b19690,88,2.7,0.0,0.006,1.3,88,123,203,238,191,258,0.79,35,35,67
OceanDNA-b14104,138,-0.8,0.0,0.11,17.0,192,210,233,251,210,260,0.79,18,18,50
OceanDNA-b30346,1949,8.7,0.1,4.7e-05,0.1,151,196,104,154,81,163,0.79,45,50,82
OceanDNA-b6674,21,12.5,0.0,6.5e-06,0.0021,151,188,165,203,150,207,0.79,37,38,57
OceanDNA-b23176,189,31.8,0.0,1.3e-11,3.2e-08,84,217,64,205,35,234,0.79,133,141,199
OceanDNA-a3751,172,7.2,0.0,0.00013,0.024,179,217,377,418,370,439,0.79,38,41,69
OceanDNA-b24875,724,13.0,0.0,2.2e-06,0.0038,144,178,118,152,99,230,0.79,34,34,131
OceanDNA-b23145,632,25.1,0.0,9.5e-10,1e-06,153,213,154,218,140,250,0.79,60,64,110
OceanDNA-b38495,763,11.1,0.0,2.6e-05,0.0072,134,181,121,169,110,191,0.79,47,48,81
OceanDNA-b3956,990,8.5,0.0,5.1e-05,0.053,160,193,109,146,15,157,0.79,33,37,142
OceanDNA-b34782,645,6.6,0.1,0.0002,0.13,147,176,29,58,19,84,0.79,29,29,65
OceanDNA-b41358,38,11.7,0.0,2.2e-05,0.0067,140,185,140,186,134,198,0.79,45,46,64
OceanDNA-b3372,406,11.3,0.1,1.5e-05,0.025,148,220,261,335,249,346,0.79,72,74,97
OceanDNA-b23165,145,1.6,0.0,0.0067,20.0,94,121,140,167,115,184,0.79,27,27,69
OceanDNA-b10144,58,14.5,0.0,7.6e-07,0.00026,145,184,91,130,70,146,0.79,39,39,76
OceanDNA-b42477,163,17.2,0.0,1.2e-07,3.2e-05,153,188,167,202,156,273,0.79,35,35,117
OceanDNA-b13590,1921,12.1,0.0,1.7e-05,0.012,139,187,311,358,262,402,0.79,48,47,140
OceanDNA-b46553,761,12.0,0.1,9.3e-06,0.0069,139,172,81,114,75,135,0.79,33,33,60
OceanDNA-b11955,249,38.8,0.1,3e-14,4e-11,113,244,89,225,69,233,0.79,131,136,164
OceanDNA-b32785,766,10.1,0.0,1.8e-05,0.019,150,185,90,125,11,141,0.79,35,35,130
OceanDNA-b6291,245,6.8,0.0,0.00018,0.1,151,172,117,138,26,155,0.79,21,21,129
OceanDNA-b22615,1167,15.2,0.1,1.4e-06,0.0028,151,185,133,167,127,206,0.79,34,34,79
OceanDNA-b44612,950,11.4,0.0,7.1e-06,0.018,140,180,123,166,117,176,0.79,40,43,59
OceanDNA-b4494,680,-3.2,0.0,0.4,230.0,218,240,37,59,33,71,0.79,22,22,38
OceanDNA-b42263,77,12.9,0.1,2.4e-06,0.00036,88,176,77,169,61,176,0.79,88,92,115
OceanDNA-b17506,254,27.2,0.0,1e-10,8.2e-08,154,245,411,505,393,514,0.79,91,94,121
OceanDNA-b46725,44,24.6,0.0,1.3e-09,1.3e-06,154,243,251,342,245,350,0.79,89,91,105
OceanDNA-b11234,311,29.3,0.0,2.3e-11,1e-08,151,229,143,222,108,239,0.79,78,79,131
OceanDNA-b24923,2035,12.6,0.1,3.1e-06,0.0077,132,191,112,176,96,201,0.79,59,64,105
OceanDNA-b25814,151,18.9,0.0,3.5e-08,7.3e-06,59,211,72,237,54,262,0.79,152,165,208
OceanDNA-b12096,376,11.5,0.0,6.2e-06,0.0046,195,267,188,258,181,285,0.79,72,70,104
OceanDNA-b3865,332,20.1,0.0,1.5e-08,5.4e-06,154,233,146,230,122,248,0.78,79,84,126
OceanDNA-b1965,72,17.6,0.0,9.1e-08,3e-05,75,175,52,157,47,164,0.78,100,105,117
OceanDNA-b23944,1715,9.5,0.2,2.7e-05,0.047,103,188,53,137,36,156,0.78,85,84,120
OceanDNA-b38872,355,4.0,0.0,0.0012,0.82,199,266,188,253,176,264,0.78,67,65,88
OceanDNA-a3351,125,19.0,0.0,3.3e-08,1.4e-05,153,213,199,265,181,272,0.78,60,66,91
OceanDNA-b47092,365,11.3,0.0,1.4e-05,0.013,136,185,142,191,124,225,0.78,49,49,101
OceanDNA-b29397,1522,15.6,0.0,3.5e-07,0.00086,153,181,145,173,123,198,0.78,28,28,75
OceanDNA-b22616,3382,37.3,0.0,1.7e-13,3.9e-10,153,247,144,240,135,244,0.78,94,96,109
OceanDNA-b46717,1168,15.1,0.0,1e-06,0.0018,155,198,146,190,134,244,0.78,43,44,110
OceanDNA-b22397,2136,9.6,0.0,9.9e-05,0.065,148,185,224,261,212,278,0.78,37,37,66
OceanDNA-b466,148,7.4,0.0,0.00023,0.34,190,220,267,296,212,321,0.78,30,29,109
OceanDNA-b12396,228,28.6,0.0,4.1e-11,1.6e-08,158,238,145,228,120,249,0.78,80,83,129
OceanDNA-b22215,297,14.2,0.0,9.5e-07,0.00092,133,211,62,141,48,155,0.78,78,79,107
OceanDNA-b15541,923,10.9,0.0,1.9e-05,0.018,151,187,110,146,27,152,0.78,36,36,125
OceanDNA-b2563,333,11.1,0.0,8.8e-06,0.0035,156,192,245,283,233,301,0.78,36,38,68
OceanDNA-b32793,1396,5.6,0.0,0.00041,1.4,198,220,209,230,200,263,0.78,22,21,63
OceanDNA-b38495,572,22.4,0.0,9.1e-09,2.5e-06,89,175,109,202,97,215,0.78,86,93,118
OceanDNA-b31537,1880,12.8,0.2,2.6e-06,0.0059,140,187,118,168,94,172,0.78,47,50,78
OceanDNA-b30938,1427,21.3,0.0,2e-08,1.6e-05,88,182,70,172,63,185,0.78,94,102,122
OceanDNA-b3681,100,5.3,0.0,0.0005,0.74,202,265,208,269,193,275,0.78,63,61,82
OceanDNA-b11507,349,11.5,0.0,6.4e-06,0.0037,153,217,161,227,148,266,0.78,64,66,118
OceanDNA-b27590,926,17.9,0.0,7.2e-08,0.00017,154,185,173,204,155,240,0.78,31,31,85
OceanDNA-b24117,1926,-0.4,0.0,0.054,71.0,31,61,243,273,232,281,0.78,30,30,49
OceanDNA-b33325,189,12.2,0.0,3.9e-06,0.0064,160,180,147,167,120,180,0.78,20,20,60
OceanDNA-b10082,290,17.9,0.0,7.4e-08,5.7e-05,79,211,94,236,59,246,0.78,132,142,187
OceanDNA-b3599,614,16.6,0.0,3.7e-07,0.00014,79,187,90,207,81,216,0.78,108,117,135
OceanDNA-b31581,1882,6.7,0.0,0.00018,0.43,136,170,318,352,290,365,0.78,34,34,75
OceanDNA-b7470,187,-2.8,0.0,0.15,83.0,196,212,211,227,206,240,0.78,16,16,34
OceanDNA-b26229,11,12.3,0.1,3.7e-06,0.0021,114,193,106,185,98,193,0.78,79,79,95
OceanDNA-b31152,265,6.4,0.0,0.00046,0.19,138,189,99,150,15,167,0.78,51,51,152
OceanDNA-b16210,467,4.9,0.0,0.0013,0.72,195,225,482,513,460,535,0.78,30,31,75
OceanDNA-b35378,46,4.1,0.0,0.0011,1.9,189,265,182,256,158,261,0.78,76,74,103
OceanDNA-b39207,1687,9.4,0.9,2.9e-05,0.06,103,169,58,129,44,142,0.78,66,71,98
OceanDNA-b39207,1687,0.3,0.0,0.016,34.0,105,145,213,252,180,288,0.78,40,39,108
OceanDNA-b43907,173,20.8,0.0,1.9e-08,3.2e-06,141,185,122,168,106,180,0.78,44,46,74
OceanDNA-b9646,234,10.6,0.0,2.5e-05,0.0075,146,228,281,370,263,379,0.78,82,89,116
OceanDNA-b7466,301,18.2,0.0,6e-08,3e-05,85,124,110,150,104,180,0.78,39,40,76
OceanDNA-b32730,416,1.0,0.0,0.02,5.2,195,231,315,350,310,369,0.78,36,35,59
OceanDNA-b36084,2329,10.4,0.0,1.4e-05,0.037,149,175,304,330,281,337,0.78,26,26,56
OceanDNA-b16133,287,32.2,0.0,9.8e-12,3.7e-09,67,176,226,346,203,359,0.78,109,120,156
OceanDNA-b31569,1828,10.5,0.0,1.3e-05,0.038,155,177,450,472,444,494,0.78,22,22,50
OceanDNA-b46894,843,13.3,0.0,1.8e-06,0.0022,93,199,46,151,32,161,0.78,106,105,129
OceanDNA-b28155,1056,5.9,0.0,0.00032,0.48,195,231,198,233,186,262,0.78,36,35,76
OceanDNA-b30487,1180,32.6,0.3,4.8e-12,6.8e-09,82,174,136,235,130,241,0.78,92,99,111
OceanDNA-b6723,230,12.4,0.0,3.4e-06,0.0023,87,210,106,238,78,250,0.78,123,132,172
OceanDNA-b2835,4814,-1.6,0.0,0.063,320.0,198,214,199,215,195,222,0.78,16,16,27
OceanDNA-b33558,856,13.2,0.6,2e-06,0.0018,127,173,135,178,52,186,0.78,46,43,134
OceanDNA-b12668,103,6.5,0.0,0.00022,0.098,144,197,97,153,84,160,0.78,53,56,76
OceanDNA-b23043,2176,11.0,0.1,1.9e-05,0.037,11,123,59,174,51,192,0.78,112,115,141
OceanDNA-b30483,397,9.9,0.2,1.9e-05,0.046,160,199,110,153,84,197,0.78,39,43,113
OceanDNA-b22386,1880,27.8,0.1,2.7e-10,1.4e-07,153,213,187,251,173,257,0.78,60,64,84
OceanDNA-b12508,394,12.7,0.0,2.8e-06,0.002,154,184,88,118,67,135,0.78,30,30,68
OceanDNA-b6505,278,3.7,0.0,0.0016,1.3,196,264,184,250,178,261,0.78,68,66,83
OceanDNA-b22496,4550,12.2,0.0,8e-06,0.019,150,185,65,100,29,137,0.78,35,35,108
OceanDNA-b3547,369,9.6,0.0,2.4e-05,0.017,155,181,104,130,85,142,0.78,26,26,57
OceanDNA-b40943,684,28.3,0.0,9.7e-11,4.6e-08,153,244,155,253,132,269,0.78,91,98,137
OceanDNA-b26769,766,5.2,0.2,0.00054,1.1,159,188,130,159,110,171,0.78,29,29,61
OceanDNA-b22654,819,11.3,0.0,3.6e-05,0.0087,150,185,266,301,239,355,0.78,35,35,116
OceanDNA-b36408,291,12.8,0.0,2.5e-06,0.0056,51,189,43,186,3,193,0.78,138,143,190
OceanDNA-b39096,2190,14.5,0.1,8.1e-07,0.0019,106,185,62,152,47,181,0.78,79,90,134
OceanDNA-b23834,1426,11.7,0.1,5.4e-06,0.01,87,175,239,322,208,342,0.78,88,83,134
OceanDNA-b13539,479,12.6,0.0,5.9e-06,0.0044,108,180,116,193,105,200,0.78,72,77,95
OceanDNA-b41340,796,53.7,0.0,1.7e-18,1.3e-15,72,270,51,260,32,277,0.78,198,209,245
OceanDNA-b40471,15,61.6,0.0,3.4e-21,6.2e-18,89,270,129,309,104,327,0.78,181,180,223
OceanDNA-b31523,1127,5.6,0.0,0.0004,0.59,177,218,294,343,283,365,0.78,41,49,82
OceanDNA-b3144,1036,-3.8,0.0,0.3,390.0,230,244,303,317,275,326,0.78,14,14,51
OceanDNA-b41526,356,13.4,0.1,3.3e-06,0.0018,107,181,116,187,101,206,0.78,74,71,105
OceanDNA-b40474,484,34.3,0.1,7.2e-13,7e-10,153,250,145,248,120,263,0.78,97,103,143
OceanDNA-b16098,490,3.0,0.0,0.005,1.9,178,243,229,297,221,313,0.78,65,68,92
OceanDNA-b34767,496,3.1,0.0,0.0046,2.1,201,231,227,256,214,281,0.78,30,29,67
OceanDNA-b30953,299,-3.7,0.0,0.28,780.0,108,123,74,89,67,99,0.78,15,15,32
OceanDNA-b36405,186,14.6,0.0,7.2e-07,0.00031,157,186,143,172,118,200,0.78,29,29,82
OceanDNA-b36405,186,-1.5,0.0,0.059,26.0,109,127,75,93,56,114,0.78,18,18,58
OceanDNA-b3594,247,41.9,0.2,3.6e-15,3.9e-12,86,245,122,287,102,345,0.78,159,165,243
OceanDNA-b36751,297,11.6,0.0,1.2e-05,0.0038,156,179,164,187,143,199,0.78,23,23,56
OceanDNA-b44154,508,-2.3,0.0,0.1,54.0,35,54,304,323,292,333,0.78,19,19,41
OceanDNA-b27622,294,1.4,0.1,0.0077,5.9,230,266,251,288,216,293,0.78,36,37,77
OceanDNA-b24430,203,12.2,0.0,4e-06,0.00081,155,249,102,200,88,214,0.78,94,98,126
OceanDNA-b37412,411,12.2,0.0,8e-06,0.0026,152,188,110,146,85,183,0.78,36,36,98
OceanDNA-b18470,311,17.6,0.0,1.8e-07,2.9e-05,151,188,296,334,264,390,0.78,37,38,126
OceanDNA-b46922,163,-1.7,0.0,0.069,150.0,223,244,280,302,275,319,0.78,21,22,44
OceanDNA-b19690,159,18.8,0.0,7.5e-08,1.7e-05,153,217,114,180,101,196,0.78,64,66,95
OceanDNA-b3628,552,1.1,0.0,0.0096,10.0,135,175,45,88,40,100,0.78,40,43,60
OceanDNA-b34859,257,11.6,0.0,1.2e-05,0.0045,140,183,142,186,129,202,0.78,43,44,73
OceanDNA-b17610,1895,12.6,0.0,2.9e-06,0.011,142,184,207,249,160,262,0.78,42,42,102
OceanDNA-b35330,190,13.8,0.1,1.3e-06,0.00026,150,188,101,139,36,156,0.78,38,38,120
OceanDNA-b41234,828,17.6,0.0,8.9e-08,0.00018,96,220,84,204,75,219,0.78,124,120,144
OceanDNA-b22917,1245,22.1,0.0,1.5e-08,1.1e-05,119,246,131,279,127,288,0.78,127,148,161
OceanDNA-b36675,330,7.5,0.0,0.00011,0.13,197,246,602,651,588,668,0.78,49,49,80
OceanDNA-b12909,177,17.1,0.0,1.3e-07,8e-05,146,189,131,174,88,214,0.78,43,43,126
OceanDNA-b3965,374,10.8,0.0,1.1e-05,0.012,159,219,96,156,71,168,0.78,60,60,97
OceanDNA-b28110,1919,15.7,0.0,3.5e-07,0.00078,70,186,251,367,207,399,0.78,116,116,192
OceanDNA-b13250,3119,16.7,0.1,1.5e-06,0.0007,107,188,218,297,172,312,0.78,81,79,140
OceanDNA-b15167,1879,2.0,0.0,0.0098,9.9,187,216,202,231,195,260,0.78,29,29,65
OceanDNA-b29503,212,18.0,0.0,1.3e-07,0.00026,153,184,145,176,127,209,0.78,31,31,82
OceanDNA-b10043,168,1.0,0.0,0.01,4.2,193,217,230,254,225,279,0.78,24,24,54
OceanDNA-b32200,2047,1.6,0.0,0.0068,16.0,197,229,234,265,230,274,0.78,32,31,44
OceanDNA-b19962,69,6.4,0.0,0.00022,0.097,150,181,75,106,59,123,0.78,31,31,64
OceanDNA-b3990,715,14.3,0.0,9.2e-07,0.00083,76,211,102,247,80,262,0.78,135,145,182
OceanDNA-b22108,719,16.7,0.0,5e-07,0.00034,136,190,147,201,116,238,0.78,54,54,122
OceanDNA-b3983,449,11.3,0.0,2.2e-05,0.0076,96,187,158,258,124,284,0.78,91,100,160
OceanDNA-b3695,466,14.8,0.0,1.3e-06,0.0012,61,136,66,147,45,162,0.78,75,81,117
OceanDNA-b4528,304,14.1,0.0,1e-06,0.00069,148,232,129,216,83,254,0.78,84,87,171
OceanDNA-b23458,1638,10.5,0.1,1.3e-05,0.037,133,185,244,290,228,340,0.78,52,46,112
OceanDNA-b9977,293,14.6,0.0,7.3e-07,0.00028,102,208,123,239,100,247,0.78,106,116,147
OceanDNA-b31012,111,11.2,0.0,7.7e-06,0.0041,97,177,88,166,75,190,0.78,80,78,115
OceanDNA-b23394,910,10.5,0.2,2.7e-05,0.033,149,186,823,860,784,878,0.78,37,37,94
OceanDNA-b34735,604,10.6,0.1,2.5e-05,0.0081,62,185,73,194,65,200,0.78,123,121,135
OceanDNA-b15333,114,2.1,0.0,0.0045,1.4,193,221,254,282,245,302,0.78,28,28,57
OceanDNA-b16182,508,14.0,0.0,1.1e-06,0.0007,130,188,233,294,214,337,0.78,58,61,123
OceanDNA-b21002,2996,21.9,0.1,8.7e-09,2.5e-05,85,181,186,295,161,303,0.78,96,109,142
OceanDNA-b45576,305,12.7,0.0,5.7e-06,0.0037,149,186,143,180,119,199,0.78,37,37,80
OceanDNA-b33108,794,10.3,0.0,1.5e-05,0.02,192,245,209,258,179,274,0.78,53,49,95
OceanDNA-b3627,388,16.2,0.0,2.3e-07,0.00017,149,218,134,205,123,235,0.78,69,71,112
OceanDNA-b17223,1015,-2.3,0.0,0.2,280.0,39,80,55,98,46,104,0.78,41,43,58
OceanDNA-b9767,735,20.1,0.0,1.6e-08,1.7e-05,83,187,173,280,166,286,0.78,104,107,120
OceanDNA-b30874,1412,17.8,0.0,1.6e-07,0.00018,86,184,65,171,57,187,0.78,98,106,130
OceanDNA-b13250,2981,35.2,0.6,3.5e-12,1.6e-09,75,271,69,264,58,280,0.78,196,195,222
OceanDNA-b23461,1360,14.0,0.0,1.1e-06,0.0033,149,182,168,200,153,244,0.78,33,32,91
OceanDNA-b12537,160,10.7,0.0,1.1e-05,0.0027,153,179,35,61,24,74,0.78,26,26,50
OceanDNA-b30221,614,14.6,0.0,1.4e-06,0.0015,153,177,172,196,158,238,0.78,24,24,80
OceanDNA-b6569,486,7.2,0.0,0.00013,0.11,195,265,188,256,156,265,0.78,70,68,109
OceanDNA-b33570,565,16.8,0.0,1.6e-07,0.0002,88,186,49,153,21,164,0.78,98,104,143
OceanDNA-b929,256,11.0,0.2,8.9e-06,0.0039,68,119,105,156,54,169,0.78,51,51,115
OceanDNA-b36729,927,5.2,0.1,0.00052,1.2,85,152,143,209,97,222,0.78,67,66,125
OceanDNA-b1435,454,3.3,0.0,0.0041,1.7,196,245,235,280,216,297,0.78,49,45,81
OceanDNA-b45059,186,1.1,0.0,0.0096,6.3,181,214,176,211,164,221,0.78,33,35,57
OceanDNA-b41152,26,71.9,1.0,5.1e-24,5.8e-21,7,270,37,305,31,327,0.78,263,268,296
OceanDNA-b38743,177,13.4,0.0,1.7e-06,0.00067,141,185,137,182,123,191,0.78,44,45,68
OceanDNA-b31685,2065,14.2,0.0,2e-06,0.0023,53,121,64,129,16,144,0.78,68,65,128
OceanDNA-b15190,1474,0.1,0.0,0.019,44.0,176,210,179,214,171,220,0.78,34,35,49
OceanDNA-b22983,11,15.9,1.7,2.9e-07,0.00042,54,171,314,434,309,441,0.78,117,120,132
OceanDNA-b16198,1641,10.5,0.0,1.3e-05,0.022,177,249,110,185,106,198,0.78,72,75,92
OceanDNA-b23817,867,13.8,0.0,2.6e-06,0.002,154,185,191,222,171,250,0.78,31,31,79
OceanDNA-b5610,599,11.9,0.0,4.9e-06,0.004,231,268,10,48,1,55,0.78,37,38,54
OceanDNA-b23584,2007,11.1,0.0,1.7e-05,0.021,150,189,196,235,119,245,0.78,39,39,126
OceanDNA-b19701,291,14.3,0.0,2.7e-06,0.00037,145,191,313,359,285,380,0.78,46,46,95
OceanDNA-b22412,1479,15.1,0.0,5.1e-07,0.0012,109,187,541,618,533,645,0.78,78,77,112
OceanDNA-b7219,294,-2.5,0.0,0.12,39.0,195,215,209,229,205,236,0.78,20,20,31
OceanDNA-b33521,2359,21.7,0.1,4.9e-09,1.4e-05,87,172,140,237,132,254,0.78,85,97,122
OceanDNA-b36733,1175,11.9,0.0,9.4e-06,0.0095,100,189,108,206,76,241,0.78,89,98,165
OceanDNA-b45582,1749,12.6,0.0,3e-06,0.0068,163,216,15,73,9,89,0.78,53,58,80
OceanDNA-b201,506,11.8,0.0,5.2e-06,0.0046,148,250,112,215,90,236,0.78,102,103,146
OceanDNA-b27556,997,14.0,0.1,3.3e-06,0.0024,123,189,94,159,81,185,0.78,66,65,104
OceanDNA-b19314,92,12.0,0.0,4.4e-06,0.0015,146,171,127,152,84,159,0.78,25,25,75
OceanDNA-b16117,541,0.5,0.0,0.028,11.0,196,224,218,246,210,267,0.78,28,28,57
OceanDNA-b34612,209,21.4,0.0,6.1e-09,5.5e-06,108,203,116,208,87,224,0.78,95,92,137
OceanDNA-b32785,766,-3.8,0.0,0.3,310.0,202,217,223,238,220,247,0.78,15,15,27
OceanDNA-b11842,884,42.8,0.0,1.8e-15,2.2e-12,98,243,93,242,81,259,0.78,145,149,178
OceanDNA-b41014,1220,3.2,0.0,0.0063,4.5,194,225,207,237,177,256,0.78,31,30,79
OceanDNA-b6218,393,2.3,0.0,0.0039,2.2,153,174,150,171,135,184,0.78,21,21,49
OceanDNA-b23145,1394,20.1,0.0,3.1e-08,3.3e-05,145,244,147,242,128,252,0.78,99,95,124
OceanDNA-b11950,656,10.9,0.0,1e-05,0.014,148,187,198,237,183,274,0.78,39,39,91
OceanDNA-b30627,591,4.3,0.0,0.001,0.94,176,245,280,354,267,362,0.78,69,74,95
OceanDNA-b13288,867,4.2,0.1,0.0011,1.2,14,54,9,49,2,73,0.78,40,40,71
OceanDNA-b10067,117,6.0,0.0,0.00031,0.15,199,264,616,683,602,685,0.78,65,67,83
OceanDNA-b20105,218,32.5,0.0,2.6e-12,1.2e-09,156,243,162,260,139,270,0.78,87,98,131
OceanDNA-b4004,18,4.0,0.0,0.0012,1.4,161,190,60,90,5,115,0.78,29,30,110
OceanDNA-b6574,558,10.0,0.0,3.7e-05,0.016,151,180,124,153,90,160,0.78,29,29,70
OceanDNA-b20957,1657,13.6,0.0,1.4e-06,0.0057,27,88,27,88,5,103,0.78,61,61,98
OceanDNA-b26680,1903,12.9,0.0,2.5e-06,0.0063,109,193,173,262,155,271,0.78,84,89,116
OceanDNA-b12674,139,12.9,0.0,2.3e-06,0.0014,107,196,551,647,520,656,0.78,89,96,136
OceanDNA-b5611,820,13.1,0.0,2.1e-06,0.0028,136,187,370,423,364,440,0.78,51,53,76
OceanDNA-b41426,71,10.2,0.1,1.5e-05,0.027,148,185,120,157,96,164,0.78,37,37,68
OceanDNA-b40613,167,16.2,0.0,4.8e-07,0.00018,154,181,140,167,110,188,0.78,27,27,78
OceanDNA-b23680,180,11.2,0.0,7.7e-06,0.014,162,187,100,125,93,149,0.78,25,25,56
OceanDNA-b22926,1352,0.3,0.0,0.033,77.0,201,264,280,343,275,347,0.78,63,63,72
OceanDNA-b24235,159,15.6,0.0,3.7e-07,0.00014,157,185,150,178,120,193,0.78,28,28,73
OceanDNA-b13590,1844,18.8,0.0,1.6e-07,0.00011,159,216,159,222,92,250,0.78,57,63,158
OceanDNA-b20036,313,21.8,0.0,1.4e-08,1.8e-06,154,225,131,203,116,236,0.78,71,72,120
OceanDNA-b20657,47,17.9,0.0,1.4e-07,2.1e-05,199,273,237,314,230,335,0.78,74,77,105
OceanDNA-b16229,52,4.0,0.0,0.0024,1.6,196,245,429,477,424,487,0.78,49,48,63
OceanDNA-b41581,30,16.1,0.0,2.6e-07,0.00015,133,174,123,163,112,178,0.78,41,40,66
OceanDNA-b16222,285,6.2,0.0,0.00027,0.45,197,247,243,293,229,308,0.78,50,50,79
OceanDNA-b37578,813,28.6,0.0,4.1e-11,1.1e-07,75,243,92,278,14,291,0.78,168,186,277
OceanDNA-b13570,390,5.0,0.0,0.0013,0.83,193,251,180,236,162,248,0.78,58,56,86
OceanDNA-b13561,806,10.7,0.1,1.1e-05,0.0092,88,182,60,152,54,164,0.78,94,92,110
OceanDNA-b12351,370,34.9,0.0,4.8e-13,2e-10,157,243,141,230,114,244,0.78,86,89,130
OceanDNA-b30773,857,12.3,0.0,3.8e-06,0.011,154,197,160,206,115,219,0.78,43,46,104
OceanDNA-b36158,534,15.5,0.2,7.7e-07,0.00071,147,216,35,106,20,120,0.78,69,71,100
OceanDNA-b6163,418,4.8,0.0,0.00071,0.41,204,268,204,266,184,277,0.78,64,62,93
OceanDNA-b16143,250,2.7,0.0,0.0063,2.7,183,245,398,460,368,464,0.78,62,62,96
OceanDNA-b40086,698,16.2,0.0,2.4e-07,0.00023,154,181,179,206,159,219,0.78,27,27,60
OceanDNA-b40207,335,17.9,0.3,7.3e-08,3.5e-05,88,176,73,166,30,193,0.78,88,93,163
OceanDNA-b24879,657,6.2,0.0,0.00053,0.49,182,220,241,278,233,297,0.78,38,37,64
OceanDNA-b32052,138,12.0,0.0,9.1e-06,0.0088,160,189,158,188,122,205,0.78,29,30,83
OceanDNA-b22191,919,12.4,0.0,3.5e-06,0.0071,135,189,128,181,109,189,0.78,54,53,80
OceanDNA-b6504,238,7.3,0.1,0.00012,0.063,175,243,194,259,189,278,0.78,68,65,89
OceanDNA-b36885,333,-2.2,0.0,0.094,64.0,91,120,118,147,109,151,0.78,29,29,42
OceanDNA-b20491,297,53.5,0.0,2e-18,3.4e-16,54,281,55,309,48,321,0.78,227,254,273
OceanDNA-b26639,931,9.4,0.0,2.7e-05,0.037,147,183,82,120,70,162,0.78,36,38,92
OceanDNA-b5321,407,13.0,0.0,2.3e-06,0.0012,97,175,91,179,82,194,0.78,78,88,112
OceanDNA-b26143,741,12.6,0.0,6e-06,0.0037,156,250,170,268,114,276,0.78,94,98,162
OceanDNA-b22654,53,12.1,0.0,2.1e-05,0.0051,153,208,150,205,129,236,0.78,55,55,107
OceanDNA-b36441,360,14.9,0.0,1.2e-06,0.0017,103,178,135,209,103,227,0.78,75,74,124
OceanDNA-b9096,35,11.4,0.0,7.1e-06,0.0024,179,253,273,353,261,374,0.78,74,80,113
OceanDNA-b26935,170,-3.7,0.1,0.27,70.0,248,268,8,28,7,39,0.78,20,20,32
OceanDNA-b25052,124,1.0,0.0,0.01,11.0,194,214,203,223,178,239,0.78,20,20,61
OceanDNA-b32730,416,9.0,0.0,7.5e-05,0.019,136,184,224,266,170,276,0.78,48,42,106
OceanDNA-b47081,449,11.8,0.0,1e-05,0.0029,153,189,196,233,147,278,0.78,36,37,131
OceanDNA-b510,1001,6.0,0.0,0.00062,0.68,196,219,261,284,252,301,0.78,23,23,49
OceanDNA-b23549,551,11.9,0.0,1.5e-05,0.0098,102,211,192,311,157,323,0.78,109,119,166
OceanDNA-b30021,940,7.4,0.1,0.00012,0.21,193,266,204,275,198,278,0.78,73,71,80
OceanDNA-b30624,1496,11.7,0.1,5.5e-06,0.0094,39,82,111,152,93,179,0.78,43,41,86
OceanDNA-b9758,608,13.7,0.0,2.8e-06,0.0016,147,219,171,246,161,288,0.78,72,75,127
OceanDNA-b40444,376,19.0,0.0,1e-07,6.2e-05,178,244,282,353,277,359,0.78,66,71,82
OceanDNA-b22017,4207,10.1,0.1,1.7e-05,0.097,107,197,321,414,271,435,0.78,90,93,164
OceanDNA-b38499,23,27.5,0.1,8.8e-11,8.9e-08,83,172,140,240,122,244,0.78,89,100,122
OceanDNA-b38499,23,9.5,0.0,2.6e-05,0.026,177,245,280,353,269,367,0.78,68,73,98
OceanDNA-b16510,1060,5.8,0.0,0.00035,0.47,175,224,378,432,373,451,0.78,49,54,78
OceanDNA-b22991,4364,10.7,0.0,1.1e-05,0.052,197,265,209,275,199,280,0.78,68,66,81
OceanDNA-b23145,1394,1.9,0.0,0.011,12.0,92,121,73,102,63,112,0.78,29,29,49
OceanDNA-b260,2646,22.4,0.1,6.1e-09,1e-05,150,217,141,211,113,248,0.78,67,70,135
OceanDNA-b13575,549,4.2,0.0,0.0011,1.2,194,252,182,238,164,254,0.78,58,56,90
OceanDNA-b22894,353,22.9,0.0,4.4e-09,4.6e-06,121,245,139,284,129,294,0.78,124,145,165
OceanDNA-b38999,680,11.4,0.0,1.3e-05,0.015,140,185,203,249,199,259,0.78,45,46,60
OceanDNA-b17248,509,14.4,0.0,8.2e-07,0.00044,198,236,703,743,640,766,0.78,38,40,126
OceanDNA-b11387,576,8.0,0.0,0.00014,0.044,145,188,306,349,286,382,0.78,43,43,96
OceanDNA-b20913,2398,16.0,0.0,5.7e-07,0.0021,140,188,215,262,203,266,0.78,48,47,63
OceanDNA-b5405,23,54.3,0.0,5.7e-19,5.4e-16,154,245,159,253,51,265,0.77,91,94,214
OceanDNA-b46222,1352,5.3,0.1,0.00096,0.78,197,263,204,267,194,270,0.77,66,63,76
OceanDNA-b20511,29,7.7,0.0,9.1e-05,0.025,124,190,208,276,204,298,0.77,66,68,94
OceanDNA-b16123,12,-0.3,0.0,0.05,18.0,196,223,210,237,195,254,0.77,27,27,59
OceanDNA-b3611,2804,10.9,0.0,9.8e-06,0.028,81,177,77,172,51,199,0.77,96,95,148
OceanDNA-b9656,512,18.5,0.0,4.6e-08,3.3e-05,79,212,92,235,77,273,0.77,133,143,196
OceanDNA-b23314,819,2.9,0.0,0.0027,10.0,139,187,76,123,44,146,0.77,48,47,102
OceanDNA-b37047,313,22.7,0.1,2.5e-09,1.8e-06,151,191,183,223,156,235,0.77,40,40,79
OceanDNA-b46741,1437,15.0,0.0,1.1e-06,0.001,153,188,102,138,90,178,0.77,35,36,88
OceanDNA-b17761,2082,13.3,0.0,1.8e-06,0.0054,129,190,214,277,179,296,0.77,61,63,117
OceanDNA-b9486,252,17.4,0.0,1e-07,3.6e-05,153,188,136,174,120,186,0.77,35,38,66
OceanDNA-b21004,1385,8.5,0.0,0.00015,0.099,191,245,327,375,320,387,0.77,54,48,67
OceanDNA-b40959,1116,20.3,0.0,2.6e-08,4.1e-05,40,211,86,269,61,328,0.77,171,183,267
OceanDNA-b32,392,-4.1,0.0,0.72,220.0,39,72,352,385,335,386,0.77,33,33,51
OceanDNA-b960,417,32.6,0.1,2.4e-12,5e-09,94,247,259,419,250,434,0.77,153,160,184
OceanDNA-b41267,1339,-2.9,0.0,0.15,470.0,195,214,273,292,269,299,0.77,19,19,30
OceanDNA-b4608,21,5.4,0.0,0.00048,0.25,161,197,107,147,88,155,0.77,36,40,67
OceanDNA-b41688,10,9.5,0.0,2.6e-05,0.0056,97,182,52,135,27,140,0.77,85,83,113
OceanDNA-b39122,1487,13.9,0.1,1.2e-06,0.0027,106,185,82,172,67,185,0.77,79,90,118
OceanDNA-b30747,684,19.7,0.0,2e-08,2.6e-05,94,193,42,137,29,178,0.77,99,95,149
OceanDNA-b34544,647,19.9,0.0,3.5e-08,1.3e-05,123,247,92,220,54,232,0.77,124,128,178
OceanDNA-b15769,769,21.7,0.2,2e-08,8.8e-06,105,212,124,244,20,252,0.77,107,120,232
OceanDNA-b15769,683,13.7,0.0,5.4e-06,0.0023,144,217,158,234,128,282,0.77,73,76,154
OceanDNA-b20668,130,16.3,0.0,4.3e-07,5.9e-05,200,282,238,323,227,337,0.77,82,85,110
OceanDNA-b16107,394,8.2,0.0,6.4e-05,0.045,181,245,399,465,389,479,0.77,64,66,90
OceanDNA-b7352,307,-2.8,0.0,0.14,48.0,198,214,225,241,219,254,0.77,16,16,35
OceanDNA-b33520,16,2.9,0.0,0.0027,1.4,87,155,93,164,87,175,0.77,68,71,88
OceanDNA-b24238,181,11.7,0.0,5.5e-06,0.0023,146,189,140,185,131,208,0.77,43,45,77
OceanDNA-b23624,1244,11.7,0.0,1.1e-05,0.013,155,181,199,225,109,248,0.77,26,26,139
OceanDNA-b20413,301,10.7,0.1,1.1e-05,0.0034,187,231,239,282,227,312,0.77,44,43,85
OceanDNA-b13281,1727,13.2,0.0,3.9e-06,0.0035,149,188,81,123,65,131,0.77,39,42,66
OceanDNA-b37054,2298,21.1,0.7,1.5e-08,2.4e-05,75,231,82,256,4,269,0.77,156,174,265
OceanDNA-b21004,1525,-1.3,0.0,0.15,97.0,161,186,99,123,92,149,0.77,25,24,57
OceanDNA-b19690,88,9.4,0.0,5.5e-05,0.012,130,190,273,337,262,357,0.77,60,64,95
OceanDNA-b4044,627,22.4,0.0,3.1e-09,3e-06,107,188,161,247,142,256,0.77,81,86,114
OceanDNA-b10050,192,14.5,0.0,8e-07,0.0003,51,192,8,147,3,213,0.77,141,139,210
OceanDNA-b9190,106,31.8,0.0,4.2e-12,1.6e-09,84,175,141,243,134,254,0.77,91,102,120
OceanDNA-b3975,243,17.3,0.0,4.3e-07,9e-05,106,187,94,180,35,209,0.77,81,86,174
OceanDNA-b20705,111,45.8,0.2,2.2e-16,5.3e-14,54,174,60,187,57,213,0.77,120,127,156
OceanDNA-b20974,1857,29.7,0.1,1.9e-11,5.3e-08,76,176,371,477,343,482,0.77,100,106,139
OceanDNA-b34885,159,16.4,0.0,2.1e-07,0.00015,99,212,114,238,77,268,0.77,113,124,191
OceanDNA-b3975,486,10.9,0.0,3.8e-05,0.008,79,180,555,662,550,682,0.77,101,107,132
OceanDNA-b23153,73,1.3,0.0,0.0084,22.0,92,121,133,162,106,170,0.77,29,29,64
OceanDNA-b41003,1014,44.2,0.2,6.9e-16,2e-12,101,268,93,260,7,283,0.77,167,167,276
OceanDNA-b34219,1085,12.1,0.1,4.3e-06,0.011,94,185,195,286,186,300,0.77,91,91,114
OceanDNA-b34949,113,14.3,0.0,2.8e-06,0.00091,107,176,111,187,90,194,0.77,69,76,104
OceanDNA-b23153,73,18.5,0.0,4.6e-08,0.00012,145,244,207,302,188,311,0.77,99,95,123
OceanDNA-b6748,244,18.9,0.0,3.5e-08,2.9e-05,43,212,58,238,49,246,0.77,169,180,197
OceanDNA-b12582,169,12.2,0.0,3.9e-06,0.0014,154,184,121,151,116,162,0.77,30,30,46
OceanDNA-b35196,601,10.3,0.0,1.5e-05,0.011,140,180,141,182,134,207,0.77,40,41,73
OceanDNA-b30046,1421,7.6,0.0,0.0002,0.29,167,227,274,336,268,351,0.77,60,62,83
OceanDNA-b6944,24,12.0,0.0,4.6e-06,0.0011,152,228,144,221,133,242,0.77,76,77,109
OceanDNA-b26127,967,18.8,0.0,3.9e-08,4.8e-05,153,183,143,174,117,203,0.77,30,31,86
OceanDNA-b38942,1826,37.1,0.6,1e-13,2e-10,96,260,94,253,15,272,0.77,164,159,257
OceanDNA-b19817,245,48.1,0.2,4.7e-17,1.8e-14,74,280,90,330,68,339,0.77,206,240,271
OceanDNA-b24140,199,5.3,0.0,0.00049,0.35,139,188,72,120,57,141,0.77,49,48,84
OceanDNA-b2880,2219,12.6,0.0,2.9e-06,0.011,115,180,17,87,6,92,0.77,65,70,86
OceanDNA-b17582,63,19.5,0.0,2.4e-08,7.8e-05,153,215,167,231,148,268,0.77,62,64,120
OceanDNA-b15853,58,10.5,0.0,2.6e-05,0.024,149,222,149,225,131,273,0.77,73,76,142
OceanDNA-b44662,1421,-3.8,0.0,0.6,810.0,87,97,724,734,719,736,0.77,10,10,17
OceanDNA-b22461,2712,12.6,0.2,9e-06,0.014,121,181,131,194,64,278,0.77,60,63,214
OceanDNA-b38369,851,-1.6,0.0,0.13,110.0,196,212,267,283,262,296,0.77,16,16,34
OceanDNA-b1836,2232,9.9,0.1,1.9e-05,0.066,149,185,129,165,74,171,0.77,36,36,97
OceanDNA-b30641,995,5.7,0.1,0.00077,0.41,203,266,235,296,223,299,0.77,63,61,76
OceanDNA-b22387,366,-1.6,0.0,0.12,130.0,98,122,169,193,162,196,0.77,24,24,34
OceanDNA-b28040,422,11.6,0.0,6.2e-06,0.0039,194,244,261,308,244,322,0.77,50,47,78
OceanDNA-b17430,13,1.8,0.0,0.006,13.0,190,221,235,266,211,287,0.77,31,31,76
OceanDNA-b4392,8,18.2,0.1,6e-08,1.8e-05,89,176,78,170,55,181,0.77,87,92,126
OceanDNA-b4473,86,27.7,0.0,7.5e-11,2e-08,153,240,152,241,134,250,0.77,87,89,116
OceanDNA-b9646,517,15.3,0.0,8.8e-07,0.00027,151,215,139,206,122,218,0.77,64,67,96
OceanDNA-b32865,275,1.5,0.0,0.0073,3.8,201,264,202,263,186,268,0.77,63,61,82
OceanDNA-b24097,631,15.1,0.0,5.1e-07,0.00075,62,176,80,201,58,219,0.77,114,121,161
OceanDNA-b20687,126,10.5,0.0,1.3e-05,0.0025,113,173,118,183,76,208,0.77,60,65,132
OceanDNA-b35112,63,13.0,0.0,4.4e-06,0.0023,141,185,4,49,2,64,0.77,44,45,62
OceanDNA-b4346,36,32.2,0.0,3.1e-12,7.7e-10,152,239,144,233,131,243,0.77,87,89,112
OceanDNA-b40444,1787,60.3,0.0,2.7e-20,1.7e-17,95,266,117,287,85,311,0.77,171,170,226
OceanDNA-b4487,698,16.6,0.0,1.7e-07,0.00028,85,212,116,253,96,276,0.77,127,137,180
OceanDNA-b18519,68,10.3,0.0,1.5e-05,0.0046,153,214,90,159,71,200,0.77,61,69,129
OceanDNA-b40635,555,145.5,0.2,1.9e-46,5.7e-44,12,273,20,301,7,315,0.77,261,281,308
OceanDNA-b3700,1479,-3.3,0.0,0.2,530.0,251,282,414,445,410,455,0.77,31,31,45
OceanDNA-b41349,857,93.2,0.0,1.7e-30,1e-27,43,274,51,291,12,309,0.77,231,240,297
OceanDNA-b16138,515,7.7,0.0,9.4e-05,0.073,181,246,422,490,416,500,0.77,65,68,84
OceanDNA-b40250,21,22.3,0.4,6.7e-09,2.4e-06,75,216,96,255,40,280,0.77,141,159,240
OceanDNA-b34610,1103,12.4,0.1,3.4e-06,0.0045,75,180,407,521,385,535,0.77,105,114,150
OceanDNA-b19687,279,58.6,0.0,2.9e-20,1.3e-17,73,282,82,320,60,328,0.77,209,238,268
OceanDNA-b15128,974,10.0,0.1,1.9e-05,0.022,72,172,15,119,2,132,0.77,100,104,130
OceanDNA-b41046,1303,35.8,0.1,2.6e-13,3.8e-10,101,269,97,265,2,282,0.77,168,168,280
OceanDNA-b3621,155,10.0,0.0,1.8e-05,0.016,146,213,301,369,281,404,0.77,67,68,123
OceanDNA-b47105,25,0.3,0.0,0.016,5.0,158,181,137,158,116,167,0.77,23,21,51
OceanDNA-b16117,541,19.6,0.0,4.3e-08,1.6e-05,94,182,90,178,73,187,0.77,88,88,114
OceanDNA-b40473,146,14.6,0.0,2.2e-06,0.00079,140,180,131,173,124,193,0.77,40,42,69
OceanDNA-b6288,38,11.0,0.0,9.3e-06,0.0043,101,190,121,219,86,248,0.77,89,98,162
OceanDNA-b17054,10,15.5,0.0,4e-07,0.00012,129,209,203,286,188,294,0.77,80,83,106
OceanDNA-b33090,1196,14.1,0.1,1e-06,0.0024,65,193,6,131,2,147,0.77,128,125,145
OceanDNA-b22306,164,12.0,0.2,9.3e-06,0.0077,78,169,103,195,76,205,0.77,91,92,129
OceanDNA-b36890,852,12.8,0.1,2.5e-06,0.0039,89,184,70,165,62,179,0.77,95,95,117
OceanDNA-b33298,1568,5.2,0.0,0.00054,1.1,202,273,209,278,200,296,0.77,71,69,96
OceanDNA-b23561,1571,10.2,0.1,1.6e-05,0.035,153,180,224,251,138,266,0.77,27,27,128
OceanDNA-b34608,1113,16.5,0.0,1.9e-07,0.00022,141,184,132,176,125,197,0.77,43,44,72
OceanDNA-b16229,171,23.1,0.0,3.8e-09,2.5e-06,88,187,55,165,31,202,0.77,99,110,171
OceanDNA-b5607,732,14.4,0.0,8.7e-07,0.00067,144,182,73,114,45,124,0.77,38,41,79
OceanDNA-b25136,116,15.8,0.0,3.1e-07,7.2e-05,86,178,99,193,89,200,0.77,92,94,111
OceanDNA-b22888,920,16.2,0.0,4.8e-07,0.00032,89,185,127,221,105,242,0.77,96,94,137
OceanDNA-b46704,996,16.7,0.0,1.7e-07,0.00032,155,222,134,202,117,236,0.77,67,68,119
OceanDNA-b13870,479,14.3,0.0,9.3e-07,0.00047,152,211,125,187,110,201,0.77,59,62,91
OceanDNA-b13250,1870,24.0,0.0,9.1e-09,4.1e-06,137,250,157,270,68,283,0.77,113,113,215
OceanDNA-b42274,30,13.9,0.1,1.2e-06,0.00024,84,175,86,181,72,188,0.77,91,95,116
OceanDNA-b13585,163,6.7,0.1,0.00076,0.29,85,132,71,121,60,145,0.77,47,50,85
OceanDNA-b13203,166,5.4,0.1,0.00048,0.49,196,265,192,259,185,267,0.77,69,67,82
OceanDNA-b34653,194,6.3,0.0,0.00025,0.2,148,183,480,515,422,521,0.77,35,35,99
OceanDNA-b34263,511,12.9,0.0,4.9e-06,0.0016,153,181,593,621,514,626,0.77,28,28,112
OceanDNA-b46651,780,17.6,0.0,1.8e-07,0.00037,154,250,198,297,172,303,0.77,96,99,131
OceanDNA-b43541,53,16.2,0.0,2.4e-07,0.00026,103,187,58,153,15,219,0.77,84,95,204
OceanDNA-b23523,1367,14.2,0.0,9.6e-07,0.0018,152,187,131,167,114,184,0.77,35,36,70
OceanDNA-b40473,146,4.1,0.0,0.0035,1.2,68,108,17,62,4,94,0.77,40,45,90
OceanDNA-b22797,381,17.9,0.1,7.2e-08,9.3e-05,62,196,215,359,166,363,0.77,134,144,197
OceanDNA-b23169,959,-1.4,0.0,0.11,120.0,244,280,323,360,317,364,0.77,36,37,47
OceanDNA-b30852,1197,20.0,0.0,3.4e-08,3.3e-05,86,183,74,179,45,189,0.77,97,105,144
OceanDNA-b20955,963,26.2,0.7,2.2e-10,1.6e-06,55,175,494,617,488,622,0.77,120,123,134
OceanDNA-b17082,426,5.8,0.0,0.00035,0.56,160,192,100,133,93,173,0.77,32,33,80
OceanDNA-b4005,288,17.2,0.0,2.4e-07,0.00013,84,187,157,263,144,269,0.77,103,106,125
OceanDNA-a2501,135,10.1,0.0,1.8e-05,0.0072,141,182,102,146,70,156,0.77,41,44,86
OceanDNA-b25128,258,0.1,0.0,0.038,16.0,195,230,227,261,219,288,0.77,35,34,69
OceanDNA-b22805,2934,11.4,0.0,2.8e-05,0.047,149,216,607,674,552,705,0.77,67,67,153
OceanDNA-b40439,284,15.7,0.0,3.3e-07,0.00065,175,244,265,339,262,347,0.77,69,74,85
OceanDNA-b39392,712,23.1,0.0,1.9e-09,1.5e-06,153,180,141,168,115,200,0.77,27,27,85
OceanDNA-b31989,707,2.7,0.1,0.0031,7.2,132,182,77,126,61,148,0.77,50,49,87
OceanDNA-b30852,1197,3.3,0.0,0.0039,3.9,192,244,238,288,210,299,0.77,52,50,89
OceanDNA-b22805,1348,11.1,1.4,3.3e-05,0.055,145,190,60,102,38,107,0.77,45,42,69
OceanDNA-b38880,297,28.1,0.1,1.1e-10,5.3e-08,83,173,120,221,114,232,0.77,90,101,118
OceanDNA-b46205,397,8.0,0.0,7.6e-05,0.12,76,145,97,165,31,181,0.77,69,68,150
OceanDNA-b38999,1473,11.5,0.1,1.3e-05,0.014,107,185,150,239,136,268,0.77,78,89,132
OceanDNA-b41272,1357,5.5,0.0,0.00042,0.96,185,216,211,241,200,268,0.77,31,30,68
OceanDNA-b40453,184,26.0,0.0,2.4e-10,2.9e-07,80,172,134,238,111,242,0.77,92,104,131
OceanDNA-b45663,568,6.6,0.0,0.00039,0.17,196,261,184,246,179,250,0.77,65,62,71
OceanDNA-b11888,925,30.0,0.1,1.5e-11,2.2e-08,107,243,176,318,158,344,0.77,136,142,186
OceanDNA-b3673,1776,3.7,0.0,0.0015,3.4,203,265,125,185,88,189,0.77,62,60,101
OceanDNA-b12873,257,18.7,0.0,4.1e-08,2.8e-05,107,191,142,233,138,240,0.77,84,91,102
OceanDNA-b29589,161,19.7,0.1,2e-08,6.5e-05,85,175,131,228,116,232,0.77,90,97,116
OceanDNA-b22108,1590,-0.8,0.0,0.11,73.0,257,273,235,251,228,268,0.77,16,16,40
OceanDNA-b26646,3094,14.4,0.0,8.3e-07,0.003,187,246,199,254,180,265,0.77,59,55,85
OceanDNA-b276,693,17.7,0.0,2.6e-07,0.0002,105,216,67,188,42,227,0.77,111,121,185
OceanDNA-b1343,542,11.3,0.0,7.6e-06,0.012,142,187,78,122,70,155,0.77,45,44,85
OceanDNA-b19962,69,6.3,0.0,0.00025,0.11,186,221,184,219,172,252,0.77,35,35,80
OceanDNA-b6503,577,12.4,0.0,6.7e-06,0.0022,134,185,103,153,25,163,0.77,51,50,138
OceanDNA-b30224,1631,15.1,0.1,5.3e-07,0.00096,89,173,110,201,100,208,0.77,84,91,108
OceanDNA-b4147,901,13.6,0.0,1.4e-06,0.0029,99,181,127,209,109,223,0.77,82,82,114
OceanDNA-b7184,483,23.2,0.0,3.6e-09,9.2e-07,79,212,93,237,53,286,0.77,133,144,233
OceanDNA-b19419,260,21.0,0.0,7.9e-09,2.4e-06,152,188,149,186,101,242,0.77,36,37,141
OceanDNA-b17716,254,23.7,0.0,1.2e-09,1.5e-06,151,200,196,246,185,274,0.77,49,50,89
OceanDNA-b276,205,37.0,0.0,3.4e-13,2.6e-10,145,244,127,228,82,235,0.77,99,101,153
OceanDNA-b35152,1683,13.8,0.0,1.3e-06,0.0025,156,177,144,165,122,185,0.77,21,21,63
OceanDNA-b13294,1747,26.2,0.0,2.1e-10,3.8e-07,139,245,11,122,4,128,0.77,106,111,124
OceanDNA-b11611,607,14.2,0.0,9.5e-07,0.00085,153,217,179,245,173,277,0.77,64,66,104
OceanDNA-b29555,2035,10.0,0.1,1.9e-05,0.047,171,234,221,286,213,308,0.77,63,65,95
OceanDNA-b33283,2262,10.8,0.0,2.1e-05,0.036,96,177,47,126,24,132,0.77,81,79,108
OceanDNA-b520,1259,12.8,0.2,2.7e-06,0.0039,150,190,216,256,153,264,0.77,40,40,111
OceanDNA-b2722,200,3.5,0.1,0.0018,1.0,203,264,196,255,187,263,0.77,61,59,76
OceanDNA-b40593,473,16.2,0.0,2.4e-07,0.00012,103,171,5,84,2,88,0.77,68,79,86
OceanDNA-b34892,416,13.5,0.0,3.1e-06,0.0014,107,212,129,245,90,276,0.77,105,116,186
OceanDNA-b36154,2126,10.8,0.0,1e-05,0.025,144,183,163,202,130,225,0.77,39,39,95
OceanDNA-b32144,1624,6.4,0.1,0.00045,0.62,163,182,111,130,90,136,0.77,19,19,46
OceanDNA-b6653,91,6.1,0.0,0.00029,0.13,192,221,218,246,215,278,0.77,29,28,63
OceanDNA-b27545,1368,8.0,0.0,7.5e-05,0.16,161,198,108,149,43,166,0.77,37,41,123
OceanDNA-b423,584,-3.7,0.0,0.27,260.0,152,173,229,250,220,256,0.77,21,21,36
OceanDNA-b9151,162,3.9,0.0,0.0013,0.4,179,250,267,344,254,363,0.77,71,77,109
OceanDNA-b37260,40,23.9,0.0,1e-09,8.7e-07,153,211,138,202,125,240,0.77,58,64,115
OceanDNA-b9344,34,10.3,0.0,1.5e-05,0.0045,157,184,91,118,27,130,0.77,27,27,103
OceanDNA-b13296,356,-0.7,0.0,0.032,33.0,180,222,296,338,288,356,0.77,42,42,68
OceanDNA-b9605,71,17.7,0.0,8e-08,2.2e-05,153,213,210,276,198,290,0.77,60,66,92
OceanDNA-b4002,353,9.9,0.0,1.9e-05,0.025,107,180,574,653,530,674,0.77,73,79,144
OceanDNA-b41226,83,41.2,0.0,5.7e-15,1.1e-11,96,274,85,266,3,279,0.77,178,181,276
OceanDNA-b26143,256,17.3,0.0,2.1e-07,0.00013,152,180,142,170,113,199,0.77,28,28,86
OceanDNA-b30139,2064,11.6,0.0,5.9e-06,0.015,70,188,27,156,12,211,0.77,118,129,199
OceanDNA-b9159,116,10.7,0.0,1.1e-05,0.0038,138,185,162,214,152,222,0.77,47,52,70
OceanDNA-b20906,284,14.6,0.3,7.5e-07,0.0032,85,173,120,219,111,289,0.77,88,99,178
OceanDNA-b15630,121,12.2,0.0,3.9e-06,0.0018,80,187,26,141,16,149,0.77,107,115,133
OceanDNA-b18640,271,1.8,0.0,0.012,1.8,148,172,108,134,92,149,0.77,24,26,57
OceanDNA-b40853,487,145.2,0.0,1.2e-46,9e-44,58,278,56,294,2,306,0.77,220,238,304
OceanDNA-b16514,942,7.3,0.0,0.00012,0.13,177,224,351,403,340,423,0.77,47,52,83
OceanDNA-b23367,1754,12.5,0.0,6.4e-06,0.0066,160,184,170,194,147,206,0.77,24,24,59
OceanDNA-b35120,288,14.1,0.0,1e-06,0.001,70,187,110,238,55,266,0.77,117,128,211
OceanDNA-b41521,1520,16.3,0.0,2.3e-07,0.00042,140,181,133,176,121,188,0.77,41,43,67
OceanDNA-b22926,1352,8.4,0.1,0.00011,0.26,144,177,178,211,167,231,0.77,33,33,64
OceanDNA-b15238,333,16.5,0.0,1.9e-07,7.4e-05,153,215,267,335,256,352,0.77,62,68,96
OceanDNA-b34576,1076,16.9,0.0,1.4e-07,0.00016,141,184,132,176,125,196,0.77,43,44,71
OceanDNA-b22806,2866,-3.1,0.0,0.52,810.0,121,155,122,159,121,162,0.77,34,37,41
OceanDNA-b35155,386,14.4,0.0,8.4e-07,0.0012,141,177,128,165,123,182,0.77,36,37,59
OceanDNA-b27523,751,20.9,0.0,1.8e-08,1.2e-05,84,175,116,215,106,224,0.77,91,99,118
OceanDNA-b22800,299,2.3,0.0,0.004,6.8,105,171,386,450,354,463,0.77,66,64,109
OceanDNA-b15138,937,15.2,0.2,4.6e-07,0.00051,61,122,8,69,1,152,0.77,61,61,151
OceanDNA-b35823,3637,10.9,0.1,2.9e-05,0.043,153,191,190,233,171,244,0.77,38,43,73
OceanDNA-b35333,154,12.7,0.0,2.8e-06,0.00093,191,265,239,313,227,314,0.77,74,74,87
OceanDNA-b22806,4603,12.9,0.0,7.5e-06,0.012,105,177,205,283,167,297,0.77,72,78,130
OceanDNA-b22490,1092,15.2,0.0,9.4e-07,0.0014,152,217,176,243,166,253,0.77,65,67,87
OceanDNA-b40265,482,27.0,0.0,2.5e-10,1.2e-07,85,170,160,256,151,261,0.77,85,96,110
OceanDNA-b23145,1394,-1.0,0.0,0.082,86.0,249,280,269,300,258,304,0.77,31,31,46
OceanDNA-b6704,841,12.1,0.0,4.2e-06,0.0036,85,211,104,239,60,254,0.77,126,135,194
OceanDNA-b3688,499,15.4,0.0,4e-07,0.00037,158,185,81,108,66,186,0.77,27,27,120
OceanDNA-b30938,1427,12.2,0.0,1.2e-05,0.0096,191,244,231,282,204,295,0.77,53,51,91
OceanDNA-b42278,58,14.3,0.0,9e-07,0.00019,84,175,65,160,54,165,0.77,91,95,111
OceanDNA-b4002,353,-0.9,0.0,0.039,52.0,32,72,470,513,452,528,0.77,40,43,76
OceanDNA-b40265,482,8.9,0.0,7.9e-05,0.038,181,245,299,368,292,374,0.77,64,69,82
OceanDNA-b20259,119,66.4,0.3,1.2e-22,3.8e-20,66,281,71,316,53,327,0.77,215,245,274
OceanDNA-b17160,71,14.6,0.0,7.1e-07,0.00013,141,207,282,352,270,372,0.77,66,70,102
OceanDNA-b24623,456,9.1,0.2,3.4e-05,0.022,160,205,105,154,81,177,0.77,45,49,96
OceanDNA-b4534,24,19.6,0.0,2.2e-08,9.3e-06,138,183,67,111,6,120,0.76,45,44,114
OceanDNA-b18639,160,0.9,0.0,0.022,4.5,85,120,140,175,91,183,0.76,35,35,92
OceanDNA-b46651,2931,25.2,0.0,8.7e-10,1.7e-06,154,245,216,311,200,326,0.76,91,95,126
OceanDNA-b13256,1037,35.7,0.0,1.4e-12,5.4e-10,53,247,215,428,206,436,0.76,194,213,230
OceanDNA-b36646,1282,13.2,0.1,1.9e-06,0.0039,55,189,14,153,5,179,0.76,134,139,174
OceanDNA-b31510,187,25.6,0.0,6.3e-10,3.5e-07,80,174,224,329,210,341,0.76,94,105,131
OceanDNA-b13249,71,21.2,0.1,1.4e-08,6.4e-06,135,213,49,131,5,165,0.76,78,82,160
OceanDNA-b23491,381,9.7,0.0,4.7e-05,0.042,161,188,149,176,43,213,0.76,27,27,170
OceanDNA-b3473,322,16.8,0.0,1.5e-07,0.00011,105,182,35,107,16,118,0.76,77,72,102
OceanDNA-b36709,945,15.5,0.0,3.8e-07,0.00065,71,186,55,170,41,208,0.76,115,115,167
OceanDNA-b37083,540,32.1,0.1,3.4e-12,2.3e-09,85,170,156,252,148,257,0.76,85,96,109
OceanDNA-b34951,634,11.6,0.0,6.1e-06,0.0045,198,264,178,240,165,242,0.76,66,62,77
OceanDNA-b40473,212,8.9,0.0,0.00012,0.042,109,183,143,213,126,232,0.76,74,70,106
OceanDNA-b46921,2201,23.8,0.0,3.6e-09,2.8e-06,135,185,436,481,420,495,0.76,50,45,75
OceanDNA-b32913,49,23.4,0.1,1.5e-09,2.9e-06,104,178,142,224,126,231,0.76,74,82,105
OceanDNA-b22995,475,16.0,0.6,5.3e-07,0.00056,55,171,367,486,361,492,0.76,116,119,131
OceanDNA-b6168,140,7.9,0.0,8.1e-05,0.047,206,270,196,258,177,275,0.76,64,62,98
OceanDNA-b9721,13,14.9,0.0,5.8e-07,0.00026,159,235,140,218,132,235,0.76,76,78,103
OceanDNA-b4061,892,11.0,0.0,9e-06,0.0081,97,212,114,239,74,244,0.76,115,125,170
OceanDNA-b26917,1026,1.0,0.0,0.021,16.0,197,258,266,323,260,327,0.76,61,57,67
OceanDNA-b22604,970,23.2,0.0,1.7e-09,2.2e-06,151,217,151,219,124,245,0.76,66,68,121
OceanDNA-b38369,851,10.0,0.0,3.6e-05,0.032,147,194,131,182,66,190,0.76,47,51,124
OceanDNA-b37076,208,6.1,0.0,0.00028,0.31,151,192,245,286,214,297,0.76,41,41,83
OceanDNA-b15979,255,-3.6,0.0,0.51,250.0,79,97,83,101,69,110,0.76,18,18,41
OceanDNA-b20782,423,-3.1,0.0,0.36,170.0,89,120,153,184,148,190,0.76,31,31,42
OceanDNA-b11244,330,16.8,0.0,1.5e-07,5.2e-05,153,196,203,247,191,320,0.76,43,44,129
OceanDNA-b15979,900,11.6,0.1,1.2e-05,0.0059,148,182,72,106,5,115,0.76,34,34,110
OceanDNA-b6846,218,-2.7,0.0,0.14,81.0,153,170,139,156,130,166,0.76,17,17,36
OceanDNA-b30640,51,10.9,0.0,1.9e-05,0.012,125,186,60,122,51,130,0.76,61,62,79
OceanDNA-b37592,1558,17.3,0.1,1.1e-07,0.00023,152,177,176,201,124,230,0.76,25,25,106
OceanDNA-b29589,161,5.0,0.0,0.0006,1.9,166,245,251,334,246,347,0.76,79,83,101
OceanDNA-b30640,386,12.9,0.1,4.9e-06,0.0031,149,183,88,120,32,134,0.76,34,32,102
OceanDNA-b36415,378,10.5,0.0,2.6e-05,0.02,148,189,110,151,5,158,0.76,41,41,153
OceanDNA-b23491,381,2.7,0.0,0.0062,5.6,227,267,257,298,225,324,0.76,40,41,99
OceanDNA-b28262,307,2.5,0.0,0.0036,1.8,160,189,86,114,75,131,0.76,29,28,56
OceanDNA-b22882,788,-1.7,0.0,0.069,290.0,144,176,609,641,566,652,0.76,32,32,86
OceanDNA-b29555,2035,9.0,0.2,3.8e-05,0.095,153,188,120,156,103,172,0.76,35,36,69
OceanDNA-b3951,745,17.8,0.0,7.7e-08,8.2e-05,146,210,43,108,29,135,0.76,64,65,106
OceanDNA-b22391,1470,12.6,0.0,6e-06,0.0056,152,194,195,238,161,267,0.76,42,43,106
OceanDNA-b19691,328,11.1,0.6,8.4e-06,0.0033,55,122,24,92,19,151,0.76,67,68,132
OceanDNA-b28083,1033,3.0,0.0,0.0049,4.2,228,266,219,258,187,263,0.76,38,39,76
OceanDNA-b30082,342,13.9,0.0,2.5e-06,0.0021,153,186,163,196,147,230,0.76,33,33,83
OceanDNA-b26571,13,26.6,0.0,3.3e-10,1.3e-07,140,185,133,180,126,198,0.76,45,47,72
OceanDNA-b15459,1164,6.8,0.0,0.00017,0.21,195,220,210,235,201,264,0.76,25,25,63
OceanDNA-b34551,738,8.7,0.0,9.3e-05,0.041,169,216,254,307,229,341,0.76,47,53,112
OceanDNA-b40768,338,17.4,0.0,2e-07,6.2e-05,140,189,143,195,135,214,0.76,49,52,79
OceanDNA-b33194,434,4.1,0.0,0.0011,1.2,199,247,271,320,261,325,0.76,48,49,64
OceanDNA-b2811,1320,8.7,0.0,4.6e-05,0.07,155,184,255,283,234,288,0.76,29,28,54
OceanDNA-b38495,572,3.6,0.0,0.005,1.4,193,245,266,318,250,324,0.76,52,52,74
OceanDNA-b22406,2419,13.8,0.0,6.2e-06,0.0036,152,189,446,484,408,518,0.76,37,38,110
OceanDNA-b35874,16,14.6,0.0,7.4e-07,0.00022,152,218,112,177,96,222,0.76,66,65,126
OceanDNA-b21507,90,1.9,0.0,0.0054,0.93,98,148,83,135,71,145,0.76,50,52,74
OceanDNA-b30787,852,12.3,0.1,3.7e-06,0.0037,79,185,30,142,16,146,0.76,106,112,130
OceanDNA-b44376,357,11.0,0.0,9e-06,0.0046,144,185,169,210,127,216,0.76,41,41,89
OceanDNA-b43907,104,0.6,0.0,0.028,4.8,195,245,236,292,226,330,0.76,50,56,104
OceanDNA-b22140,351,11.5,0.0,6.3e-06,0.0029,165,216,354,410,348,414,0.76,51,56,66
OceanDNA-b38692,169,13.4,0.0,1.7e-06,0.001,142,186,132,177,116,234,0.76,44,45,118
OceanDNA-b1424,555,12.2,0.0,7.9e-06,0.0031,145,195,594,648,539,654,0.76,50,54,115
OceanDNA-b20902,2959,-0.8,0.0,0.035,150.0,169,203,37,71,12,84,0.76,34,34,72
OceanDNA-b4058,514,17.4,0.0,1e-07,7.2e-05,101,212,117,238,84,245,0.76,111,121,161
OceanDNA-b7374,41,-2.2,0.0,0.094,30.0,43,74,309,339,301,341,0.76,31,30,40
OceanDNA-b34924,232,26.0,0.1,5e-10,2.5e-07,83,172,136,236,127,243,0.76,89,100,116
OceanDNA-b30043,702,16.1,0.1,2.6e-07,0.00051,128,185,75,132,64,143,0.76,57,57,79
OceanDNA-b40892,819,15.4,0.2,4.3e-07,0.00049,137,187,91,143,32,173,0.76,50,52,141
OceanDNA-b44627,133,10.0,0.0,3.6e-05,0.017,140,179,130,171,123,190,0.76,39,41,67
OceanDNA-b23944,1715,11.6,0.0,5.9e-06,0.01,208,271,202,263,183,273,0.76,63,61,90
OceanDNA-b38741,416,14.8,0.0,6.5e-07,0.00033,151,208,255,316,226,325,0.76,57,61,99
OceanDNA-b16133,287,15.3,0.0,1.4e-06,0.0005,157,245,370,458,359,462,0.76,88,88,103
OceanDNA-b33331,1087,54.1,0.1,1.3e-18,1.1e-15,95,272,207,402,189,420,0.76,177,195,231
OceanDNA-b36577,1192,18.2,0.1,1.2e-07,0.00011,46,190,4,154,1,206,0.76,144,150,205
OceanDNA-b43987,160,7.2,0.1,0.00026,0.028,127,175,36,86,29,90,0.76,48,50,61
OceanDNA-b41178,255,71.9,1.4,2.5e-24,5.4e-21,8,269,34,301,28,319,0.76,261,267,291
OceanDNA-b11479,73,10.9,0.0,9.7e-06,0.005,76,187,25,137,11,154,0.76,111,112,143
OceanDNA-b310,105,32.7,0.0,4.5e-12,3.3e-09,150,244,132,228,103,234,0.76,94,96,131
OceanDNA-b13249,460,16.0,2.5,5.6e-07,0.00026,71,215,130,274,124,346,0.76,144,144,222
OceanDNA-b40593,473,7.6,0.0,0.0001,0.052,180,230,125,181,109,199,0.76,50,56,90
OceanDNA-b36071,125,3.6,0.1,0.0034,3.5,199,266,198,263,164,268,0.76,67,65,104
OceanDNA-b305,2530,11.0,0.0,9.1e-06,0.034,189,260,332,402,325,409,0.76,71,70,84
OceanDNA-b11387,379,15.9,0.0,5.8e-07,0.00018,51,95,39,85,30,91,0.76,44,46,61
OceanDNA-b32031,516,8.7,0.0,4.7e-05,0.09,98,180,11,100,5,106,0.76,82,89,101
OceanDNA-b11343,100,10.7,0.0,1.1e-05,0.0051,138,191,154,210,130,245,0.76,53,56,115
OceanDNA-b8980,2,27.3,0.0,1e-10,2.8e-08,153,247,195,294,184,311,0.76,94,99,127
OceanDNA-b27536,721,9.2,0.0,3.1e-05,0.052,172,245,264,342,254,349,0.76,73,78,95
OceanDNA-b4022,184,26.5,0.0,3.5e-10,2.2e-07,83,175,137,241,114,244,0.76,92,104,130
OceanDNA-b22512,2235,15.3,0.0,8.8e-07,0.0011,155,224,134,210,117,230,0.76,69,76,113
OceanDNA-b40444,376,25.0,0.1,1.5e-09,9e-07,83,172,144,244,130,249,0.76,89,100,119
OceanDNA-b1588,529,1.6,0.0,0.0065,5.2,196,222,227,253,207,287,0.76,26,26,80
OceanDNA-b44744,465,0.7,0.0,0.012,9.9,181,214,188,223,183,243,0.76,33,35,60
OceanDNA-b18796,201,20.3,0.0,1.4e-08,3.8e-06,141,191,283,337,256,396,0.76,50,54,140
OceanDNA-b32974,1907,13.6,0.0,3e-06,0.0046,159,184,156,181,132,191,0.76,25,25,59
OceanDNA-b30226,1919,-2.7,0.0,0.14,340.0,193,220,243,270,226,273,0.76,27,27,47
OceanDNA-b510,1351,0.0,0.0,0.04,43.0,198,243,248,290,239,302,0.76,45,42,63
OceanDNA-b23093,1592,36.0,0.1,6.7e-13,1.4e-09,93,240,87,245,29,282,0.76,147,158,253
OceanDNA-b30487,2596,18.3,0.3,1.1e-07,0.00016,86,184,75,181,58,193,0.76,98,106,135
OceanDNA-b40442,251,9.8,0.1,4.1e-05,0.04,93,179,29,109,16,118,0.76,86,80,102
OceanDNA-b22759,156,18.8,0.1,4e-08,4e-05,152,218,159,227,139,256,0.76,66,68,117
OceanDNA-b22322,1513,-0.5,0.1,0.06,120.0,7,53,30,77,25,83,0.76,46,47,58
OceanDNA-b30042,1923,5.0,0.1,0.0013,2.2,141,222,64,146,50,157,0.76,81,82,107
OceanDNA-b46897,281,2.2,0.0,0.0043,3.7,199,262,252,313,242,316,0.76,63,61,74
OceanDNA-b46513,458,14.8,0.0,6.2e-07,0.00036,135,218,114,196,102,205,0.76,83,82,103
OceanDNA-b30852,157,-1.0,0.0,0.082,81.0,231,267,230,267,205,271,0.76,36,37,66
OceanDNA-b13088,539,1.3,0.0,0.0083,31.0,147,190,522,565,476,583,0.76,43,43,107
OceanDNA-b35229,353,14.4,0.0,8.1e-07,0.00057,80,186,199,305,172,354,0.76,106,106,182
OceanDNA-b35901,408,17.1,0.0,2.6e-07,7.5e-05,67,189,27,155,15,172,0.76,122,128,157
OceanDNA-b19307,78,16.8,0.0,1.5e-07,4.2e-05,152,189,357,395,332,448,0.76,37,38,116
OceanDNA-b23909,1854,13.4,0.0,3.4e-06,0.0033,195,232,274,310,265,335,0.76,37,36,70
OceanDNA-b1353,3339,10.1,0.0,3.3e-05,0.065,137,191,167,226,156,240,0.76,54,59,84
OceanDNA-b20495,104,68.7,0.5,2.4e-23,5.1e-21,68,271,85,313,55,326,0.76,203,228,271
OceanDNA-b23169,959,0.9,0.0,0.022,25.0,104,121,145,162,125,170,0.76,17,17,45
OceanDNA-b30854,1685,8.2,0.0,0.00013,0.14,174,244,228,300,219,315,0.76,70,72,96
OceanDNA-b30953,299,11.6,0.0,6.1e-06,0.017,140,178,126,166,114,192,0.76,38,40,78
OceanDNA-b30001,346,14.9,0.0,1.2e-06,0.00094,89,179,120,217,85,228,0.76,90,97,143
OceanDNA-b20044,310,48.8,0.1,2.8e-17,1.1e-14,72,281,105,341,82,349,0.76,209,236,267
OceanDNA-b16098,320,7.3,0.0,0.00025,0.096,194,245,423,473,397,524,0.76,51,50,127
OceanDNA-b17331,550,13.2,0.1,1.9e-06,0.0018,142,184,162,204,129,211,0.76,42,42,82
OceanDNA-b23624,2259,18.1,0.0,1.3e-07,0.00014,107,214,129,246,110,294,0.76,107,117,184
OceanDNA-b37525,354,34.2,0.1,8e-13,1.8e-09,75,230,82,258,76,271,0.76,155,176,195
OceanDNA-b14467,90,-1.1,0.0,0.045,11.0,199,230,243,273,235,278,0.76,31,30,43
OceanDNA-b15515,1821,23.3,0.0,1.6e-09,3.2e-06,106,212,121,240,117,248,0.76,106,119,131
OceanDNA-b29,3447,13.2,0.0,7.7e-06,0.0098,153,238,82,173,63,189,0.76,85,91,126
OceanDNA-b6778,256,-0.3,0.0,0.025,15.0,153,175,142,164,127,176,0.76,22,22,49
OceanDNA-b23139,799,28.2,0.0,1e-10,1.2e-07,153,192,164,204,148,260,0.76,39,40,112
OceanDNA-b46199,612,12.8,0.0,8e-06,0.004,108,182,570,652,557,661,0.76,74,82,104
OceanDNA-b16517,491,4.9,0.0,0.00064,0.57,173,218,345,394,331,422,0.76,45,49,91
OceanDNA-b11352,456,5.6,0.0,0.00041,0.26,197,264,198,263,188,269,0.76,67,65,81
OceanDNA-b22997,222,-3.0,0.0,0.52,170.0,266,280,415,429,406,433,0.76,14,14,27
OceanDNA-b17638,663,23.3,0.0,1.7e-09,1.2e-06,153,227,186,265,174,298,0.76,74,79,124
OceanDNA-b20043,202,-1.2,0.0,0.096,16.0,22,67,32,77,18,90,0.76,45,45,72
OceanDNA-b35291,674,16.2,0.0,2.4e-07,0.00038,152,245,136,234,106,251,0.76,93,98,145
OceanDNA-b6561,331,10.6,0.0,2.4e-05,0.016,88,212,109,242,86,263,0.76,124,133,177
OceanDNA-b27525,1050,22.0,0.1,1.7e-08,1.1e-05,89,173,207,302,202,317,0.76,84,95,115
OceanDNA-b15118,491,11.2,0.0,7.7e-06,0.005,105,186,85,181,35,198,0.76,81,96,163
OceanDNA-b26937,190,14.9,0.0,1.1e-06,0.00013,155,256,127,235,111,240,0.76,101,108,129
OceanDNA-b23379,895,-2.9,0.0,0.31,360.0,198,220,418,440,413,478,0.76,22,22,65
OceanDNA-b26937,161,11.1,0.0,1.7e-05,0.002,149,181,223,255,186,279,0.76,32,32,93
OceanDNA-b22012,141,11.6,0.0,5.9e-06,0.0018,75,173,58,160,51,176,0.76,98,102,125
OceanDNA-b14740,185,13.6,0.0,1.4e-06,0.00038,123,197,79,154,69,165,0.76,74,75,96
OceanDNA-b22991,4364,10.2,0.1,1.6e-05,0.072,104,185,73,153,59,170,0.76,81,80,111
OceanDNA-b30031,2048,4.0,0.0,0.0025,2.8,157,185,66,94,50,133,0.76,28,28,83
OceanDNA-b41301,4116,10.8,0.0,3.2e-05,0.053,158,180,141,163,116,178,0.76,22,22,62
OceanDNA-b22998,423,10.2,0.0,1.6e-05,0.016,139,193,326,380,317,391,0.76,54,54,74
OceanDNA-b41337,73,14.5,0.0,8e-07,0.0014,140,181,122,164,116,186,0.76,41,42,70
OceanDNA-b6298,94,18.6,0.0,8.6e-08,1.8e-05,77,212,93,239,80,275,0.76,135,146,195
OceanDNA-b42522,68,6.0,0.0,0.0006,0.094,154,180,129,155,107,165,0.76,26,26,58
OceanDNA-b28563,1394,12.7,0.0,2.7e-06,0.0058,152,179,142,169,125,187,0.76,27,27,62
OceanDNA-b23273,1319,12.1,0.1,4.3e-06,0.0094,157,187,229,259,209,263,0.76,30,30,54
OceanDNA-b19592,319,19.6,0.1,2.2e-08,8.3e-06,86,177,75,171,63,183,0.76,91,96,120
OceanDNA-b6674,104,12.5,0.0,6.5e-06,0.0021,152,233,154,236,137,274,0.76,81,82,137
OceanDNA-b37161,189,14.3,0.1,9e-07,0.00098,107,183,51,124,32,136,0.76,76,73,104
OceanDNA-b22460,1842,13.2,0.1,3.9e-06,0.0067,149,211,715,782,673,792,0.76,62,67,119
OceanDNA-b35901,22,5.4,0.0,0.00094,0.28,133,177,76,121,54,135,0.76,44,45,81
OceanDNA-b16125,732,8.7,0.0,4.5e-05,0.034,174,245,383,457,376,461,0.76,71,74,85
OceanDNA-b29482,1279,1.3,0.0,0.008,25.0,180,245,251,320,236,326,0.76,65,69,90
OceanDNA-b36703,499,15.5,0.0,3.9e-07,0.0004,137,180,131,175,118,190,0.76,43,44,72
OceanDNA-b27622,294,14.1,0.1,1.1e-06,0.00082,105,196,85,179,64,204,0.76,91,94,140
OceanDNA-b36650,251,13.3,0.0,1.8e-06,0.00063,157,184,140,167,111,183,0.76,27,27,72
OceanDNA-b37510,398,6.1,0.0,0.00056,0.45,97,127,78,106,68,135,0.76,30,28,67
OceanDNA-b40920,808,24.9,1.5,1.1e-09,6.6e-07,75,244,101,286,18,289,0.76,169,185,271
OceanDNA-b33307,615,7.8,0.0,8.7e-05,0.28,198,267,231,298,222,301,0.76,69,67,79
OceanDNA-b21018,732,2.4,0.0,0.0037,12.0,189,221,241,272,232,298,0.76,32,31,66
OceanDNA-b46391,78,10.5,0.0,1.3e-05,0.034,131,190,145,205,126,234,0.76,59,60,108
OceanDNA-a842,279,11.7,0.0,1.1e-05,0.002,103,187,50,143,10,150,0.76,84,93,140
OceanDNA-b38527,545,0.8,0.0,0.011,7.6,183,221,195,233,176,238,0.76,38,38,62
OceanDNA-b31170,1207,7.3,0.0,0.00012,0.15,197,269,161,233,153,256,0.76,72,72,103
OceanDNA-b6558,89,14.1,0.0,2.1e-06,0.0011,150,216,134,203,121,214,0.76,66,69,93
OceanDNA-b9724,486,10.3,0.2,1.5e-05,0.0072,191,243,213,262,195,279,0.76,52,49,84
OceanDNA-b20098,139,51.4,0.9,9.2e-18,1.1e-15,71,279,84,326,63,335,0.76,208,242,272
OceanDNA-b27565,2096,14.8,0.1,6.2e-07,0.0015,150,186,72,108,54,173,0.76,36,36,119
OceanDNA-b22382,1397,11.1,0.0,1.7e-05,0.033,136,187,486,536,456,569,0.76,51,50,113
OceanDNA-b26879,966,-1.8,0.0,0.075,260.0,190,212,212,234,203,271,0.76,22,22,68
OceanDNA-b13585,820,-2.8,0.0,0.58,220.0,202,223,180,200,175,213,0.76,21,20,38
OceanDNA-b35180,16,11.1,0.0,8.8e-06,0.0063,140,180,127,168,114,194,0.76,40,41,80
OceanDNA-b20981,2855,10.1,0.0,1.7e-05,0.059,137,181,170,214,141,256,0.76,44,44,115
OceanDNA-b16121,452,6.4,0.0,0.00022,0.17,194,220,429,455,400,479,0.76,26,26,79
OceanDNA-b45502,684,23.7,0.0,1.3e-09,1.6e-06,151,243,163,269,148,276,0.76,92,106,128
OceanDNA-b19590,449,27.6,0.0,8.2e-11,3.8e-08,149,224,125,202,114,234,0.76,75,77,120
OceanDNA-b16213,512,13.6,0.1,1.5e-06,0.0012,177,245,430,501,423,508,0.76,68,71,85
OceanDNA-b24623,456,3.9,0.0,0.0013,0.82,195,265,185,253,177,261,0.76,70,68,84
OceanDNA-b20991,229,13.2,0.1,3.8e-06,0.0036,91,168,181,269,172,282,0.76,77,88,110
OceanDNA-b5857,282,0.1,0.0,0.019,8.2,153,169,139,155,122,172,0.76,16,16,50
OceanDNA-b23003,1384,14.7,1.1,2.8e-06,0.0017,42,175,283,423,278,457,0.76,133,140,179
OceanDNA-b31431,792,10.4,0.0,1.3e-05,0.027,52,103,517,570,467,585,0.76,51,53,118
OceanDNA-b46916,4169,11.1,0.0,1.7e-05,0.046,149,190,165,207,138,235,0.76,41,42,97
OceanDNA-b41223,916,11.9,0.0,4.9e-06,0.0099,122,209,114,201,40,242,0.76,87,87,202
OceanDNA-b4252,269,9.4,0.0,2.7e-05,0.068,154,196,70,110,59,139,0.76,42,40,80
OceanDNA-b5580,87,21.4,0.0,1.2e-08,2.9e-06,153,221,148,218,124,263,0.76,68,70,139
OceanDNA-b37023,40,15.4,0.0,8.2e-07,0.00031,78,183,133,243,96,260,0.76,105,110,164
OceanDNA-b32059,1567,22.9,0.1,2.2e-09,5e-06,89,187,121,228,53,267,0.76,98,107,214
OceanDNA-b12220,283,38.3,0.0,4.4e-14,1.8e-11,144,245,26,139,13,153,0.76,101,113,140
OceanDNA-b17033,596,-2.8,0.0,0.3,230.0,190,214,211,235,204,248,0.76,24,24,44
OceanDNA-b11963,1108,-1.2,0.0,0.049,94.0,255,268,320,333,305,350,0.76,13,13,45
OceanDNA-b3425,433,12.1,0.0,4.3e-06,0.0033,151,192,194,238,180,250,0.76,41,44,70
OceanDNA-b20972,2572,31.1,0.1,7e-12,2e-08,76,175,76,181,55,186,0.76,99,105,131
OceanDNA-b17424,1206,-2.3,0.0,0.21,190.0,212,225,299,312,290,326,0.76,13,13,36
OceanDNA-b280,1608,11.1,0.0,8.7e-06,0.027,104,215,68,189,38,222,0.76,111,121,184
OceanDNA-b30073,1107,4.2,0.0,0.0011,2.4,155,191,136,177,124,196,0.76,36,41,72
OceanDNA-b40047,199,11.3,0.0,7.5e-06,0.0019,94,178,29,107,17,141,0.76,84,78,124
OceanDNA-b5721,663,3.1,0.0,0.0023,2.4,153,173,159,179,139,193,0.76,20,20,54
OceanDNA-b35314,474,20.3,0.0,1.4e-08,1.4e-05,82,187,28,148,14,153,0.76,105,120,139
OceanDNA-b23841,627,13.9,0.0,1.2e-06,0.00095,107,192,179,273,163,281,0.76,85,94,118
OceanDNA-b40634,443,12.3,0.0,7.5e-06,0.0031,111,185,47,117,29,134,0.76,74,70,105
OceanDNA-b23003,1321,15.4,0.4,1.7e-06,0.001,27,71,61,108,37,120,0.76,44,47,83
OceanDNA-b23559,253,14.4,0.0,8.3e-07,0.0013,133,182,127,173,59,184,0.76,49,46,125
OceanDNA-b17633,332,9.8,0.0,2.1e-05,0.016,193,248,235,285,224,302,0.76,55,50,78
OceanDNA-b36732,2751,23.7,0.4,1.2e-09,4.2e-06,87,175,152,250,144,253,0.76,88,98,109
OceanDNA-b35823,1092,12.2,0.0,1.2e-05,0.018,68,191,14,143,4,155,0.75,123,129,151
OceanDNA-b1522,281,2.5,0.0,0.011,3.5,191,254,237,297,222,300,0.75,63,60,78
OceanDNA-b31969,612,15.2,0.0,4.8e-07,0.00069,105,189,184,266,167,281,0.75,84,82,114
OceanDNA-b30938,2151,1.5,0.0,0.021,17.0,191,245,255,309,232,321,0.75,54,54,89
OceanDNA-b36151,655,19.1,0.1,6.4e-08,7.1e-05,75,182,54,162,29,169,0.75,107,108,140
OceanDNA-b13288,867,43.8,0.1,9.4e-16,1e-12,82,225,274,437,271,457,0.75,143,163,186
OceanDNA-b22423,1899,16.8,0.0,3.2e-07,0.00037,152,216,130,198,115,217,0.75,64,68,102
OceanDNA-b3653,1280,6.1,0.0,0.0011,0.65,161,223,123,184,69,191,0.75,62,61,122
OceanDNA-b40613,659,143.5,0.3,7.9e-46,3e-43,16,275,38,317,19,332,0.75,259,279,313
OceanDNA-b1991,34,17.5,0.0,9.7e-08,5.8e-05,75,177,52,159,35,170,0.75,102,107,135
OceanDNA-b23271,540,10.6,0.0,1.2e-05,0.03,106,182,89,167,81,184,0.75,76,78,103
OceanDNA-b45372,298,11.1,0.0,8.4e-06,0.0065,153,216,131,196,115,206,0.75,63,65,91
OceanDNA-b15892,186,-4.1,0.1,0.37,110.0,202,215,204,217,201,228,0.75,13,13,27
OceanDNA-b45271,128,14.0,0.0,2.3e-06,0.00056,90,179,168,260,148,279,0.75,89,92,131
OceanDNA-b30938,1023,12.1,0.0,1.2e-05,0.01,93,212,111,240,70,290,0.75,119,129,220
OceanDNA-b20096,228,14.5,0.1,7.7e-07,0.00024,89,174,102,192,88,198,0.75,85,90,110
OceanDNA-b21004,811,2.8,0.0,0.0084,5.4,194,219,155,180,125,189,0.75,25,25,64
OceanDNA-b36151,881,13.9,0.0,2.5e-06,0.0027,109,203,99,190,86,217,0.75,94,91,131
OceanDNA-b6750,437,10.6,0.0,3.7e-05,0.0091,198,267,135,202,124,221,0.75,69,67,97
OceanDNA-b11514,128,12.2,0.0,3.9e-06,0.001,153,232,133,212,108,245,0.75,79,79,137
OceanDNA-b23104,1060,28.6,0.0,8e-11,1.6e-07,45,174,568,702,563,708,0.75,129,134,145
OceanDNA-b30857,1356,11.4,0.0,7e-06,0.019,140,180,128,169,119,190,0.75,40,41,71
OceanDNA-b26935,170,18.1,0.0,6.2e-08,1.6e-05,77,193,156,277,153,290,0.75,116,121,137
OceanDNA-b20129,312,30.4,0.0,1.2e-11,4.1e-09,152,243,137,238,94,248,0.75,91,101,154
OceanDNA-b37083,540,6.4,0.0,0.00023,0.16,181,245,295,364,288,370,0.75,64,69,82
OceanDNA-b20811,373,10.5,0.0,1.3e-05,0.01,125,183,44,103,18,118,0.75,58,59,100
OceanDNA-b41014,1220,9.7,0.2,6.9e-05,0.05,156,191,91,130,75,139,0.75,35,39,64
OceanDNA-b7584,366,-2.8,0.0,0.14,54.0,42,62,83,103,70,121,0.75,20,20,51
OceanDNA-b15801,1289,19.2,0.1,2.8e-08,4.2e-05,149,205,107,163,24,175,0.75,56,56,151
OceanDNA-b23047,344,38.1,0.0,4.9e-14,3.9e-11,98,246,87,249,26,257,0.75,148,162,231
OceanDNA-b6574,177,18.0,0.0,1.3e-07,5.9e-05,78,209,118,260,97,267,0.75,131,142,170
OceanDNA-b40453,184,11.6,0.0,6.2e-06,0.0074,177,229,275,333,271,352,0.75,52,58,81
OceanDNA-b22823,1208,10.6,0.0,1.2e-05,0.05,154,215,105,165,78,174,0.75,61,60,96
OceanDNA-b24311,1044,10.1,0.0,1.8e-05,0.061,154,192,241,281,214,292,0.75,38,40,78
OceanDNA-b7194,42,17.3,0.0,3.3e-07,9.3e-05,88,212,112,246,63,268,0.75,124,134,205
OceanDNA-b20705,111,17.3,0.0,1.1e-07,2.6e-05,201,270,240,313,234,331,0.75,69,73,97
OceanDNA-b24879,1546,11.6,0.0,1.2e-05,0.011,145,179,110,144,94,222,0.75,34,34,128
OceanDNA-b41496,132,8.4,1.0,5.5e-05,0.1,104,130,173,198,166,289,0.75,26,25,123
OceanDNA-b19697,279,17.4,0.0,1e-07,3.5e-05,146,207,294,359,265,363,0.75,61,65,98
OceanDNA-b47087,1306,11.0,0.0,1.8e-05,0.025,153,189,240,277,221,315,0.75,36,37,94
OceanDNA-b23143,876,-2.5,0.0,0.24,330.0,107,120,172,185,157,199,0.75,13,13,42
OceanDNA-b24608,76,6.1,0.0,0.00028,0.15,149,177,142,170,98,175,0.75,28,28,77
OceanDNA-b20910,5024,19.8,0.7,1.9e-08,0.00016,72,170,36,144,14,154,0.75,98,108,140
OceanDNA-b24045,2236,2.3,0.0,0.0042,11.0,145,192,131,176,126,208,0.75,47,45,82
OceanDNA-b23143,876,-0.7,0.0,0.068,92.0,243,279,346,383,340,390,0.75,36,37,50
OceanDNA-b20056,324,53.3,0.0,2.4e-18,4.7e-16,72,280,78,313,56,322,0.75,208,235,266
OceanDNA-b4056,546,10.5,0.0,1.3e-05,0.0074,101,208,119,236,77,276,0.75,107,117,199
OceanDNA-b40066,15,11.3,0.0,7.2e-06,0.0019,94,178,29,107,17,137,0.75,84,78,120
OceanDNA-b22607,683,19.1,0.0,9.6e-08,2.9e-05,152,216,152,218,131,245,0.75,64,66,114
OceanDNA-b15967,1133,15.4,0.1,4e-07,0.00074,89,217,39,177,7,206,0.75,128,138,199
OceanDNA-b9718,79,13.8,0.0,1.3e-06,0.00066,160,236,123,201,115,216,0.75,76,78,101
OceanDNA-b20782,503,11.7,0.0,1.1e-05,0.0054,87,184,35,134,23,142,0.75,97,99,119
OceanDNA-b29532,1267,12.3,0.0,3.6e-06,0.011,89,185,241,336,207,341,0.75,96,95,134
OceanDNA-b25927,19,9.9,0.0,1.9e-05,0.0062,150,181,215,248,182,271,0.75,31,33,89
OceanDNA-b22423,1643,15.1,0.0,1e-06,0.0012,148,185,198,235,155,272,0.75,37,37,117
OceanDNA-b36889,1742,13.0,0.1,2.3e-06,0.0059,89,177,79,172,65,216,0.75,88,93,151
OceanDNA-b41055,278,13.0,0.0,4.4e-06,0.0048,128,181,126,177,119,195,0.75,53,51,76
OceanDNA-b43873,508,22.9,2.7,2.2e-09,2.6e-06,72,269,70,262,11,280,0.75,197,192,269
OceanDNA-b2517,40,12.2,0.3,3.9e-06,0.0073,94,183,107,194,101,202,0.75,89,87,101
OceanDNA-b13295,2627,17.8,0.3,7.8e-08,0.00021,80,174,101,209,66,217,0.75,94,108,151
OceanDNA-b12109,280,13.8,0.0,1.3e-06,0.00052,107,192,27,119,9,133,0.75,85,92,124
OceanDNA-b23905,603,6.0,0.3,0.0003,0.41,186,231,258,305,247,331,0.75,45,47,84
OceanDNA-b35132,707,10.3,0.1,1.5e-05,0.016,152,215,214,287,139,308,0.75,63,73,169
OceanDNA-b33048,1451,10.5,0.0,2.6e-05,0.047,136,187,102,147,57,156,0.75,51,45,99
OceanDNA-b9243,342,17.6,0.0,9.2e-08,3.2e-05,151,194,147,191,129,242,0.75,43,44,113
OceanDNA-b36733,557,11.6,0.0,1.2e-05,0.012,152,184,144,176,90,186,0.75,32,32,96
OceanDNA-b40629,357,2.9,0.0,0.0027,1.7,198,261,219,278,181,280,0.75,63,59,99
OceanDNA-b32084,1484,13.4,0.1,3.3e-06,0.0055,131,173,253,292,246,307,0.75,42,39,61
OceanDNA-b3655,555,10.6,0.0,2.4e-05,0.0091,153,244,144,237,137,251,0.75,91,93,114
OceanDNA-b20036,199,-2.9,0.0,0.47,60.0,127,150,353,375,339,377,0.75,23,22,38
OceanDNA-b46559,174,12.4,0.0,3.5e-06,0.0029,145,186,119,160,95,184,0.75,41,41,89
OceanDNA-b18804,177,21.6,0.0,5.4e-09,1.7e-06,151,217,154,222,125,248,0.75,66,68,123
OceanDNA-b30769,950,10.6,0.0,1.2e-05,0.023,159,219,105,168,76,196,0.75,60,63,120
OceanDNA-b34562,134,2.5,0.0,0.0037,2.6,193,234,292,333,256,353,0.75,41,41,97
OceanDNA-b4498,1017,27.2,0.0,3.1e-10,1.1e-07,84,176,154,257,147,267,0.75,92,103,120
OceanDNA-b27549,1961,2.6,0.0,0.0066,7.1,198,264,189,253,181,256,0.75,66,64,75
OceanDNA-b29510,1279,17.0,0.1,2.7e-07,0.00034,80,178,126,231,107,237,0.75,98,105,130
OceanDNA-b7208,478,10.5,0.0,1.3e-05,0.0091,195,249,212,261,190,276,0.75,54,49,86
OceanDNA-b22386,1896,12.6,0.0,1.2e-05,0.0061,155,188,48,82,34,134,0.75,33,34,100
OceanDNA-b30427,1668,-1.7,0.0,0.13,140.0,109,143,135,170,117,175,0.75,34,35,58
OceanDNA-b40912,147,6.3,0.0,0.00024,0.22,181,245,266,335,260,341,0.75,64,69,81
OceanDNA-b22650,1574,8.2,0.1,0.00013,0.16,159,185,136,165,125,181,0.75,26,29,56
OceanDNA-b45519,118,21.7,0.0,4.9e-09,5.9e-06,135,189,192,246,174,301,0.75,54,54,127
OceanDNA-b46310,870,11.4,0.0,6.9e-06,0.011,154,184,1,31,1,80,0.75,30,30,79
OceanDNA-b12519,196,33.5,0.0,1.3e-12,4.2e-10,150,240,130,224,114,239,0.75,90,94,125
OceanDNA-b22449,551,17.2,0.0,2.4e-07,0.00019,153,216,85,152,74,159,0.75,63,67,85
OceanDNA-b10079,394,22.6,0.0,2.7e-09,2.3e-06,148,189,176,218,162,254,0.75,41,42,92
OceanDNA-a2655,499,9.9,0.1,1.9e-05,0.012,152,188,126,166,109,173,0.75,36,40,64
OceanDNA-b23839,428,14.3,0.0,1.8e-06,0.00096,154,181,242,269,222,287,0.75,27,27,65
OceanDNA-b23850,1049,0.7,0.0,0.038,19.0,184,220,224,258,214,265,0.75,36,34,51
OceanDNA-b30427,1176,3.6,0.0,0.0032,3.4,156,188,132,164,113,208,0.75,32,32,95
OceanDNA-b22397,543,13.0,0.0,8.8e-06,0.0058,145,185,128,169,101,184,0.75,40,41,83
OceanDNA-b44168,3,-0.9,0.0,0.038,20.0,197,230,203,235,191,254,0.75,33,32,63
OceanDNA-b34892,191,37.5,0.6,1.6e-13,7.2e-11,82,172,166,270,133,275,0.75,90,104,142
OceanDNA-b30427,1176,11.6,0.1,1.2e-05,0.012,174,231,229,292,218,307,0.75,57,63,89
OceanDNA-b1657,494,12.2,0.1,7.9e-06,0.0032,105,178,74,145,53,169,0.75,73,71,116
OceanDNA-b38548,512,14.9,0.0,6.1e-07,0.00038,83,187,29,138,17,155,0.75,104,109,138
OceanDNA-b13250,1533,19.7,0.5,1.8e-07,8.3e-05,71,228,80,238,76,284,0.75,157,158,208
OceanDNA-b20097,208,35.5,0.0,6.4e-13,9.5e-11,154,243,161,260,139,270,0.75,89,99,131
OceanDNA-b15453,1335,26.8,0.0,2.8e-10,3.1e-07,106,212,133,252,129,264,0.75,106,119,135
OceanDNA-b34942,321,-0.8,0.0,0.036,21.0,143,176,51,84,30,98,0.75,33,33,68
OceanDNA-b18639,90,55.5,1.7,5e-19,1e-16,66,281,97,339,79,352,0.75,215,242,273
OceanDNA-b27525,756,7.7,0.1,0.00038,0.25,161,197,178,218,120,251,0.75,36,40,131
OceanDNA-b23372,240,10.5,0.3,1.3e-05,0.03,97,181,98,180,92,191,0.75,84,82,99
OceanDNA-b23515,947,8.4,0.0,5.7e-05,0.071,197,262,202,268,196,271,0.75,65,66,75
OceanDNA-b22687,325,23.4,0.1,1.5e-09,1.5e-06,152,219,147,216,127,245,0.75,67,69,118
OceanDNA-b31421,2275,12.2,0.1,4e-06,0.014,100,176,106,178,97,193,0.75,76,72,96
OceanDNA-b31510,971,12.6,0.0,6.1e-06,0.0034,194,253,568,627,564,647,0.75,59,59,83
OceanDNA-b3631,550,8.2,0.0,6.5e-05,0.066,201,266,196,259,181,268,0.75,65,63,87
OceanDNA-b37060,975,10.7,0.0,1.2e-05,0.012,146,186,174,216,128,228,0.75,40,42,100
OceanDNA-b31510,187,1.7,0.0,0.013,7.0,180,230,367,423,348,448,0.75,50,56,100
OceanDNA-b36740,366,11.1,0.0,8.6e-06,0.0047,145,185,122,163,111,190,0.75,40,41,79
OceanDNA-b37054,2027,15.0,0.0,1.1e-06,0.0017,142,181,126,167,116,186,0.75,39,41,70
OceanDNA-b17318,494,21.3,0.0,1.3e-08,1.6e-05,154,227,406,480,400,505,0.75,73,74,105
OceanDNA-b45634,653,4.0,0.0,0.0024,0.88,157,176,16,36,5,58,0.75,19,20,53
OceanDNA-b22849,1144,13.2,0.0,5.7e-06,0.0038,139,186,204,251,164,280,0.75,47,47,116
OceanDNA-b3983,449,-3.3,0.0,0.62,220.0,75,104,305,333,296,334,0.75,29,28,38
OceanDNA-b6493,506,15.6,0.0,3.7e-07,0.00028,73,212,88,242,76,292,0.75,139,154,216
OceanDNA-b17084,129,11.6,0.0,5.9e-06,0.0064,149,222,172,245,149,250,0.75,73,73,101
OceanDNA-b3673,1776,7.7,0.1,9.2e-05,0.21,160,223,30,99,14,119,0.75,63,69,105
OceanDNA-b46204,227,17.2,0.0,1.1e-07,0.00013,153,217,137,208,121,220,0.75,64,71,99
OceanDNA-b26893,2504,14.8,0.0,1.2e-06,0.0021,154,189,154,190,135,215,0.75,35,36,80
OceanDNA-b46728,1025,15.2,0.0,1.4e-06,0.00078,155,189,5,40,1,103,0.75,34,35,102
OceanDNA-b26748,560,10.5,0.1,1.3e-05,0.03,138,193,72,130,51,141,0.75,55,58,90
OceanDNA-b26051,249,18.1,0.0,6.4e-08,2.3e-05,153,181,18,46,2,76,0.75,28,28,74
OceanDNA-b22393,1546,14.9,0.0,1.2e-06,0.00092,133,185,5,53,2,67,0.75,52,48,65
OceanDNA-b22393,660,-1.9,0.0,0.16,120.0,101,122,131,152,122,154,0.75,21,21,32
OceanDNA-b41176,1182,45.6,0.2,2.6e-16,5.8e-13,88,272,104,288,18,307,0.75,184,184,289
OceanDNA-b16227,471,5.2,0.0,0.0016,0.56,135,183,369,418,360,423,0.75,48,49,63
OceanDNA-b30842,113,0.0,0.0,0.02,11.0,110,145,78,115,59,134,0.75,35,37,75
OceanDNA-b19665,86,18.2,0.0,5.8e-08,2.7e-05,126,192,290,360,284,385,0.75,66,70,101
OceanDNA-b12642,408,-1.5,0.0,0.057,34.0,195,213,201,219,196,229,0.75,18,18,33
OceanDNA-b41456,66,33.6,0.0,1.2e-12,1.2e-09,92,231,110,268,105,283,0.75,139,158,178
OceanDNA-b21040,270,35.1,0.3,1.3e-12,2e-09,87,187,18,122,7,132,0.75,100,104,125
OceanDNA-b42533,111,14.6,0.0,7.1e-07,0.00016,96,172,59,133,27,139,0.75,76,74,112
OceanDNA-b17223,1768,12.6,0.0,6e-06,0.0081,154,224,409,480,364,486,0.75,70,71,122
OceanDNA-b30046,2482,4.6,0.2,0.0016,2.4,139,177,51,88,24,100,0.75,38,37,76
OceanDNA-b45622,631,20.6,0.0,1.1e-08,7.9e-06,151,194,32,76,9,127,0.75,43,44,118
OceanDNA-b26823,1130,22.8,0.1,2.3e-09,8.7e-06,83,172,126,226,119,232,0.75,89,100,113
OceanDNA-b40257,356,14.0,0.1,1.1e-06,0.0009,50,179,68,218,62,227,0.75,129,150,165
OceanDNA-b30917,1286,15.3,0.0,4.4e-07,0.00097,87,181,61,163,36,171,0.75,94,102,135
OceanDNA-b13623,278,11.3,0.0,7.3e-06,0.0026,109,232,89,217,71,227,0.75,123,128,156
OceanDNA-b16161,577,19.4,0.0,2.5e-08,2e-05,77,171,42,147,32,153,0.75,94,105,121
OceanDNA-b46917,94,13.9,0.0,1.2e-06,0.002,128,186,106,163,93,179,0.75,58,57,86
OceanDNA-b16209,599,10.5,0.0,2.6e-05,0.016,154,246,105,197,91,204,0.75,92,92,113
OceanDNA-b23399,1369,-0.6,0.0,0.031,72.0,173,217,173,217,164,222,0.75,44,44,58
OceanDNA-b38527,545,9.0,0.0,3.6e-05,0.024,143,187,63,106,45,124,0.75,44,43,79
OceanDNA-b16147,423,12.8,0.0,5.3e-06,0.0018,77,180,228,350,225,354,0.75,103,122,129
OceanDNA-b13073,695,10.3,0.0,1.5e-05,0.014,89,181,183,273,169,292,0.75,92,90,123
OceanDNA-b3626,407,10.5,0.0,1.2e-05,0.016,148,191,98,149,80,216,0.75,43,51,136
OceanDNA-b13250,4012,37.3,0.5,8.2e-13,3.7e-10,105,225,186,297,131,331,0.75,120,111,200
OceanDNA-b26065,209,9.9,0.0,2e-05,0.0071,141,179,132,172,124,195,0.75,38,40,71
OceanDNA-b42603,1,12.9,0.0,2.4e-06,0.00056,150,230,170,256,155,287,0.75,80,86,132
OceanDNA-b18433,539,17.6,0.0,8.7e-08,5.2e-05,105,212,50,167,32,175,0.75,107,117,143
OceanDNA-b34087,371,3.4,0.0,0.0019,0.92,146,185,95,133,32,153,0.75,39,38,121
OceanDNA-b1353,1053,0.9,0.0,0.021,42.0,154,180,151,177,114,207,0.75,26,26,93
OceanDNA-b9659,37,1.1,0.0,0.0097,5.4,180,247,283,356,274,363,0.75,67,73,89
OceanDNA-b16139,377,3.7,0.0,0.0016,1.3,135,174,329,366,320,372,0.75,39,37,52
OceanDNA-b4324,224,16.1,0.1,2.5e-07,5.8e-05,89,175,78,169,63,177,0.75,86,91,114
OceanDNA-b15480,355,12.8,0.0,5.1e-06,0.0013,138,189,454,505,409,509,0.75,51,51,100
OceanDNA-b39139,2159,10.6,0.0,1.2e-05,0.031,140,181,199,241,195,255,0.75,41,42,60
OceanDNA-b40639,13,12.5,0.0,6.3e-06,0.0023,93,182,27,110,3,121,0.75,89,83,118
OceanDNA-b44168,3,10.0,0.0,1.8e-05,0.0095,138,196,66,128,47,141,0.75,58,62,94
OceanDNA-b37582,1979,25.9,0.1,5.4e-10,6.6e-07,76,243,93,278,84,290,0.75,167,185,206
OceanDNA-b21040,2808,12.9,0.0,7.3e-06,0.011,134,182,118,169,91,178,0.75,48,51,87
OceanDNA-b20902,2959,10.4,0.0,1.4e-05,0.06,145,212,153,222,135,232,0.75,67,69,97
OceanDNA-b17739,3688,11.7,0.0,5.7e-06,0.024,79,186,114,229,109,276,0.75,107,115,167
OceanDNA-b517,1813,0.9,0.8,0.011,43.0,144,188,19,67,13,96,0.74,44,48,83
OceanDNA-b23292,1732,-2.1,0.0,0.18,180.0,197,211,169,184,161,207,0.74,14,15,46
OceanDNA-b23153,73,-3.6,0.0,0.25,650.0,250,279,330,359,321,362,0.74,29,29,41
OceanDNA-b9010,182,9.1,0.0,3.5e-05,0.0086,109,189,59,145,53,160,0.74,80,86,107
OceanDNA-b22193,201,15.5,0.0,3.8e-07,0.0005,139,187,307,357,266,414,0.74,48,50,148
OceanDNA-b44039,156,4.6,0.0,0.0017,0.25,195,245,229,285,219,293,0.74,50,56,74
OceanDNA-b22997,222,11.4,0.0,2e-05,0.0069,153,215,155,221,125,225,0.74,62,66,100
OceanDNA-b17212,4055,13.0,0.1,4.6e-06,0.0095,197,243,84,128,54,135,0.74,46,44,81
OceanDNA-b34674,221,6.2,0.1,0.00027,0.17,169,246,291,372,280,407,0.74,77,81,127
OceanDNA-b20595,175,12.4,0.0,3.4e-06,0.00093,201,279,249,331,243,343,0.74,78,82,100
OceanDNA-b17633,332,-2.4,0.0,0.11,81.0,157,183,107,133,93,136,0.74,26,26,43
OceanDNA-b35208,909,7.5,0.0,0.0001,0.098,152,181,128,157,88,165,0.74,29,29,77
OceanDNA-b6781,378,-2.8,0.0,0.14,73.0,150,169,135,156,130,171,0.74,19,21,41
OceanDNA-b34562,134,17.0,0.0,1.4e-07,9.7e-05,142,187,152,200,90,218,0.74,45,48,128
OceanDNA-b4053,568,-1.8,0.0,0.15,52.0,68,96,64,97,57,105,0.74,28,33,48
OceanDNA-b30927,693,6.3,0.0,0.0005,0.52,181,245,209,275,194,300,0.74,64,66,106
OceanDNA-b32721,1677,10.4,0.0,2.7e-05,0.031,133,184,217,273,185,284,0.74,51,56,99
OceanDNA-b27416,97,-0.7,0.0,0.033,8.7,197,248,304,352,298,367,0.74,51,48,69
OceanDNA-b9314,190,14.8,0.0,6.2e-07,0.0002,151,207,139,198,118,217,0.74,56,59,99
OceanDNA-b6759,585,11.0,0.0,1.8e-05,0.0065,150,185,147,182,135,221,0.74,35,35,86
OceanDNA-b36771,228,11.5,0.0,6.3e-06,0.0069,150,192,230,272,199,294,0.74,42,42,95
OceanDNA-b27545,1368,3.3,0.1,0.0021,4.5,204,266,196,256,184,258,0.74,62,60,74
OceanDNA-b35325,133,11.9,0.0,4.8e-06,0.0025,93,181,30,113,13,129,0.74,88,83,116
OceanDNA-b17622,995,12.3,0.2,3.7e-06,0.005,91,187,63,157,52,168,0.74,96,94,116
OceanDNA-b30238,288,1.5,0.1,0.0074,15.0,201,263,202,262,193,268,0.74,62,60,75
OceanDNA-b34663,655,10.6,0.0,2.5e-05,0.01,135,189,55,111,41,116,0.74,54,56,75
OceanDNA-b32692,1303,1.7,0.0,0.0061,15.0,195,243,185,232,169,248,0.74,48,47,79
OceanDNA-b22261,1742,15.7,0.0,3.4e-07,0.00068,149,185,185,221,156,258,0.74,36,36,102
OceanDNA-b235,598,14.3,0.0,9.3e-07,0.00071,74,187,95,218,82,246,0.74,113,123,164
OceanDNA-b4159,28,19.1,0.0,3.1e-08,1.4e-05,126,190,113,178,84,191,0.74,64,65,107
OceanDNA-b37535,76,32.1,0.1,3.4e-12,6.1e-09,75,243,118,304,36,318,0.74,168,186,282
OceanDNA-b40959,1853,10.6,0.0,2.3e-05,0.037,140,180,167,208,159,234,0.74,40,41,75
OceanDNA-b25124,314,10.5,0.0,1.3e-05,0.015,150,190,136,181,112,205,0.74,40,45,93
OceanDNA-b1522,444,7.0,0.0,0.00045,0.15,194,230,256,291,236,320,0.74,36,35,84
OceanDNA-b15471,102,13.4,0.2,1.7e-06,0.00095,105,187,57,147,25,161,0.74,82,90,136
OceanDNA-b29482,1279,22.8,0.2,2.3e-09,7.3e-06,82,188,114,228,110,245,0.74,106,114,135
OceanDNA-b16209,388,10.1,0.0,3.5e-05,0.022,194,245,453,503,430,510,0.74,51,50,80
OceanDNA-b21004,1385,-2.0,0.0,0.24,160.0,250,269,410,429,398,440,0.74,19,19,42
OceanDNA-b44154,508,16.4,0.1,2.1e-07,0.00011,90,197,38,148,18,161,0.74,107,110,143
OceanDNA-b14149,56,11.8,0.0,5.3e-06,0.0025,152,217,126,194,114,201,0.74,65,68,87
OceanDNA-b45818,6,26.9,0.0,3.9e-10,1.9e-07,143,212,168,240,150,279,0.74,69,72,129
OceanDNA-b45818,450,15.4,0.0,1.2e-06,0.00062,106,181,566,649,550,656,0.74,75,83,106
OceanDNA-b20909,5248,11.5,0.0,1.3e-05,0.048,113,193,232,315,228,323,0.74,80,83,95
OceanDNA-b35233,573,13.3,0.0,1.8e-06,0.0012,158,181,168,191,145,205,0.74,23,23,60
OceanDNA-b17091,323,13.6,0.0,1.5e-06,0.0016,102,187,45,139,13,206,0.74,85,94,193
OceanDNA-b8077,136,-2.9,0.0,0.16,32.0,198,218,213,234,209,242,0.74,20,21,33
OceanDNA-b20657,149,9.2,0.0,6.7e-05,0.01,155,194,87,125,70,153,0.74,39,38,83
OceanDNA-b22765,288,15.5,0.0,7.5e-07,0.00061,109,212,515,625,491,640,0.74,103,110,149
OceanDNA-b16784,1504,13.7,0.0,1.4e-06,0.0023,93,180,74,163,58,169,0.74,87,89,111
OceanDNA-b44390,515,18.4,0.1,1.5e-07,3.6e-05,152,245,131,226,96,247,0.74,93,95,151
OceanDNA-b46763,1616,15.5,0.0,3.8e-07,0.00094,155,199,146,191,134,244,0.74,44,45,110
OceanDNA-b46199,236,19.6,0.0,6.6e-08,3.3e-05,139,184,150,194,133,202,0.74,45,44,69
OceanDNA-b20562,61,2.6,0.0,0.0033,0.96,192,227,191,225,186,254,0.74,35,34,68
OceanDNA-b36072,497,-3.3,0.0,0.21,200.0,88,112,124,149,122,151,0.74,24,25,29
OceanDNA-b28111,1558,-4.0,0.0,0.34,690.0,107,120,4,17,3,23,0.74,13,13,20
OceanDNA-b30849,481,9.3,0.0,2.9e-05,0.029,160,198,110,152,40,161,0.74,38,42,121
OceanDNA-b28141,234,0.2,0.0,0.036,30.0,152,191,121,165,109,171,0.74,39,44,62
OceanDNA-b40263,195,28.7,0.7,3.8e-11,2.6e-08,74,182,89,208,15,272,0.74,108,119,257
OceanDNA-b20097,224,43.5,0.0,2.3e-15,3.4e-13,55,281,60,315,56,324,0.74,226,255,268
OceanDNA-b32695,807,-0.2,0.0,0.024,23.0,154,191,101,139,78,157,0.74,37,38,79
OceanDNA-b1696,215,13.9,0.0,1.2e-06,0.00091,149,184,135,170,84,184,0.74,35,35,100
OceanDNA-b22353,1092,15.5,0.0,7.8e-07,0.00044,152,221,120,196,107,203,0.74,69,76,96
OceanDNA-b6505,278,9.1,0.0,3.4e-05,0.027,99,187,43,130,22,155,0.74,88,87,133
OceanDNA-b45854,2076,4.5,0.0,0.0017,1.8,200,258,141,202,136,210,0.74,58,61,74
OceanDNA-b41476,951,20.7,0.1,2e-08,1.4e-05,90,244,94,264,86,273,0.74,154,170,187
OceanDNA-b13263,346,26.1,0.0,2.4e-10,2.3e-07,80,246,127,296,114,307,0.74,166,169,193
OceanDNA-b12554,71,35.5,0.0,3.2e-13,1.2e-10,159,241,158,243,42,261,0.74,82,85,219
OceanDNA-b33520,16,0.6,0.0,0.013,7.0,198,230,178,209,171,238,0.74,32,31,67
OceanDNA-b18031,140,23.4,0.0,1.5e-09,2.3e-07,151,215,135,203,118,213,0.74,64,68,95
OceanDNA-b5499,196,10.8,0.1,1.1e-05,0.0042,142,188,225,276,131,283,0.74,46,51,152
OceanDNA-b17035,719,12.7,0.0,5.7e-06,0.0027,142,182,81,120,55,136,0.74,40,39,81
OceanDNA-b22461,4000,11.4,0.0,2.1e-05,0.032,98,179,165,247,149,263,0.74,81,82,114
OceanDNA-b44771,155,15.3,0.0,4.5e-07,0.00018,149,186,82,121,53,143,0.74,37,39,90
OceanDNA-b7450,995,12.3,0.0,7.4e-06,0.0048,83,187,160,267,144,279,0.74,104,107,135
OceanDNA-b32958,1170,18.3,0.0,5.5e-08,0.00013,104,184,319,407,303,422,0.74,80,88,119
OceanDNA-b23489,873,-0.1,0.0,0.022,48.0,188,246,268,322,255,343,0.74,58,54,88
OceanDNA-b23811,325,11.5,0.0,6.3e-06,0.0098,162,191,100,130,93,149,0.74,29,30,56
OceanDNA-b47088,1051,20.8,0.1,9.5e-09,3.7e-05,89,254,159,322,140,368,0.74,165,163,228
OceanDNA-b22893,2192,9.8,0.0,6.5e-05,0.05,136,181,211,256,198,268,0.74,45,45,70
OceanDNA-b45289,7,2.8,0.0,0.0059,7.4,179,225,304,350,296,392,0.74,46,46,96
OceanDNA-b38906,131,12.2,0.0,4e-06,0.0047,156,184,146,174,121,189,0.74,28,28,68
OceanDNA-b31334,15,9.9,0.1,2e-05,0.0031,204,271,213,279,202,279,0.74,67,66,77
OceanDNA-b38499,23,-0.5,0.0,0.029,29.0,249,282,388,423,373,433,0.74,33,35,60
OceanDNA-b22798,1185,4.0,0.0,0.0013,5.2,77,144,80,149,77,164,0.74,67,69,87
OceanDNA-b23143,43,17.7,0.0,1.6e-07,0.00022,154,219,157,224,142,265,0.74,65,67,123
OceanDNA-b22386,1905,32.3,0.0,1.2e-11,6.1e-09,153,243,26,118,13,124,0.74,90,92,111
OceanDNA-b43700,166,5.5,0.0,0.00044,0.48,168,230,107,172,100,194,0.74,62,65,94
OceanDNA-b13167,165,13.1,0.0,2e-06,0.0008,186,230,110,154,94,178,0.74,44,44,84
OceanDNA-b34918,448,37.8,0.9,1.9e-13,6.7e-11,79,172,163,270,131,279,0.74,93,107,148
OceanDNA-b23324,307,16.4,0.0,2.1e-07,8e-05,80,193,37,154,18,161,0.74,113,117,143
OceanDNA-b13153,314,-3.6,0.0,0.26,180.0,70,86,16,32,14,45,0.74,16,16,31
OceanDNA-b30641,77,13.1,0.1,4.1e-06,0.0022,158,185,83,110,20,126,0.74,27,27,106
OceanDNA-b12117,217,14.0,0.0,1.1e-06,0.00061,107,192,295,387,266,400,0.74,85,92,134
OceanDNA-b38880,297,8.1,0.0,0.00014,0.066,180,243,260,328,230,336,0.74,63,68,106
OceanDNA-b22076,2870,26.5,0.1,1.7e-10,5.4e-07,76,174,188,295,164,303,0.74,98,107,139
OceanDNA-b17201,332,16.1,0.0,2.6e-07,0.00021,75,169,161,266,155,276,0.74,94,105,121
OceanDNA-b32091,179,14.2,0.0,9.6e-07,0.0018,103,195,553,655,531,662,0.74,92,102,131
OceanDNA-b15711,972,-3.0,0.0,0.33,190.0,253,283,81,111,74,120,0.74,30,30,46
OceanDNA-b5279,16,37.6,0.2,7.2e-14,3.8e-11,77,245,123,310,91,324,0.74,168,187,233
OceanDNA-b17208,311,19.0,0.0,3.4e-08,3e-05,75,169,141,246,135,258,0.74,94,105,123
OceanDNA-b3653,1280,8.3,0.0,0.00023,0.13,223,265,229,270,197,276,0.74,42,41,79
OceanDNA-b1424,451,2.3,0.0,0.0083,3.3,195,230,202,236,183,258,0.74,35,34,75
OceanDNA-b23396,1632,10.8,0.0,2e-05,0.021,95,182,89,174,83,179,0.74,87,85,96
OceanDNA-b28146,1182,8.5,0.4,5.3e-05,0.099,161,197,90,130,35,135,0.74,36,40,100
OceanDNA-b9784,27,21.4,0.0,1.2e-08,7.3e-06,99,187,170,261,154,271,0.74,88,91,117
OceanDNA-b32793,1396,4.0,0.1,0.0012,4.2,137,189,70,125,56,137,0.74,52,55,81
OceanDNA-b46897,281,8.1,0.0,6.8e-05,0.058,136,186,169,215,160,247,0.74,50,46,87
OceanDNA-b23484,982,14.8,0.0,1.3e-06,0.0011,161,199,98,138,88,172,0.74,38,40,84
OceanDNA-b36411,1726,12.9,0.0,4.9e-06,0.0049,58,189,19,155,10,167,0.74,131,136,157
OceanDNA-b23725,806,-0.5,0.0,0.089,64.0,188,264,249,321,238,330,0.74,76,72,92
OceanDNA-b9009,59,6.7,0.0,0.00037,0.041,109,189,485,571,480,586,0.74,80,86,106
OceanDNA-b31334,15,9.2,0.0,3.1e-05,0.005,148,186,113,150,95,168,0.74,38,37,73
OceanDNA-b45271,95,-3.2,0.0,0.39,95.0,193,214,220,242,218,253,0.74,21,22,35
OceanDNA-b28587,550,7.5,0.0,0.00011,0.09,134,187,99,154,73,163,0.74,53,55,90
OceanDNA-b23549,1740,9.6,0.0,7.2e-05,0.047,141,190,62,112,43,133,0.74,49,50,90
OceanDNA-b40439,284,24.4,0.1,7.8e-10,1.5e-06,86,172,133,230,125,234,0.74,86,97,109
OceanDNA-b3312,138,10.2,0.0,1.6e-05,0.05,135,182,59,109,45,122,0.74,47,50,77
OceanDNA-b21019,1371,10.7,0.0,2.3e-05,0.034,120,187,91,160,85,164,0.74,67,69,79
OceanDNA-b30874,1412,8.2,0.0,0.00013,0.15,180,245,213,280,197,294,0.74,65,67,97
OceanDNA-b45442,215,3.4,0.0,0.0018,2.7,197,262,184,247,178,251,0.74,65,63,73
OceanDNA-b12501,1285,9.5,0.0,2.5e-05,0.037,96,178,44,130,14,140,0.74,82,86,126
OceanDNA-b13256,790,20.4,0.0,6.1e-08,2.4e-05,76,189,384,493,344,536,0.74,113,109,192
OceanDNA-b13256,418,18.2,0.1,2.9e-07,0.00012,93,273,195,365,155,385,0.74,180,170,230
OceanDNA-b46513,458,-3.8,0.0,0.29,170.0,247,265,33,51,30,60,0.74,18,18,30
OceanDNA-b26879,966,21.0,0.0,8.2e-09,2.8e-05,109,177,87,169,66,176,0.74,68,82,110
OceanDNA-b4028,760,11.9,0.0,9.7e-06,0.004,152,189,371,409,354,450,0.74,37,38,96
OceanDNA-b27535,1573,10.6,0.3,1.2e-05,0.028,161,223,143,204,85,223,0.74,62,61,138
OceanDNA-b31979,1189,28.5,0.2,4.1e-11,9.1e-08,86,189,40,152,23,202,0.74,103,112,179
OceanDNA-b20893,1271,1.3,0.0,0.0082,49.0,246,289,415,457,396,461,0.74,43,42,65
OceanDNA-b15137,529,9.1,0.0,0.0001,0.072,151,185,84,120,59,134,0.74,34,36,75
OceanDNA-b46647,1849,12.6,0.0,6e-06,0.0069,87,140,297,354,216,385,0.74,53,57,169
OceanDNA-b27533,2244,21.0,0.4,1.6e-08,2.1e-05,81,178,90,194,76,200,0.74,97,104,124
OceanDNA-b512,417,5.7,0.0,0.00076,0.63,198,266,198,262,181,262,0.74,68,64,81
OceanDNA-b8783,80,25.1,0.0,4.7e-10,8.4e-08,153,229,206,287,194,314,0.74,76,81,120
OceanDNA-b46554,500,17.5,0.0,9.2e-08,9.7e-05,148,190,148,191,133,223,0.74,42,43,90
OceanDNA-b46939,472,5.6,0.0,0.00041,0.54,157,195,112,150,90,160,0.74,38,38,70
OceanDNA-b47083,923,11.4,0.0,6.9e-06,0.011,153,199,210,257,192,307,0.74,46,47,115
OceanDNA-b31123,254,1.1,0.0,0.0093,9.7,198,263,334,399,325,426,0.74,65,65,101
OceanDNA-b30681,143,13.2,0.1,2e-06,0.0013,105,196,54,148,27,163,0.74,91,94,136
OceanDNA-b30842,113,13.2,0.0,2e-06,0.0011,156,181,146,171,113,189,0.74,25,25,76
OceanDNA-b33090,1196,0.5,0.0,0.014,34.0,201,250,213,258,174,268,0.74,49,45,94
OceanDNA-b4053,506,10.5,0.0,2.6e-05,0.0092,181,223,165,205,152,242,0.74,42,40,90
OceanDNA-b269,1108,23.9,0.0,3.2e-09,2.2e-06,153,243,185,280,137,293,0.74,90,95,156
OceanDNA-b38590,329,6.3,0.0,0.00024,0.17,160,218,195,259,182,288,0.74,58,64,106
OceanDNA-b15167,1945,10.7,0.0,2.2e-05,0.022,88,186,55,149,38,192,0.74,98,94,154
OceanDNA-b24712,366,2.6,0.1,0.0033,2.0,229,265,218,256,184,257,0.74,36,38,73
OceanDNA-b24641,274,16.0,0.0,2.8e-07,9e-05,103,205,48,152,19,178,0.74,102,104,159
OceanDNA-b30627,591,22.4,0.3,3e-09,2.8e-06,86,175,149,248,135,266,0.74,89,99,131
OceanDNA-b31475,251,12.6,0.0,3e-06,0.0019,140,185,160,206,153,226,0.74,45,46,73
OceanDNA-b31192,461,-3.9,0.0,0.32,250.0,198,217,212,232,211,241,0.74,19,20,30
OceanDNA-b46964,505,17.0,0.0,1.4e-07,0.0001,151,227,152,239,138,276,0.74,76,87,138
OceanDNA-b38369,225,20.8,0.0,1.9e-08,1.7e-05,106,190,110,205,63,279,0.74,84,95,216
OceanDNA-b30994,2728,10.1,0.0,1.7e-05,0.049,155,178,182,205,156,227,0.74,23,23,71
OceanDNA-b6168,140,9.2,0.0,3.2e-05,0.019,146,185,92,129,43,159,0.74,39,37,116
OceanDNA-b24712,366,10.4,0.0,1.4e-05,0.0086,161,197,108,145,92,194,0.74,36,37,102
OceanDNA-b27535,1573,3.1,0.1,0.0023,5.4,208,267,235,292,219,305,0.74,59,57,86
OceanDNA-b28261,86,9.1,0.0,3.4e-05,0.0097,194,221,166,193,157,230,0.74,27,27,73
OceanDNA-b45590,333,10.5,0.0,1.3e-05,0.0067,154,243,159,262,140,265,0.73,89,103,125
OceanDNA-b7450,617,9.4,0.0,5.5e-05,0.036,100,194,48,145,18,161,0.73,94,97,143
OceanDNA-b11316,39,9.8,0.0,4.2e-05,0.0068,140,191,144,198,134,206,0.73,51,54,72
OceanDNA-b22490,2327,10.3,0.0,2.9e-05,0.043,126,185,527,588,514,622,0.73,59,61,108
OceanDNA-b6653,91,6.3,0.0,0.00025,0.11,135,170,113,146,36,162,0.73,35,33,126
OceanDNA-b19574,99,14.4,0.0,8.6e-07,0.00033,145,207,331,397,301,401,0.73,62,66,100
OceanDNA-b20562,61,7.4,0.0,0.00011,0.034,155,179,97,121,23,125,0.73,24,24,102
OceanDNA-b25045,394,9.5,0.2,2.6e-05,0.023,154,180,145,171,122,186,0.73,26,26,64
OceanDNA-b20703,336,10.7,0.0,1.1e-05,0.0044,129,192,215,281,208,313,0.73,63,66,105
OceanDNA-b44414,115,16.0,2.0,2.7e-07,6.3e-05,79,243,72,248,45,264,0.73,164,176,219
OceanDNA-b35333,154,10.3,0.0,1.4e-05,0.0048,77,182,41,152,20,162,0.73,105,111,142
OceanDNA-b23019,128,15.6,0.1,7.4e-07,0.0014,68,175,693,806,678,813,0.73,107,113,135
OceanDNA-b37405,679,10.9,0.1,9.6e-06,0.01,146,180,130,164,103,179,0.73,34,34,76
OceanDNA-b32143,845,-3.8,0.1,0.3,630.0,151,183,47,79,45,82,0.73,32,32,37
OceanDNA-b30739,776,17.4,0.0,1e-07,0.00014,70,212,94,248,74,268,0.73,142,154,194
OceanDNA-b30216,630,0.6,0.0,0.013,27.0,201,263,405,465,396,470,0.73,62,60,74
OceanDNA-b9793,474,-1.9,0.0,0.077,42.0,158,187,127,157,108,171,0.73,29,30,63
OceanDNA-b9322,239,17.9,0.0,7.2e-08,1.9e-05,151,211,95,158,75,175,0.73,60,63,100
OceanDNA-b34892,191,7.1,0.0,0.00027,0.12,181,243,315,379,307,400,0.73,62,64,93
OceanDNA-b32709,1359,10.5,0.0,2.6e-05,0.022,132,184,207,264,144,275,0.73,52,57,131
OceanDNA-b1825,2392,29.4,0.6,2.3e-11,8.5e-08,88,244,493,673,487,678,0.73,156,180,191
OceanDNA-b40249,8,-0.6,0.0,0.032,23.0,93,124,64,98,56,115,0.73,31,34,59
OceanDNA-b7128,140,12.2,0.0,4e-06,0.0017,142,256,134,249,121,253,0.73,114,115,132
OceanDNA-b47056,481,2.0,0.0,0.0051,3.0,194,235,211,251,193,263,0.73,41,40,70
OceanDNA-b41044,685,52.2,1.3,2.5e-18,4.5e-15,16,268,11,271,3,290,0.73,252,260,287
OceanDNA-b18150,166,-3.2,0.0,0.2,33.0,82,120,136,174,109,183,0.73,38,38,74
OceanDNA-b20891,298,45.6,0.0,2.7e-16,2.1e-13,153,243,161,253,98,266,0.73,90,92,168
OceanDNA-b37532,1746,29.2,0.0,2.5e-11,6.7e-08,76,229,92,266,89,282,0.73,153,174,193
OceanDNA-b35218,372,12.1,0.0,4.3e-06,0.0038,141,181,128,169,121,188,0.73,40,41,67
OceanDNA-b36401,140,15.2,0.0,9.4e-07,0.00053,146,205,98,160,5,181,0.73,59,62,176
OceanDNA-b22385,1572,-2.9,0.0,0.15,590.0,34,78,561,608,556,615,0.73,44,47,59
OceanDNA-b39756,387,19.4,0.0,5.1e-08,1.1e-05,141,185,128,174,121,240,0.73,44,46,119
OceanDNA-b9659,37,27.0,0.0,1.2e-10,6.7e-08,86,174,143,243,133,248,0.73,88,100,115
OceanDNA-b16514,942,15.3,0.1,4.3e-07,0.00044,89,175,207,306,177,317,0.73,86,99,140
OceanDNA-b36144,426,13.6,0.0,2.9e-06,0.0036,149,216,513,584,500,594,0.73,67,71,94
OceanDNA-b2923,1425,15.6,0.0,7.1e-07,0.00068,88,182,40,132,4,155,0.73,94,92,151
OceanDNA-b19120,201,17.3,0.0,2.2e-07,3.6e-05,109,185,70,156,35,188,0.73,76,86,153
OceanDNA-b30134,407,12.1,0.1,4.2e-06,0.0095,192,235,244,287,208,309,0.73,43,43,101
OceanDNA-b22765,1312,18.3,0.0,1.1e-07,9e-05,152,188,169,206,148,243,0.73,36,37,95
OceanDNA-b27525,756,3.9,0.1,0.0052,3.5,204,266,266,326,255,335,0.73,62,60,80
OceanDNA-b30927,693,15.1,0.0,1e-06,0.001,88,183,62,165,52,181,0.73,95,103,129
OceanDNA-b16140,405,14.5,0.1,7.8e-07,0.00072,180,233,420,476,413,496,0.73,53,56,83
OceanDNA-b34942,321,10.0,0.0,1.9e-05,0.011,193,260,173,236,159,242,0.73,67,63,83
OceanDNA-b40245,290,25.2,0.6,8.7e-10,3.2e-07,75,216,96,255,91,279,0.73,141,159,188
OceanDNA-b26298,393,8.2,0.1,6.3e-05,0.04,135,195,140,199,112,211,0.73,60,59,99
OceanDNA-b24678,261,-2.6,0.0,0.13,120.0,110,135,80,106,77,119,0.73,25,26,42
OceanDNA-b17424,1206,-0.1,0.0,0.045,40.0,180,218,319,360,313,384,0.73,38,41,71
OceanDNA-b17424,328,25.2,0.0,8.9e-10,7.9e-07,152,243,165,261,117,276,0.73,91,96,159
OceanDNA-b41301,4206,11.5,0.1,1.9e-05,0.03,86,182,82,186,65,189,0.73,96,104,124
OceanDNA-b34384,302,15.1,0.0,2e-06,0.00043,143,184,69,113,32,165,0.73,41,44,133
OceanDNA-b22130,1424,21.9,0.1,8.6e-09,1.1e-05,94,177,278,363,257,367,0.73,83,85,110
OceanDNA-b45891,116,10.3,0.1,1.5e-05,0.0049,148,203,108,169,77,177,0.73,55,61,100
OceanDNA-b41267,1339,13.4,0.0,1.8e-06,0.0054,132,206,130,203,93,227,0.73,74,73,134
OceanDNA-b22917,474,20.0,0.0,6.4e-08,4.6e-05,109,185,105,175,82,192,0.73,76,70,110
OceanDNA-b36732,2751,4.2,0.0,0.0011,3.7,181,260,284,369,277,372,0.73,79,85,95
OceanDNA-b20098,140,42.5,0.0,4.7e-15,5.9e-13,55,281,95,350,90,359,0.73,226,255,269
OceanDNA-b17240,117,11.2,0.0,8.1e-06,0.0039,75,171,122,229,101,240,0.73,96,107,139
OceanDNA-b31523,1127,25.4,0.1,3.7e-10,5.5e-07,82,173,156,261,146,271,0.73,91,105,125
OceanDNA-b3983,883,2.0,0.0,0.015,5.1,195,256,276,334,260,349,0.73,61,58,89
OceanDNA-b40232,803,18.7,0.1,8e-08,9.2e-05,154,213,159,225,141,268,0.73,59,66,127
OceanDNA-b21873,149,-0.9,0.0,0.039,7.5,198,244,197,241,179,261,0.73,46,44,82
OceanDNA-b13635,603,27.2,0.0,1.1e-10,1.3e-07,151,221,139,213,120,261,0.73,70,74,141
OceanDNA-b3329,1290,16.5,0.8,1.9e-07,0.00042,88,204,88,202,81,206,0.73,116,114,125
OceanDNA-b46647,2053,16.6,0.1,3.5e-07,0.0004,138,189,139,187,117,218,0.73,51,48,101
OceanDNA-b33317,1303,10.8,0.1,1.1e-05,0.029,124,180,86,145,78,159,0.73,56,59,81
OceanDNA-b37573,1579,23.7,0.1,1.3e-09,3.5e-06,76,243,108,293,104,304,0.73,167,185,200
OceanDNA-b30771,946,13.5,0.1,1.6e-06,0.0035,84,211,101,238,38,285,0.73,127,137,247
OceanDNA-b40889,92,21.6,0.0,5.6e-09,3.6e-06,86,170,127,222,120,227,0.73,84,95,107
OceanDNA-b22260,1342,18.5,0.0,4.7e-08,8.8e-05,150,188,214,253,192,287,0.73,38,39,95
OceanDNA-b3704,1601,1.4,0.1,0.0078,21.0,77,126,40,92,8,113,0.73,49,52,105
OceanDNA-b2866,1726,12.5,0.0,6.2e-06,0.0082,101,181,61,140,8,149,0.73,80,79,141
OceanDNA-b41451,1294,-2.1,0.0,0.18,130.0,16,68,14,65,6,69,0.73,52,51,63
OceanDNA-b16125,732,21.4,0.0,6.4e-09,4.9e-06,78,175,229,343,219,353,0.73,97,114,134
OceanDNA-b19896,68,18.1,0.0,6.1e-08,2.4e-05,145,191,296,342,267,365,0.73,46,46,98
OceanDNA-b16662,303,8.5,0.0,5.4e-05,0.054,138,179,326,366,315,375,0.73,41,40,60
OceanDNA-b27536,721,24.4,0.2,7.5e-10,1.2e-06,89,172,142,232,134,246,0.73,83,90,112
OceanDNA-b20908,8483,33.1,0.1,1.7e-12,1.7e-08,88,245,50,232,41,244,0.73,157,182,203
OceanDNA-b30743,468,15.7,0.0,3.3e-07,0.00051,78,211,47,191,18,222,0.73,133,144,204
OceanDNA-b6759,143,10.4,0.0,2.7e-05,0.01,108,188,95,177,85,186,0.73,80,82,101
OceanDNA-b20893,1271,12.8,0.0,2.5e-06,0.015,84,173,175,275,169,283,0.73,89,100,114
OceanDNA-b6184,38,13.3,0.0,1.8e-06,0.0013,74,193,54,180,35,186,0.73,119,126,151
OceanDNA-b30206,381,19.4,0.2,2.6e-08,5.8e-05,86,173,141,238,133,245,0.73,87,97,112
OceanDNA-b4491,657,4.9,0.0,0.0013,0.45,178,243,277,347,274,355,0.73,65,70,81
OceanDNA-b31945,387,10.4,0.0,1.4e-05,0.026,159,190,114,146,9,158,0.73,31,32,149
OceanDNA-b16227,638,-2.3,0.0,0.3,110.0,196,227,219,249,210,263,0.73,31,30,53
OceanDNA-b22477,939,-3.9,0.0,0.31,530.0,191,208,196,213,192,216,0.73,17,17,24
OceanDNA-b25263,132,10.2,0.0,1.6e-05,0.0037,161,197,96,140,90,148,0.73,36,44,58
OceanDNA-b28826,1069,10.5,0.0,1.3e-05,0.016,158,196,92,131,72,148,0.73,38,39,76
OceanDNA-b33331,208,-2.6,0.0,0.25,200.0,207,235,74,101,55,113,0.73,28,27,58
OceanDNA-b22322,1513,13.7,0.0,2.8e-06,0.0055,136,188,206,254,186,288,0.73,52,48,102
OceanDNA-b37615,440,0.5,0.0,0.015,28.0,154,191,15,56,3,76,0.73,37,41,73
OceanDNA-b32645,804,-1.0,0.0,0.04,34.0,157,185,136,165,126,182,0.73,28,29,56
OceanDNA-b3631,550,3.0,0.1,0.0025,2.6,161,197,111,151,94,193,0.73,36,40,99
OceanDNA-b34266,1658,-1.5,0.0,0.058,150.0,118,146,122,150,117,164,0.73,28,28,47
OceanDNA-b34951,634,-2.1,0.0,0.086,63.0,150,179,58,87,34,95,0.73,29,29,61
OceanDNA-b26380,46,-3.7,0.0,0.27,210.0,197,223,248,274,240,284,0.73,26,26,44
OceanDNA-b13759,281,19.7,0.0,2e-08,7e-06,101,212,41,161,16,192,0.73,111,120,176
OceanDNA-b34671,566,9.3,0.0,3e-05,0.022,168,246,309,392,279,428,0.73,78,83,149
OceanDNA-b22403,3109,11.5,0.0,6.2e-06,0.024,133,189,139,191,109,214,0.73,56,52,105
OceanDNA-b46553,591,19.8,0.1,3.7e-08,2.8e-05,154,207,144,201,115,243,0.73,53,57,128
OceanDNA-b46908,1333,-3.3,0.0,0.21,720.0,46,69,569,592,548,593,0.73,23,23,45
OceanDNA-b33515,491,1.2,0.0,0.0088,13.0,197,251,295,346,287,359,0.73,54,51,72
OceanDNA-b10027,423,7.4,0.0,0.00011,0.061,101,185,50,133,27,153,0.73,84,83,126
OceanDNA-b20975,3216,19.0,0.1,3.3e-08,0.00019,91,169,115,203,91,213,0.73,78,88,122
OceanDNA-b32763,549,15.5,0.0,4e-07,0.00063,138,181,97,140,20,157,0.73,43,43,137
OceanDNA-b6424,365,1.5,0.0,0.022,4.4,223,265,214,255,189,257,0.73,42,41,68
OceanDNA-b45789,235,12.1,0.0,8.2e-06,0.0023,154,243,151,254,125,264,0.73,89,103,139
OceanDNA-b24879,1546,0.9,0.1,0.021,20.0,24,72,27,75,6,79,0.73,48,48,73
OceanDNA-b23813,1139,13.3,0.2,1.9e-06,0.0027,76,243,64,247,60,255,0.73,167,183,195
OceanDNA-b30235,805,21.3,0.2,6.8e-09,2e-05,85,173,159,258,151,263,0.73,88,99,112
OceanDNA-b45640,461,20.0,0.0,1.7e-08,9.6e-06,138,244,128,246,121,269,0.73,106,118,148
OceanDNA-b22382,1397,-1.3,0.0,0.1,200.0,177,193,305,321,295,334,0.73,16,16,39
OceanDNA-b4054,583,13.3,0.0,1.8e-06,0.0011,108,194,22,115,5,131,0.73,86,93,126
OceanDNA-b37351,879,8.6,0.0,5e-05,0.062,197,232,222,256,210,273,0.73,35,34,63
OceanDNA-b40467,631,13.0,0.1,2.3e-06,0.0036,126,188,146,212,122,223,0.73,62,66,101
OceanDNA-b36767,303,11.5,0.0,6.3e-06,0.0056,151,192,231,272,201,294,0.73,41,41,93
OceanDNA-b34729,429,16.7,0.1,1.7e-07,0.00015,190,249,228,290,210,308,0.73,59,62,98
OceanDNA-b36152,858,16.7,0.9,1.6e-07,0.00039,75,185,123,252,110,261,0.73,110,129,151
OceanDNA-b5492,297,12.0,0.0,4.6e-06,0.0021,154,183,76,107,47,149,0.73,29,31,102
OceanDNA-b30151,698,14.7,0.0,6.6e-07,0.002,157,231,80,155,62,165,0.73,74,75,103
OceanDNA-b13083,150,8.6,0.0,4.9e-05,0.12,156,185,146,174,76,197,0.73,29,28,121
OceanDNA-b41127,1967,69.2,1.0,1.7e-23,3.8e-20,9,269,30,296,22,314,0.73,260,266,292
OceanDNA-b32166,2396,9.4,0.2,2.8e-05,0.078,130,176,225,270,205,289,0.73,46,45,84
OceanDNA-b41307,1384,3.7,0.8,0.0015,6.2,159,172,149,162,84,176,0.73,13,13,92
OceanDNA-b38215,413,11.6,0.0,5.8e-06,0.0078,159,236,125,207,109,229,0.73,77,82,120
OceanDNA-b1522,281,10.3,0.1,4.5e-05,0.015,142,183,105,145,47,155,0.73,41,40,108
OceanDNA-b30217,1058,20.0,0.7,1.7e-08,4e-05,81,172,129,231,123,242,0.73,91,102,119
OceanDNA-b23549,1740,2.9,0.0,0.0078,5.1,198,263,189,255,183,258,0.73,65,66,75
OceanDNA-b32144,1624,5.1,0.5,0.0011,1.5,62,111,43,92,5,97,0.73,49,49,92
OceanDNA-b3906,1521,16.4,0.0,2.1e-07,0.00035,74,192,186,311,166,318,0.73,118,125,152
OceanDNA-b44444,1331,1.2,0.0,0.0089,21.0,173,230,254,317,242,334,0.73,57,63,92
OceanDNA-b43826,61,1.2,0.0,0.009,14.0,169,217,172,224,165,238,0.73,48,52,73
OceanDNA-b9784,941,13.4,0.0,3.3e-06,0.002,150,188,125,163,112,240,0.73,38,38,128
OceanDNA-b30487,1180,4.7,0.0,0.0015,2.1,176,245,269,342,259,349,0.73,69,73,90
OceanDNA-b34725,328,16.5,0.1,3.9e-07,0.00014,155,264,142,253,121,256,0.73,109,111,135
OceanDNA-b35863,368,11.9,0.0,4.8e-06,0.011,128,190,137,203,127,233,0.73,62,66,106
OceanDNA-b29509,1618,11.4,0.0,6.8e-06,0.031,152,182,92,122,17,147,0.73,30,30,130
OceanDNA-b1142,658,12.0,0.0,4.6e-06,0.0047,150,214,90,164,76,185,0.73,64,74,109
OceanDNA-b25939,345,10.1,0.0,1.7e-05,0.0072,150,180,224,256,184,279,0.73,30,32,95
OceanDNA-b23093,2434,14.7,0.0,2.1e-06,0.0043,75,170,375,481,372,491,0.73,95,106,119
OceanDNA-b24040,1710,-1.2,0.0,0.047,82.0,250,276,171,197,158,213,0.73,26,26,55
OceanDNA-b34753,600,11.1,0.0,8.3e-06,0.006,151,199,623,672,559,676,0.73,48,49,117
OceanDNA-b3865,332,-3.4,0.0,0.22,76.0,58,86,37,66,35,77,0.73,28,29,42
OceanDNA-b3696,1147,-3.0,0.0,0.17,430.0,154,175,194,215,184,226,0.73,21,21,42
OceanDNA-b37859,480,18.1,0.0,6.4e-08,6.1e-05,197,269,704,778,678,782,0.73,72,74,104
OceanDNA-b43700,166,6.8,0.2,0.00018,0.19,155,185,27,55,7,62,0.73,30,28,55
OceanDNA-b31695,307,1.7,0.0,0.0061,11.0,196,245,621,671,615,678,0.73,49,50,63
OceanDNA-b13078,1187,-1.7,0.0,0.068,88.0,197,235,276,314,256,349,0.73,38,38,93
OceanDNA-b20895,1799,20.4,0.0,1.2e-08,5e-05,106,211,162,281,152,349,0.73,105,119,197
OceanDNA-b24128,1437,16.2,0.0,2.3e-07,0.00051,132,185,64,116,48,125,0.73,53,52,77
OceanDNA-b37652,73,11.0,0.0,1.8e-05,0.011,24,156,8,139,2,144,0.73,132,131,142
OceanDNA-b39,3911,3.8,0.0,0.0028,9.7,201,268,261,327,251,332,0.73,67,66,81
OceanDNA-b18515,271,11.1,0.0,8.7e-06,0.0038,154,215,60,129,38,175,0.72,61,69,137
OceanDNA-b3867,683,-0.8,0.1,0.035,56.0,214,244,41,73,31,83,0.72,30,32,52
OceanDNA-b20094,148,21.2,0.0,1.5e-08,2.8e-06,151,215,132,199,117,243,0.72,64,67,126
OceanDNA-b2904,2752,3.0,0.0,0.0024,11.0,136,237,268,372,257,382,0.72,101,104,125
OceanDNA-b46050,498,3.4,0.0,0.0019,1.9,110,172,728,791,701,801,0.72,62,63,100
OceanDNA-b42293,157,-2.7,0.0,0.14,27.0,252,273,28,50,15,62,0.72,21,22,47
OceanDNA-b3867,683,10.5,0.0,1.3e-05,0.021,125,182,119,177,100,193,0.72,57,58,93
OceanDNA-b46766,1355,11.5,0.0,1.3e-05,0.011,154,190,205,242,189,303,0.72,36,37,114
OceanDNA-b36658,243,15.8,0.0,6.3e-07,0.00028,154,217,198,263,105,292,0.72,63,65,187
OceanDNA-b24219,68,15.8,0.0,3.1e-07,0.00037,79,174,58,167,54,205,0.72,95,109,151
OceanDNA-b12642,408,11.4,0.0,6.9e-06,0.0041,144,185,101,141,10,147,0.72,41,40,137
OceanDNA-b22407,1618,-1.9,0.0,0.075,220.0,142,178,18,54,9,62,0.72,36,36,53
OceanDNA-b32747,410,4.0,0.0,0.0012,0.58,191,263,298,366,276,368,0.72,72,68,92
OceanDNA-b23552,218,0.5,0.0,0.014,29.0,199,220,235,258,229,298,0.72,21,23,69
OceanDNA-b16095,80,2.1,0.0,0.0048,4.3,194,271,223,294,214,299,0.72,77,71,85
OceanDNA-b24647,108,10.2,0.0,1.6e-05,0.015,139,181,121,160,97,186,0.72,42,39,89
OceanDNA-b32285,973,-2.8,0.0,0.14,140.0,94,129,62,101,60,111,0.72,35,39,51
OceanDNA-b7996,86,13.7,0.0,1.3e-06,0.00039,149,189,143,184,117,223,0.72,40,41,106
OceanDNA-b23019,3479,1.3,0.0,0.016,31.0,153,195,169,216,138,230,0.72,42,47,92
OceanDNA-b23150,2605,-3.6,0.0,0.26,690.0,201,244,234,274,233,276,0.72,43,40,43
OceanDNA-b23040,1616,-1.0,0.1,0.041,77.0,176,199,18,41,11,63,0.72,23,23,52
OceanDNA-b38966,1203,10.5,0.1,1.3e-05,0.028,107,185,267,356,257,362,0.72,78,89,105
OceanDNA-b23417,1309,-1.0,0.0,0.13,120.0,196,243,667,714,662,735,0.72,47,47,73
OceanDNA-b22848,486,16.7,0.0,1.7e-07,0.00065,111,212,504,608,466,632,0.72,101,104,166
OceanDNA-b23984,1143,-2.3,0.0,0.1,180.0,230,252,225,247,196,261,0.72,22,22,65
OceanDNA-b23063,1570,25.7,0.3,2.9e-10,4.8e-07,81,185,67,176,35,185,0.72,104,109,150
OceanDNA-b16220,1203,26.8,0.1,2.9e-10,1.8e-07,52,179,260,402,213,409,0.72,127,142,196
OceanDNA-b35148,1840,21.7,0.4,9.7e-09,1e-05,13,187,19,206,7,219,0.72,174,187,212
OceanDNA-b36755,104,4.8,0.0,0.0014,2.6,197,231,206,239,199,265,0.72,34,33,66
OceanDNA-b7584,366,2.5,0.0,0.0035,1.3,153,173,155,175,135,190,0.72,20,20,55
OceanDNA-b7477,488,12.4,0.0,3.5e-06,0.0022,139,181,134,175,104,200,0.72,42,41,96
OceanDNA-b22131,554,21.8,0.0,9.1e-09,3.9e-06,149,248,158,261,134,268,0.72,99,103,134
OceanDNA-b20963,6458,12.2,0.0,8.1e-06,0.027,148,216,65,140,47,153,0.72,68,75,106
OceanDNA-b16095,80,7.6,0.0,0.0001,0.092,108,181,111,184,102,194,0.72,73,73,92
OceanDNA-b45584,658,-1.9,0.0,0.079,110.0,54,100,16,61,13,70,0.72,46,45,57
OceanDNA-b46839,919,11.9,0.0,9.8e-06,0.0063,154,192,204,243,187,300,0.72,38,39,113
OceanDNA-b3654,348,25.4,0.1,3.6e-10,4.7e-07,85,174,144,245,136,256,0.72,89,101,120
OceanDNA-b4143,217,15.0,0.0,1.7e-06,0.00092,153,218,135,202,124,234,0.72,65,67,110
OceanDNA-b35991,369,17.4,0.1,9.9e-08,4.4e-05,78,218,105,247,83,282,0.72,140,142,199
OceanDNA-b22292,899,42.8,4.0,1.8e-15,3.5e-12,76,232,79,244,36,259,0.72,156,165,223
OceanDNA-b44183,327,13.2,0.0,2e-06,0.00095,144,188,120,166,68,196,0.72,44,46,128
OceanDNA-b23176,7390,11.5,0.0,2e-05,0.049,31,135,41,149,10,165,0.72,104,108,155
OceanDNA-b34735,132,11.4,0.0,1.4e-05,0.0046,109,198,573,670,568,687,0.72,89,97,119
OceanDNA-b36890,852,-1.2,0.0,0.047,73.0,201,234,254,282,250,292,0.72,33,28,42
OceanDNA-b23634,126,3.0,0.0,0.0075,6.2,150,177,141,168,111,223,0.72,27,27,112
OceanDNA-b202,1210,16.3,0.0,6.7e-07,0.0005,64,215,19,180,4,226,0.72,151,161,222
OceanDNA-b19769,45,10.0,0.0,3.7e-05,0.0085,148,192,297,341,264,365,0.72,44,44,101
OceanDNA-b32148,502,-0.4,0.0,0.027,49.0,193,218,219,244,198,278,0.72,25,25,80
OceanDNA-b20404,296,-0.7,0.0,0.034,14.0,103,120,161,178,146,183,0.72,17,17,37
OceanDNA-b9791,496,10.4,0.0,1.4e-05,0.011,43,206,56,229,39,240,0.72,163,173,201
OceanDNA-b46839,520,14.8,0.0,1.3e-06,0.0008,153,243,164,256,147,265,0.72,90,92,118
OceanDNA-b9635,310,6.6,0.1,0.0002,0.096,178,221,200,243,191,257,0.72,43,43,66
OceanDNA-b5446,232,12.9,0.0,2.4e-06,0.001,105,187,217,301,140,309,0.72,82,84,169
OceanDNA-b20951,936,12.1,0.0,8.3e-06,0.01,102,176,119,207,105,225,0.72,74,88,120
OceanDNA-b25052,124,15.7,0.0,3.4e-07,0.00035,153,216,88,151,66,160,0.72,63,63,94
OceanDNA-b22894,1403,11.7,0.0,1.1e-05,0.012,89,211,515,646,501,671,0.72,122,131,170
OceanDNA-b45289,873,11.4,0.0,1.3e-05,0.017,89,197,170,282,145,289,0.72,108,112,144
OceanDNA-b6424,365,10.6,0.0,3.7e-05,0.0076,98,185,46,132,21,153,0.72,87,86,132
OceanDNA-b1575,593,-2.3,0.0,0.1,86.0,127,156,213,242,204,246,0.72,29,29,42
OceanDNA-b32133,1141,3.4,0.0,0.0019,4.6,169,245,448,519,443,524,0.72,76,71,81
OceanDNA-b40634,229,37.7,0.1,1.3e-13,5.4e-11,62,244,78,275,66,281,0.72,182,197,215
OceanDNA-b23120,1596,15.6,0.0,3.6e-07,0.00068,149,262,113,241,104,244,0.72,113,128,140
OceanDNA-b11842,884,-4.1,0.0,0.36,440.0,27,49,309,331,298,333,0.72,22,22,35
OceanDNA-b45233,797,22.6,0.0,5.3e-09,3.9e-06,96,225,109,240,82,248,0.72,129,131,166
OceanDNA-b22654,1156,15.0,0.0,2.8e-06,0.00068,153,213,527,592,498,631,0.72,60,65,133
OceanDNA-b41418,435,6.3,0.0,0.00024,0.21,196,218,236,258,223,302,0.72,22,22,79
OceanDNA-b7277,105,11.7,0.0,5.7e-06,0.0025,154,217,193,261,175,310,0.72,63,68,135
OceanDNA-b26901,3435,4.2,0.0,0.0011,4.1,201,268,225,290,212,295,0.72,67,65,83
OceanDNA-b43987,160,6.4,0.0,0.00046,0.051,194,244,124,180,114,188,0.72,50,56,74
OceanDNA-b20946,2606,12.8,0.1,2.6e-06,0.011,123,175,120,170,113,172,0.72,52,50,59
OceanDNA-b10080,453,10.7,0.0,2.3e-05,0.011,102,211,163,281,127,317,0.72,109,118,190
OceanDNA-b289,2632,28.9,0.0,6.4e-11,1.2e-07,153,244,211,304,193,327,0.72,91,93,134
OceanDNA-b41451,1294,35.0,0.0,9.1e-13,6.6e-10,92,243,107,274,102,281,0.72,151,167,179
OceanDNA-b37023,40,-2.5,0.0,0.24,89.0,223,261,350,389,333,396,0.72,38,39,63
OceanDNA-b5608,496,11.9,0.0,5e-06,0.0038,141,187,30,79,11,87,0.72,46,49,76
OceanDNA-b20036,199,41.2,0.0,1.7e-14,2.1e-12,72,280,97,333,77,350,0.72,208,236,273
OceanDNA-b3912,1700,12.2,0.0,8e-06,0.008,124,182,101,160,48,175,0.72,58,59,127
OceanDNA-b2928,1170,-1.9,0.0,0.078,93.0,48,82,63,99,36,122,0.72,34,36,86
OceanDNA-b46982,639,25.1,0.0,9.5e-10,3.1e-07,153,192,164,204,150,239,0.72,39,40,89
OceanDNA-b3712,2033,11.1,0.0,1.7e-05,0.018,104,198,21,121,13,129,0.72,94,100,116
OceanDNA-b6736,12,9.6,0.0,2.5e-05,0.017,100,180,61,136,50,145,0.72,80,75,95
OceanDNA-b43987,64,18.2,0.0,1.2e-07,1.3e-05,73,172,84,195,76,200,0.72,99,111,124
OceanDNA-b18466,166,15.0,0.0,5.3e-07,0.00019,78,186,53,171,34,247,0.72,108,118,213
OceanDNA-b33329,584,2.8,0.0,0.0088,4.6,195,261,312,378,304,380,0.72,66,66,76
OceanDNA-b33329,1259,-1.3,0.0,0.16,82.0,206,245,73,111,48,126,0.72,39,38,78
OceanDNA-b24117,2173,8.5,0.0,0.00011,0.14,182,230,186,230,166,260,0.72,48,44,94
OceanDNA-b20820,150,-0.5,0.0,0.029,16.0,96,121,149,174,136,193,0.72,25,25,57
OceanDNA-b34724,426,14.3,0.0,8.9e-07,0.00075,155,264,142,253,119,256,0.72,109,111,137
OceanDNA-b3934,51,13.7,0.0,2.8e-06,0.00098,89,187,157,258,142,264,0.72,98,101,122
OceanDNA-b22616,1116,16.1,0.0,5.2e-07,0.0011,141,183,107,151,71,196,0.72,42,44,125
OceanDNA-b6745,55,13.7,0.0,1.4e-06,0.00075,88,204,105,231,76,244,0.72,116,126,168
OceanDNA-b31994,2391,17.9,0.0,7.3e-08,0.00024,101,171,81,165,63,176,0.72,70,84,113
OceanDNA-b3144,1036,14.0,0.2,1.1e-06,0.0015,75,186,97,220,18,235,0.72,111,123,217
OceanDNA-b27525,1377,21.8,0.4,1.9e-08,1.3e-05,80,178,115,220,99,227,0.72,98,105,128
OceanDNA-b32153,1760,-0.6,0.2,0.032,79.0,158,173,157,172,138,179,0.72,15,15,41
OceanDNA-b22654,1156,-1.9,0.0,0.39,95.0,20,53,251,286,232,300,0.72,33,35,68
OceanDNA-b34944,344,11.2,0.0,7.9e-06,0.0057,140,179,28,68,23,95,0.72,39,40,72
OceanDNA-b43986,170,5.5,0.0,0.00043,0.11,194,244,232,288,222,297,0.72,50,56,75
OceanDNA-b16147,120,7.0,0.0,0.00031,0.11,186,246,422,482,406,491,0.72,60,60,85
OceanDNA-b46295,121,11.1,0.0,8.5e-06,0.025,103,176,25,102,13,108,0.72,73,77,95
OceanDNA-b36084,2329,-0.8,0.0,0.035,93.0,75,121,194,242,140,257,0.72,46,48,117
OceanDNA-b22995,1529,20.0,0.3,3.3e-08,3.5e-05,52,208,455,624,421,714,0.72,156,169,293
OceanDNA-b29542,1230,11.1,0.0,1.7e-05,0.019,106,198,189,284,175,304,0.72,92,95,129
OceanDNA-b36896,572,14.3,0.1,9.1e-07,0.0012,79,183,81,185,53,201,0.72,104,104,148
OceanDNA-b33096,89,10.7,0.0,2.3e-05,0.015,104,172,12,90,5,105,0.72,68,78,100
OceanDNA-a14,380,11.5,0.0,6.5e-06,0.0056,80,187,33,149,13,156,0.72,107,116,143
OceanDNA-b22548,17,18.4,0.0,1e-07,6.7e-05,129,215,92,183,62,213,0.72,86,91,151
OceanDNA-b34895,715,-1.2,0.0,0.047,41.0,188,212,194,219,181,228,0.72,24,25,47
OceanDNA-b31573,692,-3.0,0.0,0.34,310.0,94,122,77,108,74,114,0.71,28,31,40
OceanDNA-b42522,247,20.2,0.0,2.9e-08,4.6e-06,153,243,153,247,136,266,0.71,90,94,130
OceanDNA-b23843,2041,-0.5,0.0,0.03,68.0,78,124,58,107,26,131,0.71,46,49,105
OceanDNA-b34630,236,18.8,0.0,7.7e-08,3.6e-05,109,203,103,194,79,205,0.71,94,91,126
OceanDNA-b22554,194,11.2,0.1,1.6e-05,0.0094,95,175,547,625,523,633,0.71,80,78,110
OceanDNA-b31120,370,14.8,0.0,2e-06,0.00071,149,186,71,111,45,154,0.71,37,40,109
OceanDNA-b47071,688,24.9,0.0,1.1e-09,4e-07,153,244,89,189,77,205,0.71,91,100,128
OceanDNA-b17212,2925,1.7,0.0,0.013,27.0,169,218,111,164,91,189,0.71,49,53,98
OceanDNA-b23040,1616,12.0,2.0,4.5e-06,0.0084,153,180,79,106,44,108,0.71,27,27,64
OceanDNA-b44444,1331,24.9,0.0,5.5e-10,1.3e-06,89,170,127,219,122,239,0.71,81,92,117
OceanDNA-b30138,3515,13.0,0.0,2.3e-06,0.0084,156,220,250,322,174,351,0.71,64,72,177
OceanDNA-b11352,456,3.8,0.0,0.0014,0.89,160,184,116,140,34,159,0.71,24,24,125
OceanDNA-b41211,1622,36.6,0.2,1.4e-13,2.7e-10,15,268,31,289,17,305,0.71,253,258,288
OceanDNA-b34384,115,16.7,0.0,6.6e-07,0.00014,159,187,130,158,45,168,0.71,28,28,123
OceanDNA-b34551,738,27.6,0.2,1.6e-10,7.3e-08,85,172,116,216,99,220,0.71,87,100,121
OceanDNA-b15777,1620,5.5,0.0,0.0013,0.72,194,250,216,268,209,284,0.71,56,52,75
OceanDNA-b17770,189,3.2,0.0,0.0022,0.65,84,182,30,131,17,139,0.71,98,101,122
OceanDNA-b18640,271,8.8,0.0,8.4e-05,0.013,175,223,232,279,227,316,0.71,48,47,89
OceanDNA-b19767,37,10.4,0.0,1.4e-05,0.0045,150,207,132,193,93,200,0.71,57,61,107
OceanDNA-b9056,116,11.5,0.0,6.6e-06,0.002,157,236,91,171,75,182,0.71,79,80,107
OceanDNA-b3653,1507,10.9,0.0,3.9e-05,0.022,137,229,139,234,130,255,0.71,92,95,125
OceanDNA-b44039,156,7.7,0.6,0.00018,0.028,128,172,141,187,69,193,0.71,44,46,124
OceanDNA-b1435,542,25.5,0.1,6.9e-10,2.9e-07,132,183,109,159,73,169,0.71,51,50,96
OceanDNA-b4157,45,23.1,0.0,1.9e-09,7.5e-07,153,196,232,276,222,352,0.71,43,44,130
OceanDNA-b6783,384,10.4,0.0,1.4e-05,0.0063,154,182,77,105,16,115,0.71,28,28,99
OceanDNA-b45220,1971,2.5,0.0,0.0035,14.0,195,222,236,263,218,288,0.71,27,27,70
OceanDNA-b38873,431,12.2,0.0,4e-06,0.003,146,205,83,152,60,165,0.71,59,69,105
OceanDNA-b1232,562,17.0,0.1,1.4e-07,0.00027,90,168,187,274,175,279,0.71,78,87,104
OceanDNA-b31692,265,7.9,0.6,8.1e-05,0.09,77,183,40,146,18,170,0.71,106,106,152
OceanDNA-b27491,217,-3.0,0.0,0.16,45.0,198,216,301,319,297,356,0.71,18,18,59
OceanDNA-b6750,637,14.7,0.0,2.1e-06,0.00051,151,223,141,216,126,254,0.71,72,75,128
OceanDNA-b6575,684,14.7,0.0,6.8e-07,0.00068,70,193,20,151,8,157,0.71,123,131,149
OceanDNA-b13300,331,8.5,0.0,5.2e-05,0.083,137,180,118,164,96,172,0.71,43,46,76
OceanDNA-b16517,491,14.4,0.3,8.2e-07,0.00073,88,174,204,303,152,310,0.71,86,99,158
OceanDNA-b9808,396,15.9,0.0,5.7e-07,0.00016,147,215,145,217,131,224,0.71,68,72,93
OceanDNA-b36971,832,16.4,0.1,2e-07,0.0002,137,185,120,169,52,185,0.71,48,49,133
OceanDNA-b36,1773,17.3,0.0,1.1e-07,0.0002,102,176,226,308,184,334,0.71,74,82,150
OceanDNA-b498,1429,12.5,0.0,3.1e-06,0.0088,148,177,325,354,296,412,0.71,29,29,116
OceanDNA-b23515,947,6.4,0.0,0.00022,0.28,122,190,57,123,51,135,0.71,68,66,84
OceanDNA-b23551,407,-0.3,0.0,0.05,38.0,187,246,263,318,254,341,0.71,59,55,87
OceanDNA-b23323,39,13.4,0.0,1.7e-06,0.00021,96,206,61,175,55,216,0.71,110,114,161
OceanDNA-b28576,324,10.4,0.0,1.4e-05,0.0069,112,189,64,137,52,155,0.71,77,73,103
OceanDNA-b13261,8,2.6,0.0,0.0065,3.9,193,219,193,220,178,260,0.71,26,27,82
OceanDNA-b10294,774,8.6,0.0,0.0001,0.042,99,192,53,149,31,160,0.71,93,96,129
OceanDNA-b9937,387,-0.4,0.0,0.027,11.0,195,217,208,230,202,258,0.71,22,22,56
OceanDNA-b16213,512,18.1,0.0,6.4e-08,5.4e-05,81,188,270,400,231,409,0.71,107,130,178
OceanDNA-b265,82,28.1,0.0,1.1e-10,9.7e-08,153,243,172,264,150,285,0.71,90,92,135
OceanDNA-b8222,62,-2.1,0.0,0.088,24.0,156,185,72,102,54,135,0.71,29,30,81
OceanDNA-b4763,414,-1.9,0.0,0.079,39.0,263,278,202,217,187,227,0.71,15,15,40
OceanDNA-b4498,1017,5.3,0.0,0.0015,0.5,179,247,294,368,262,373,0.71,68,74,111
OceanDNA-b31692,265,0.3,0.0,0.016,18.0,196,264,206,272,200,280,0.71,68,66,80
OceanDNA-b9190,106,2.9,0.0,0.0026,1.0,177,247,279,355,270,362,0.71,70,76,92
OceanDNA-b30216,630,10.5,0.2,1.3e-05,0.027,137,198,298,361,263,401,0.71,61,63,138
OceanDNA-b22999,1727,16.4,0.0,2.1e-07,0.00041,153,197,136,183,122,204,0.71,44,47,82
OceanDNA-b40943,23,13.3,0.0,3.6e-06,0.0017,104,182,38,110,22,122,0.71,78,72,100
OceanDNA-b22517,1461,18.0,0.0,1.4e-07,0.00022,129,214,171,255,160,286,0.71,85,84,126
OceanDNA-b20627,234,5.0,0.0,0.00063,0.2,83,148,133,201,126,214,0.71,65,68,88
OceanDNA-b41512,504,7.8,0.1,8.8e-05,0.17,88,119,56,87,41,223,0.71,31,31,182
OceanDNA-b23839,810,13.9,0.0,2.4e-06,0.0013,107,192,128,222,112,230,0.71,85,94,118
OceanDNA-b17563,225,1.0,0.0,0.03,22.0,55,117,66,132,55,139,0.71,62,66,84
OceanDNA-b36076,1735,14.4,0.0,1.7e-06,0.0021,152,189,535,573,523,610,0.71,37,38,87
OceanDNA-b40245,298,12.4,0.1,6.9e-06,0.0025,104,197,75,171,43,216,0.71,93,96,173
OceanDNA-b32958,1170,-0.4,0.0,0.027,65.0,186,218,459,491,440,508,0.71,32,32,68
OceanDNA-b16622,278,-0.1,0.0,0.022,33.0,198,266,444,518,414,524,0.71,68,74,110
OceanDNA-b46867,343,12.4,0.0,3.4e-06,0.0039,149,245,164,279,130,287,0.71,96,115,157
OceanDNA-b16622,278,6.8,0.1,0.00017,0.25,149,180,351,383,222,389,0.71,31,32,167
OceanDNA-b16039,280,4.2,0.1,0.001,1.3,177,223,434,485,429,507,0.71,46,51,78
OceanDNA-b20343,316,11.3,0.1,7.3e-06,0.0027,134,172,132,175,122,178,0.71,38,43,56
OceanDNA-b39756,409,13.7,0.0,2.8e-06,0.00058,108,176,124,197,119,219,0.71,68,73,100
OceanDNA-b484,1486,16.2,0.1,2.4e-07,0.00049,121,219,259,371,206,398,0.71,98,112,192
OceanDNA-b23089,2834,31.4,0.2,1.1e-11,2.1e-08,143,227,152,237,9,269,0.71,84,85,260
OceanDNA-b37238,465,10.3,0.0,1.5e-05,0.029,152,193,580,625,520,635,0.71,41,45,115
OceanDNA-b33520,16,8.0,0.1,7.4e-05,0.039,147,180,49,82,38,95,0.71,33,33,57
OceanDNA-b24003,129,-3.5,0.0,0.47,350.0,109,124,73,88,55,92,0.71,15,15,37
OceanDNA-b2904,2752,10.0,0.5,1.9e-05,0.081,110,183,162,231,97,247,0.71,73,69,150
OceanDNA-b23261,187,11.8,0.0,1e-05,0.012,85,185,50,158,33,196,0.71,100,108,163
OceanDNA-b35371,154,15.5,0.0,3.8e-07,0.00033,100,197,49,149,21,162,0.71,97,100,141
OceanDNA-b30115,454,12.7,0.1,2.8e-06,0.0073,166,244,219,296,213,312,0.71,78,77,99
OceanDNA-b45383,5853,-2.6,0.0,0.13,1100.0,205,224,138,158,131,164,0.71,19,20,33
OceanDNA-b16143,19,2.6,0.0,0.0068,2.9,179,245,414,483,406,494,0.71,66,69,88
OceanDNA-b23139,2350,-2.1,0.0,0.18,220.0,201,241,243,280,235,285,0.71,40,37,50
OceanDNA-b4022,184,0.6,0.0,0.026,16.0,176,217,276,323,271,356,0.71,41,47,85
OceanDNA-b40889,92,2.5,0.0,0.0035,2.3,181,243,265,332,257,338,0.71,62,67,81
OceanDNA-b25128,263,-3.3,0.0,0.42,180.0,11,43,183,215,177,218,0.71,32,32,41
OceanDNA-b36722,252,13.8,0.1,2.6e-06,0.0012,89,224,159,301,91,340,0.71,135,142,249
OceanDNA-b19686,2,57.9,0.0,4.8e-20,2.2e-17,62,282,76,330,63,341,0.71,220,254,278
OceanDNA-b36722,553,2.1,0.0,0.0093,4.6,220,245,242,268,214,287,0.71,25,26,73
OceanDNA-b40634,443,-1.2,0.0,0.097,40.0,195,231,203,240,200,253,0.71,36,37,53
OceanDNA-b42542,274,13.9,0.0,1.2e-06,0.00034,102,212,45,168,18,185,0.71,110,123,167
OceanDNA-b17381,628,15.0,0.0,5.6e-07,0.00057,75,212,255,403,235,412,0.71,137,148,177
OceanDNA-b26937,161,3.0,0.0,0.005,0.57,197,264,309,376,300,384,0.71,67,67,84
OceanDNA-b26197,431,-0.3,0.1,0.026,18.0,192,224,269,304,258,310,0.71,32,35,52
OceanDNA-b23176,189,-2.2,0.0,0.29,720.0,251,269,281,299,272,312,0.71,18,18,40
OceanDNA-b22460,863,10.9,0.0,2e-05,0.034,109,169,200,271,196,278,0.71,60,71,82
OceanDNA-b18035,77,16.9,0.0,1.5e-07,2.7e-05,139,207,230,302,145,308,0.71,68,72,163
OceanDNA-b45128,771,11.2,0.0,7.8e-06,0.008,89,213,48,186,10,201,0.71,124,138,191
OceanDNA-b31131,267,13.9,0.0,2.3e-06,0.00076,125,236,45,158,29,188,0.71,111,113,159
OceanDNA-b17572,742,4.4,0.0,0.00094,0.9,200,265,93,157,66,161,0.71,65,64,95
OceanDNA-b41301,4143,17.6,0.1,2.7e-07,0.00044,72,187,31,164,2,198,0.71,115,133,196
OceanDNA-b36680,368,0.2,0.1,0.017,15.0,178,220,129,171,122,207,0.71,42,42,85
OceanDNA-b28111,1558,17.5,0.0,9.5e-08,0.00019,146,223,114,189,53,193,0.71,77,75,140
OceanDNA-b6768,369,16.9,0.0,1.4e-07,0.00011,152,231,115,198,107,220,0.71,79,83,113
OceanDNA-b30849,481,3.0,0.1,0.0025,2.5,201,264,196,257,182,266,0.71,63,61,84
OceanDNA-b950,1814,-3.1,0.0,0.36,380.0,166,187,56,75,47,90,0.71,21,19,43
OceanDNA-b17030,137,7.4,0.1,0.00012,0.044,146,198,90,145,18,167,0.71,52,55,149
OceanDNA-b21004,811,11.6,0.0,1.7e-05,0.011,148,179,28,60,14,78,0.71,31,32,64
OceanDNA-b36767,303,6.8,0.0,0.00018,0.16,90,122,137,169,125,217,0.71,32,32,92
OceanDNA-b2668,146,-3.1,0.0,0.18,73.0,202,220,121,139,114,150,0.71,18,18,36
OceanDNA-b30021,940,-1.4,0.0,0.055,100.0,124,164,42,81,27,118,0.71,40,39,91
OceanDNA-b6425,553,12.1,0.0,4.2e-06,0.0035,146,193,128,181,60,189,0.71,47,53,129
OceanDNA-b27,3135,12.1,0.3,4.3e-06,0.014,88,175,76,159,51,165,0.71,87,83,114
OceanDNA-b35378,46,8.2,0.1,6.5e-05,0.11,100,193,49,141,21,152,0.71,93,92,131
OceanDNA-b21042,1174,12.1,0.4,4.3e-06,0.011,91,185,322,414,302,418,0.71,94,92,116
OceanDNA-b23603,226,12.7,0.0,2.9e-06,0.0066,161,227,161,230,152,238,0.71,66,69,86
OceanDNA-b21013,3975,11.7,0.0,5.4e-06,0.022,106,215,119,238,107,266,0.71,109,119,159
OceanDNA-b22637,1373,16.2,0.0,2.4e-07,0.00076,148,182,110,146,100,162,0.71,34,36,62
OceanDNA-b20349,336,6.9,0.0,0.00016,0.065,199,274,227,306,208,323,0.71,75,79,115
OceanDNA-b34299,271,-3.3,0.0,0.42,420.0,108,124,72,88,55,95,0.71,16,16,40
OceanDNA-b32606,3261,2.0,0.0,0.0051,23.0,191,243,264,318,250,324,0.71,52,54,74
OceanDNA-b20682,69,20.2,0.0,1.4e-08,4e-06,129,244,25,146,18,162,0.71,115,121,144
OceanDNA-b30226,1919,18.1,0.0,6.2e-08,0.00015,86,181,70,173,45,176,0.71,95,103,131
OceanDNA-b40618,310,129.3,0.1,3.3e-41,5e-39,17,247,44,294,28,346,0.71,230,250,318
OceanDNA-b9927,6,8.1,0.0,7e-05,0.025,145,186,113,154,26,163,0.71,41,41,137
OceanDNA-b31076,1192,3.9,0.0,0.004,3.9,197,249,346,395,313,410,0.71,52,49,97
OceanDNA-b24117,1926,14.1,0.0,2.1e-06,0.0028,74,191,19,143,2,156,0.71,117,124,154
OceanDNA-b44390,296,2.7,0.0,0.0095,2.2,202,263,241,300,228,307,0.7,61,59,79
OceanDNA-b46852,1158,-1.0,0.0,0.12,49.0,153,215,393,460,377,467,0.7,62,67,90
OceanDNA-b26769,766,-1.3,0.0,0.05,100.0,53,73,218,238,175,243,0.7,20,20,68
OceanDNA-b3628,552,8.4,0.0,5.5e-05,0.06,156,188,178,210,97,236,0.7,32,32,139
OceanDNA-b16220,1203,7.1,0.0,0.00028,0.17,193,244,463,517,437,576,0.7,51,54,139
OceanDNA-a1335,150,12.4,0.0,3.3e-06,0.00052,84,171,36,119,20,148,0.7,87,83,128
OceanDNA-b15168,127,3.9,0.0,0.0013,1.3,146,185,93,131,73,137,0.7,39,38,64
OceanDNA-b22616,3382,13.7,0.0,2.7e-06,0.0059,138,188,368,417,349,454,0.7,50,49,105
OceanDNA-b5248,272,14.2,0.0,9.4e-07,0.00064,107,191,550,644,536,655,0.7,84,94,119
OceanDNA-b22443,289,10.4,0.0,1.3e-05,0.033,110,183,520,591,511,603,0.7,73,71,92
OceanDNA-b1719,179,8.3,0.1,0.00012,0.18,103,185,159,240,145,259,0.7,82,81,114
OceanDNA-b332,28,22.9,0.9,2.2e-09,1.7e-06,72,189,23,137,3,142,0.7,117,114,139
OceanDNA-b7503,295,18.1,0.0,6.4e-08,4.9e-05,151,190,153,193,141,230,0.7,39,40,89
OceanDNA-b45518,70,24.6,0.0,6.5e-10,1e-06,150,243,148,243,121,251,0.7,93,95,130
OceanDNA-b45703,674,19.4,0.1,2.5e-08,1.8e-05,183,244,219,280,172,302,0.7,61,61,130
OceanDNA-b13261,8,10.3,0.0,2.9e-05,0.017,77,123,11,60,6,136,0.7,46,49,130
OceanDNA-b20676,199,9.0,0.0,7.7e-05,0.013,200,275,240,321,229,341,0.7,75,81,112
OceanDNA-b1833,1400,23.9,0.4,1.1e-09,1.6e-06,89,223,145,312,137,330,0.7,134,167,193
OceanDNA-b4134,225,10.0,0.0,3.6e-05,0.016,102,170,293,373,262,386,0.7,68,80,124
OceanDNA-b31120,118,-2.4,0.0,0.33,120.0,109,141,74,107,56,115,0.7,32,33,59
OceanDNA-b31573,834,-1.5,0.0,0.11,100.0,198,220,300,322,297,361,0.7,22,22,64
OceanDNA-b3972,255,11.4,0.0,7e-06,0.0043,153,189,587,624,533,640,0.7,36,37,107
OceanDNA-b46648,325,8.3,0.0,6.1e-05,0.15,194,243,254,301,190,303,0.7,49,47,113
OceanDNA-b26781,1409,-3.9,0.0,0.63,550.0,110,133,7,31,4,41,0.7,23,24,37
OceanDNA-b13250,950,10.9,0.3,8.6e-05,0.039,149,191,208,249,126,307,0.7,42,41,181
OceanDNA-b7262,219,4.9,0.1,0.0013,0.25,55,103,375,429,355,434,0.7,48,54,79
OceanDNA-b11616,217,17.7,0.4,8.5e-08,8.5e-05,73,170,174,281,153,293,0.7,97,107,140
OceanDNA-b23131,668,20.4,0.0,1.2e-08,1.2e-05,150,210,148,212,130,218,0.7,60,64,88
OceanDNA-b32,392,2.3,0.0,0.0079,2.4,77,124,121,172,51,197,0.7,47,51,146
OceanDNA-b45257,1554,11.5,0.0,1.3e-05,0.014,101,150,44,95,37,133,0.7,49,51,96
OceanDNA-b21000,2867,21.6,0.3,5.4e-09,1.6e-05,100,171,181,264,173,280,0.7,71,83,107
OceanDNA-b41358,206,10.9,0.1,3.9e-05,0.012,52,183,96,231,39,272,0.7,131,135,233
OceanDNA-b30483,397,1.5,0.1,0.0069,17.0,202,264,197,257,166,259,0.7,62,60,93
OceanDNA-b34384,115,3.8,0.0,0.0055,1.2,165,245,218,299,183,311,0.7,80,81,128
OceanDNA-b23293,1110,6.7,0.2,0.00019,0.27,103,172,58,127,46,141,0.7,69,69,95
OceanDNA-b22872,3058,12.7,0.0,2.7e-06,0.0084,153,191,64,106,44,110,0.7,38,42,66
OceanDNA-b43426,332,-2.1,0.0,0.091,36.0,196,217,223,244,209,277,0.7,21,21,68
OceanDNA-b10437,4,21.1,0.0,7.4e-09,1.9e-06,152,216,224,294,213,342,0.7,64,70,129
OceanDNA-b31945,387,0.5,0.0,0.015,28.0,200,247,200,244,193,265,0.7,47,44,72
OceanDNA-b46050,498,11.3,0.0,7.3e-06,0.0071,153,214,249,311,232,374,0.7,61,62,142
OceanDNA-b23491,1528,15.5,0.1,7.6e-07,0.00069,89,203,111,243,94,263,0.7,114,132,169
OceanDNA-b13174,41,13.0,0.0,2.3e-06,0.0013,134,186,119,165,56,239,0.7,52,46,183
OceanDNA-b112,1144,11.1,0.0,8.3e-06,0.013,128,188,98,153,36,183,0.7,60,55,147
OceanDNA-b17609,3614,10.8,0.0,1e-05,0.048,108,178,152,232,129,250,0.7,70,80,121
OceanDNA-b13250,1592,-3.7,0.0,2.4,1100.0,199,218,248,267,246,281,0.7,19,19,35
OceanDNA-b34767,496,15.9,0.0,5.7e-07,0.00026,133,185,111,162,26,175,0.7,52,51,149
OceanDNA-b16182,508,12.1,0.0,4.1e-06,0.0026,29,120,100,192,80,196,0.7,91,92,116
OceanDNA-b33061,911,18.1,0.0,6.4e-08,0.0002,123,177,139,191,95,274,0.7,54,52,179
OceanDNA-b26893,2504,-3.4,0.0,0.45,740.0,94,128,69,106,66,114,0.7,34,37,48
OceanDNA-b3965,374,-0.9,0.0,0.039,42.0,197,215,208,226,202,251,0.7,18,18,49
OceanDNA-b15450,418,14.6,0.0,1.5e-06,0.0015,81,187,48,162,34,181,0.7,106,114,147
OceanDNA-b26613,119,-1.7,0.0,0.07,39.0,195,217,201,223,175,249,0.7,22,22,74
OceanDNA-b38208,1052,12.0,0.0,4.4e-06,0.012,89,188,69,169,31,183,0.7,99,100,152
OceanDNA-b24146,108,6.1,0.0,0.00029,0.64,189,244,258,309,243,320,0.7,55,51,77
OceanDNA-b35890,2812,2.9,1.2,0.0026,10.0,6,88,88,169,83,173,0.7,82,81,90
OceanDNA-b29542,1230,1.0,0.0,0.021,23.0,204,266,331,391,323,394,0.7,62,60,71
OceanDNA-b16143,250,19.5,0.1,4.7e-08,2e-05,88,176,239,346,196,354,0.7,88,107,158
OceanDNA-b34735,132,-3.9,0.0,0.63,210.0,53,78,491,516,480,525,0.7,25,25,45
OceanDNA-b33394,954,10.4,0.1,2.7e-05,0.035,61,97,239,276,214,295,0.7,36,37,81
OceanDNA-b23370,1686,12.8,0.7,5.1e-06,0.0053,97,175,81,157,75,180,0.7,78,76,105
OceanDNA-b40631,559,5.2,0.0,0.00052,0.29,178,243,271,341,262,347,0.7,65,70,85
OceanDNA-b38325,1042,11.3,0.1,7.5e-06,0.012,102,190,79,172,40,182,0.7,88,93,142
OceanDNA-b30235,805,3.5,0.0,0.0018,5.0,176,213,293,336,278,371,0.7,37,43,93
OceanDNA-b4252,269,0.4,0.0,0.015,38.0,187,228,163,203,150,207,0.7,41,40,57
OceanDNA-b44480,233,-3.1,0.0,0.18,61.0,106,129,100,125,70,132,0.7,23,25,62
OceanDNA-b16139,377,5.1,0.0,0.00056,0.46,53,116,225,291,185,297,0.7,63,66,112
OceanDNA-b24609,149,6.8,0.0,0.00018,0.12,150,185,166,200,153,281,0.7,35,34,128
OceanDNA-b13083,150,1.5,0.0,0.0071,17.0,204,265,239,298,228,302,0.7,61,59,74
OceanDNA-b36858,388,23.0,0.0,2e-09,1.5e-06,153,244,196,291,169,309,0.7,91,95,140
OceanDNA-b22828,2407,19.2,0.0,2.9e-08,0.00012,131,246,134,248,123,274,0.7,115,114,151
OceanDNA-b42600,70,12.7,0.0,2.8e-06,0.00077,147,228,169,254,155,262,0.7,81,85,107
OceanDNA-b30641,995,12.1,0.1,8.3e-06,0.0045,161,195,148,186,69,192,0.7,34,38,123
OceanDNA-b40768,273,20.6,0.1,2.1e-08,6.6e-06,62,185,36,175,27,207,0.7,123,139,180
OceanDNA-b24965,1095,16.8,0.0,1.5e-07,0.0003,75,190,27,146,6,173,0.7,115,119,167
OceanDNA-b34946,337,9.4,0.1,2.8e-05,0.02,103,185,69,150,39,169,0.7,82,81,130
OceanDNA-b37529,835,24.6,0.2,6.6e-10,1.3e-06,74,230,82,260,12,279,0.7,156,178,267
OceanDNA-b34615,91,14.7,0.2,6.7e-07,0.0006,34,201,80,248,47,307,0.7,167,168,260
OceanDNA-b40685,499,16.4,0.0,4.3e-07,0.00024,195,245,224,272,196,294,0.7,50,48,98
OceanDNA-b22406,759,11.3,0.0,3.7e-05,0.022,109,190,170,258,165,266,0.7,81,88,101
OceanDNA-b23976,1658,0.4,0.0,0.015,26.0,229,264,229,265,192,270,0.7,35,36,78
OceanDNA-b17563,1730,11.3,0.0,2.2e-05,0.016,147,198,138,198,122,203,0.7,51,60,81
OceanDNA-b26636,3007,13.3,0.0,3.5e-06,0.0068,111,245,60,197,20,212,0.7,134,137,192
OceanDNA-b46897,281,1.4,0.0,0.0076,6.6,35,86,29,77,5,81,0.7,51,48,76
OceanDNA-b37154,416,8.6,0.0,4.8e-05,0.03,90,183,82,182,69,205,0.7,93,100,136
OceanDNA-b22849,589,10.9,0.0,3e-05,0.02,108,171,171,245,163,256,0.7,63,74,93
OceanDNA-b32135,345,15.3,0.0,4.6e-07,0.0012,106,179,80,168,42,178,0.7,73,88,136
OceanDNA-b23108,1029,22.6,0.0,5.2e-09,5.3e-06,108,212,349,474,339,488,0.7,104,125,149
OceanDNA-b31969,612,-3.0,0.0,0.17,240.0,199,243,338,384,335,386,0.7,44,46,51
OceanDNA-b37613,422,17.9,0.0,7.1e-08,0.00014,107,215,63,185,36,194,0.7,108,122,158
OceanDNA-b22893,1361,17.2,0.0,3.6e-07,0.00028,85,211,505,641,495,666,0.7,126,136,171
OceanDNA-b31152,265,3.9,0.0,0.0027,1.1,199,246,248,294,242,316,0.7,47,46,74
OceanDNA-b31695,307,8.3,0.0,6e-05,0.11,126,184,517,577,485,587,0.7,58,60,102
OceanDNA-b40235,671,-3.3,0.0,0.21,150.0,163,186,18,41,15,58,0.7,23,23,43
OceanDNA-b26197,431,14.0,0.1,1.1e-06,0.0008,151,188,139,176,62,181,0.7,37,37,119
OceanDNA-b35069,891,17.5,0.0,1.9e-07,8.8e-05,82,186,56,167,48,175,0.7,104,111,127
OceanDNA-b33411,617,10.8,0.0,2e-05,0.013,96,169,95,166,85,184,0.7,73,71,99
OceanDNA-b20657,149,1.8,0.0,0.012,1.8,193,243,180,228,174,247,0.7,50,48,73
OceanDNA-b14001,78,15.1,0.0,5.3e-07,0.00012,129,214,64,159,54,169,0.7,85,95,115
OceanDNA-b23551,407,13.3,0.0,3.7e-06,0.0028,161,227,132,201,126,209,0.7,66,69,83
OceanDNA-b44694,1736,-2.6,0.0,0.13,510.0,107,124,76,93,42,101,0.7,17,17,59
OceanDNA-b16510,1060,15.0,0.2,5.7e-07,0.00077,88,175,235,335,218,343,0.69,87,100,125
OceanDNA-a3708,129,7.6,0.0,0.0001,0.033,93,173,228,321,222,331,0.69,80,93,109
OceanDNA-b21008,2230,15.1,0.1,5.2e-07,0.0014,129,244,84,205,19,212,0.69,115,121,193
OceanDNA-b19355,313,19.0,0.0,3.3e-08,1.2e-05,151,218,157,226,133,253,0.69,67,69,120
OceanDNA-b41526,837,28.6,0.1,7.7e-11,4.2e-08,77,231,84,255,81,273,0.69,154,171,192
OceanDNA-b15726,327,16.1,0.0,2.5e-07,0.00022,134,197,93,150,23,164,0.69,63,57,141
OceanDNA-b16212,559,-3.1,0.1,0.19,210.0,62,85,23,44,19,47,0.69,23,21,28
OceanDNA-b31981,888,6.3,0.1,0.00051,0.59,113,182,103,175,89,186,0.69,69,72,97
OceanDNA-b32052,711,11.2,0.0,1.5e-05,0.015,105,195,562,662,538,668,0.69,90,100,130
OceanDNA-b17714,1521,17.6,0.0,8.9e-08,0.00019,149,216,159,226,142,239,0.69,67,67,97
OceanDNA-b272,1587,10.6,0.0,1.2e-05,0.032,101,186,44,128,15,198,0.69,85,84,183
OceanDNA-b24875,724,-0.9,0.0,0.039,66.0,24,72,36,84,14,88,0.69,48,48,74
OceanDNA-b11531,252,12.6,0.0,3e-06,0.0013,80,175,88,197,83,213,0.69,95,109,130
OceanDNA-b30225,956,15.8,0.0,3.1e-07,0.0008,153,211,146,206,129,214,0.69,58,60,85
OceanDNA-b6771,503,12.2,0.0,1.2e-05,0.0038,89,182,119,226,102,233,0.69,93,107,131
OceanDNA-b44662,1421,0.6,0.1,0.027,37.0,55,98,522,568,512,575,0.69,43,46,63
OceanDNA-b23324,307,5.6,0.1,0.00039,0.15,194,270,196,270,188,294,0.69,76,74,106
OceanDNA-b36430,1104,-1.8,0.0,0.071,150.0,229,245,281,297,236,317,0.69,16,16,81
OceanDNA-b43,3904,13.4,0.0,1.6e-06,0.011,151,212,62,127,46,164,0.69,61,65,118
OceanDNA-b23108,845,14.2,0.0,2e-06,0.002,150,254,221,340,212,351,0.69,104,119,139
OceanDNA-b30238,288,11.4,0.0,7e-06,0.014,135,198,93,158,55,179,0.69,63,65,124
OceanDNA-b22423,1643,-3.8,0.0,0.58,680.0,33,51,357,375,352,386,0.69,18,18,34
OceanDNA-b276,1268,30.3,0.0,3.6e-11,2.8e-08,153,244,56,149,19,171,0.69,91,93,152
OceanDNA-b27544,463,15.1,0.1,5e-07,0.00079,136,198,76,140,24,182,0.69,62,64,158
OceanDNA-b22394,801,5.8,0.0,0.00071,0.69,149,171,462,484,407,489,0.69,22,22,82
OceanDNA-b37653,1001,33.1,0.2,1.7e-12,1.8e-09,88,244,147,322,141,334,0.69,156,175,193
OceanDNA-b11344,671,32.5,0.0,2.5e-12,1.8e-09,94,250,85,249,40,257,0.69,156,164,217
OceanDNA-b35318,70,4.0,0.0,0.0012,1.2,200,261,197,257,192,261,0.69,61,60,69
OceanDNA-b34544,56,3.0,0.0,0.0048,1.8,165,252,218,306,184,314,0.69,87,88,130
OceanDNA-b13541,1191,-3.6,0.0,0.26,360.0,202,258,306,362,300,368,0.69,56,56,68
OceanDNA-b13244,222,11.6,0.0,6e-06,0.0083,77,188,24,147,7,176,0.69,111,123,169
OceanDNA-b3912,1924,10.9,0.0,2e-05,0.019,97,170,112,183,70,204,0.69,73,71,134
OceanDNA-b31521,1422,5.5,0.1,0.00044,0.92,199,256,192,244,180,257,0.69,57,52,77
OceanDNA-b3712,1818,16.3,0.0,4.6e-07,0.00047,101,177,174,256,132,267,0.69,76,82,135
OceanDNA-b3920,492,18.1,0.0,1.3e-07,0.00012,153,189,365,402,347,443,0.69,36,37,96
OceanDNA-b22610,773,6.1,0.0,0.00027,0.27,142,189,114,162,56,173,0.69,47,48,117
OceanDNA-b36071,125,15.4,0.2,8.6e-07,0.00088,104,196,59,154,28,165,0.69,92,95,137
OceanDNA-b6574,177,-3.7,0.0,0.55,240.0,67,104,276,312,272,314,0.69,37,36,42
OceanDNA-b4471,6,19.5,0.0,2.4e-08,5.2e-06,101,184,241,335,210,359,0.69,83,94,149
OceanDNA-b36897,631,-1.6,0.0,0.065,80.0,92,123,51,85,26,96,0.69,31,34,70
OceanDNA-b40967,187,44.0,0.4,8e-16,2.5e-12,99,268,91,260,3,285,0.69,169,169,282
OceanDNA-b15459,1164,8.4,0.0,5.8e-05,0.07,75,187,24,135,1,154,0.69,112,111,153
OceanDNA-b24966,964,11.0,0.0,8.9e-06,0.014,133,171,127,170,117,231,0.69,38,43,114
OceanDNA-b28083,1033,10.4,0.1,2.8e-05,0.024,107,198,57,151,35,173,0.69,91,94,138
OceanDNA-b269,1802,28.4,0.0,1.3e-10,9.2e-08,126,243,148,269,140,290,0.69,117,121,150
OceanDNA-b269,302,10.1,0.1,5.2e-05,0.036,105,186,133,229,125,270,0.69,81,96,145
OceanDNA-b13674,206,4.1,0.1,0.0012,0.26,56,121,55,124,42,129,0.69,65,69,87
OceanDNA-b34217,652,16.8,0.0,1.6e-07,0.0002,148,195,69,116,6,125,0.69,47,47,119
OceanDNA-b39458,463,-3.1,0.0,0.19,99.0,182,213,296,333,269,344,0.69,31,37,75
OceanDNA-b3545,477,30.3,0.0,1.2e-11,8.7e-09,89,240,70,228,46,244,0.69,151,158,198
OceanDNA-b8544,124,-2.5,0.0,0.12,22.0,199,227,215,242,208,251,0.69,28,27,43
OceanDNA-b19934,261,18.6,0.0,4.6e-08,1.7e-05,124,192,266,338,261,360,0.69,68,72,99
OceanDNA-b23850,133,13.2,0.0,5.8e-06,0.0029,104,192,637,734,609,742,0.69,88,97,133
OceanDNA-b15541,1753,17.8,0.0,1.6e-07,0.00015,106,209,139,255,130,270,0.69,103,116,140
OceanDNA-b41340,879,7.2,0.1,0.00026,0.19,77,179,19,125,3,158,0.69,102,106,155
OceanDNA-b45520,838,23.6,0.0,2.6e-09,1.9e-06,150,218,171,241,144,274,0.69,68,70,130
OceanDNA-b34725,188,6.3,0.0,0.0005,0.18,75,181,398,514,381,523,0.69,106,116,142
OceanDNA-b26837,1569,11.4,0.2,6.8e-06,0.02,129,169,88,130,40,147,0.69,40,42,107
OceanDNA-b45094,335,13.7,0.0,1.3e-06,0.0013,77,188,25,148,4,192,0.69,111,123,188
OceanDNA-b19147,46,4.9,0.0,0.0013,0.24,154,184,306,336,271,350,0.69,30,30,79
OceanDNA-b23519,926,-0.4,0.0,0.052,40.0,188,243,297,353,291,361,0.69,55,56,70
OceanDNA-b20977,3170,10.6,0.0,3.7e-05,0.046,151,225,216,292,205,313,0.69,74,76,108
OceanDNA-b8956,293,23.1,0.0,1.9e-09,5.7e-07,138,211,116,193,106,202,0.69,73,77,96
OceanDNA-b20897,2001,-1.4,0.0,0.055,150.0,158,180,124,146,114,160,0.69,22,22,46
OceanDNA-b22650,2148,12.8,0.0,5.1e-06,0.0061,111,186,102,178,82,186,0.69,75,76,104
OceanDNA-b23508,519,6.4,0.0,0.00022,0.34,198,261,203,267,196,271,0.69,63,64,75
OceanDNA-b21002,2868,22.4,0.1,6.1e-09,1.7e-05,85,244,225,399,219,405,0.69,159,174,186
OceanDNA-b20909,1214,10.4,0.1,2.8e-05,0.1,105,190,196,283,180,290,0.69,85,87,110
OceanDNA-b41688,10,0.5,0.0,0.015,3.1,202,262,199,262,190,264,0.69,60,63,74
OceanDNA-b22518,1323,-3.5,0.0,0.24,890.0,89,110,502,523,495,526,0.69,21,21,31
OceanDNA-b13073,695,-3.2,0.0,0.19,170.0,149,185,91,128,86,139,0.69,36,37,53
OceanDNA-b41553,665,36.0,0.0,2.2e-13,2.6e-10,104,271,201,392,180,407,0.69,167,191,227
OceanDNA-b13544,146,-1.1,0.0,0.043,51.0,181,215,195,232,193,278,0.69,34,37,85
OceanDNA-b16112,176,13.3,0.0,1.9e-06,0.00091,139,180,69,104,56,183,0.69,41,35,127
OceanDNA-b2722,200,9.2,0.0,3.1e-05,0.018,108,197,57,149,35,164,0.69,89,92,129
OceanDNA-b15473,124,16.3,0.0,2.2e-07,0.00012,86,197,41,161,30,168,0.69,111,120,138
OceanDNA-b30739,776,-2.6,0.0,0.12,170.0,77,104,271,297,258,300,0.69,27,26,42
OceanDNA-b39,2116,11.9,0.0,9.7e-06,0.034,147,179,182,214,162,237,0.69,32,32,75
OceanDNA-b32865,275,15.6,0.1,3.7e-07,0.00019,112,223,69,178,56,197,0.69,111,109,141
OceanDNA-b3547,369,-1.9,0.0,0.075,55.0,197,228,220,249,214,277,0.69,31,29,63
OceanDNA-b28170,113,2.7,0.0,0.003,7.9,157,214,57,116,42,131,0.69,57,59,89
OceanDNA-b9777,817,12.2,0.0,4e-06,0.005,152,180,120,146,61,158,0.69,28,26,97
OceanDNA-b39,3911,6.1,0.0,0.00058,2.0,107,185,123,200,102,217,0.68,78,77,115
OceanDNA-b32152,3251,-4.0,0.0,0.65,1100.0,94,122,146,177,145,186,0.68,28,31,41
OceanDNA-b3301,2382,11.6,0.1,5.9e-06,0.016,109,185,294,378,245,393,0.68,76,84,148
OceanDNA-b3034,104,15.0,0.0,5.5e-07,0.00014,93,208,27,143,19,167,0.68,115,116,148
OceanDNA-b16039,280,11.6,0.0,6.1e-06,0.0074,76,120,274,319,203,403,0.68,44,45,200
OceanDNA-b29496,1411,19.5,0.0,4.7e-08,6.2e-05,154,211,139,198,124,246,0.68,57,59,122
OceanDNA-b40245,298,2.1,0.1,0.0092,3.4,230,264,241,276,206,279,0.68,34,35,73
OceanDNA-b5274,115,10.5,0.0,1.3e-05,0.0085,107,191,539,633,508,644,0.68,84,94,136
OceanDNA-b20977,2184,14.8,0.0,1.9e-06,0.0023,140,189,192,246,144,254,0.68,49,54,110
OceanDNA-b28083,1033,-1.5,0.0,0.12,100.0,124,164,25,64,22,67,0.68,40,39,45
OceanDNA-b39492,519,19.6,0.0,2.1e-08,1.7e-05,141,214,127,204,113,221,0.68,73,77,108
OceanDNA-b5526,379,12.2,0.0,7.7e-06,0.002,107,192,542,634,509,648,0.68,85,92,139
OceanDNA-b22017,4207,-1.0,0.0,0.041,230.0,211,251,472,509,457,533,0.68,40,37,76
OceanDNA-b38872,355,8.3,0.0,5.9e-05,0.039,106,187,51,131,35,151,0.68,81,80,116
OceanDNA-b26917,1026,8.5,0.1,0.00011,0.086,76,127,51,102,27,165,0.68,51,51,138
OceanDNA-b4022,184,-4.1,0.0,0.73,450.0,198,225,55,83,43,88,0.68,27,28,45
OceanDNA-b22333,591,16.0,0.1,2.8e-07,0.0008,122,218,148,243,142,285,0.68,96,95,143
OceanDNA-b20998,1644,14.6,0.1,7.5e-07,0.0029,89,185,152,261,128,272,0.68,96,109,144
OceanDNA-b17083,134,3.4,0.0,0.0019,1.8,198,248,238,283,231,294,0.68,50,45,63
OceanDNA-b20184,195,14.0,0.0,1.1e-06,0.00062,83,179,51,150,42,152,0.68,96,99,110
OceanDNA-b45131,359,-1.7,0.1,0.066,84.0,202,253,269,318,261,322,0.68,51,49,61
OceanDNA-b23634,1957,12.6,0.3,9e-06,0.0074,75,190,70,186,4,211,0.68,115,116,207
OceanDNA-b1347,737,29.7,0.1,5.4e-11,2.6e-08,88,244,195,365,186,384,0.68,156,170,198
OceanDNA-b35240,640,7.8,0.0,8.4e-05,0.089,174,246,253,339,250,349,0.68,72,86,99
OceanDNA-b30157,926,0.6,0.0,0.013,27.0,203,266,210,271,198,273,0.68,63,61,75
OceanDNA-b23949,1238,8.1,0.3,6.9e-05,0.13,77,172,94,208,34,236,0.68,95,114,202
OceanDNA-b4594,24,4.9,0.1,0.00067,0.33,161,197,107,147,22,153,0.68,36,40,131
OceanDNA-b1522,751,14.4,0.0,2.5e-06,0.00083,63,185,25,141,7,153,0.68,122,116,146
OceanDNA-b33424,401,12.4,0.1,3.5e-06,0.0035,88,180,38,126,20,136,0.68,92,88,116
OceanDNA-b906,322,18.3,0.0,5.5e-08,2.4e-05,79,191,75,201,69,236,0.68,112,126,167
OceanDNA-b22383,761,-3.9,0.0,0.61,1100.0,253,283,305,337,302,339,0.68,30,32,37
OceanDNA-b40797,403,10.7,0.2,1.2e-05,0.012,90,185,42,150,19,182,0.68,95,108,163
OceanDNA-b46199,1168,10.9,0.0,2.9e-05,0.014,142,188,77,122,28,131,0.68,46,45,103
OceanDNA-b314,121,28.3,3.4,4.9e-11,4.1e-08,75,221,96,266,75,291,0.68,146,170,216
OceanDNA-b27533,1795,11.6,0.0,1.2e-05,0.015,160,227,97,167,73,230,0.68,67,70,157
OceanDNA-b7440,29,-2.3,0.0,0.1,34.0,38,72,300,333,293,337,0.68,34,33,44
OceanDNA-b23551,393,1.5,0.0,0.015,11.0,199,224,164,191,158,228,0.68,25,27,70
OceanDNA-b17618,82,12.3,0.1,3.6e-06,0.0053,94,193,66,165,57,175,0.68,99,99,118
OceanDNA-b740,193,11.7,0.1,5.8e-06,0.0027,90,213,147,275,137,301,0.68,123,128,164
OceanDNA-b43839,38,3.3,0.1,0.002,3.6,144,175,88,119,69,133,0.68,31,31,64
OceanDNA-b26636,3711,14.3,0.0,1.7e-06,0.0034,80,133,73,129,55,152,0.68,53,56,97
OceanDNA-b23148,295,20.0,0.0,3.2e-08,4.2e-05,93,229,383,539,373,553,0.68,136,156,180
OceanDNA-b35371,154,-0.1,0.1,0.022,19.0,203,263,196,254,186,262,0.68,60,58,76
OceanDNA-b13844,27,-2.9,0.0,0.16,47.0,86,120,92,125,82,128,0.68,34,33,46
OceanDNA-b45442,215,6.0,0.0,0.00031,0.46,155,190,101,136,21,151,0.68,35,35,130
OceanDNA-b466,1643,15.9,0.0,5.7e-07,0.00084,123,219,227,337,221,364,0.68,96,110,143
OceanDNA-b12523,276,31.3,0.0,6.1e-12,1.9e-09,130,244,119,239,54,251,0.68,114,120,197
OceanDNA-b45789,15,1.6,0.0,0.013,3.7,197,262,180,242,162,245,0.68,65,62,83
OceanDNA-b13273,1079,13.2,0.0,1.9e-06,0.0021,79,245,62,233,43,241,0.68,166,171,198
OceanDNA-b37652,816,-1.5,0.0,0.12,75.0,137,183,15,63,11,84,0.68,46,48,73
OceanDNA-b31012,111,-2.5,0.0,0.12,62.0,229,245,251,267,240,281,0.68,16,16,41
OceanDNA-b1333,679,12.5,0.1,9.9e-06,0.0052,105,187,51,144,9,151,0.68,82,93,142
OceanDNA-b32277,85,10.6,0.0,2.5e-05,0.026,62,189,75,214,54,258,0.68,127,139,204
OceanDNA-b10020,85,3.9,0.0,0.0026,0.64,104,185,61,141,37,159,0.68,81,80,122
OceanDNA-b15853,1523,19.6,0.2,4.3e-08,4e-05,75,212,89,239,13,257,0.68,137,150,244
OceanDNA-b6164,300,9.9,0.0,1.9e-05,0.014,147,181,78,113,49,127,0.68,34,35,78
OceanDNA-b20907,2112,22.0,0.8,4.1e-09,2.2e-05,110,245,199,343,180,352,0.68,135,144,172
OceanDNA-b45663,568,9.6,0.0,5e-05,0.022,143,197,89,144,25,148,0.68,54,55,123
OceanDNA-b3655,170,11.6,0.0,1.2e-05,0.0046,139,198,77,137,20,149,0.68,59,60,129
OceanDNA-b34217,652,2.6,0.0,0.0034,4.4,193,245,162,215,145,233,0.68,52,53,88
OceanDNA-b43651,721,11.4,0.1,6.9e-06,0.0067,123,244,97,216,57,234,0.68,121,119,177
OceanDNA-b23229,485,-3.4,0.0,0.44,310.0,259,287,26,52,12,57,0.68,28,26,45
OceanDNA-b36456,1321,5.4,0.0,0.00046,1.0,63,179,53,174,16,186,0.68,116,121,170
OceanDNA-b7203,304,15.2,0.0,4.6e-07,0.00033,98,213,119,244,61,255,0.68,115,125,194
OceanDNA-b40237,535,-3.3,0.0,0.2,150.0,163,202,16,54,13,57,0.68,39,38,44
OceanDNA-b23832,3,7.8,0.0,0.00017,0.15,136,185,396,443,326,471,0.68,49,47,145
OceanDNA-b3909,233,14.4,0.0,1.7e-06,0.001,141,207,108,173,103,205,0.68,66,65,102
OceanDNA-b20726,68,-1.3,0.0,0.051,8.5,221,270,257,304,230,325,0.68,49,47,95
OceanDNA-b16210,467,26.4,0.6,3.6e-10,2e-07,78,181,301,427,228,443,0.68,103,126,215
OceanDNA-b46265,580,11.5,0.1,1.3e-05,0.011,150,185,147,182,87,202,0.67,35,35,115
OceanDNA-b22801,848,9.9,0.1,3.8e-05,0.048,152,195,234,280,153,284,0.67,43,46,131
OceanDNA-b21043,1237,20.1,0.0,4.7e-08,2.8e-05,100,246,209,355,187,404,0.67,146,146,217
OceanDNA-b20962,2408,-3.4,0.0,0.45,1200.0,107,124,108,125,91,140,0.67,17,17,49
OceanDNA-b26842,552,-0.7,0.1,0.033,75.0,250,282,417,451,405,460,0.67,32,34,55
OceanDNA-b15711,972,12.6,0.0,6e-06,0.0034,153,243,163,258,150,264,0.67,90,95,114
OceanDNA-b17056,36,8.4,0.0,5.6e-05,0.015,89,150,39,104,31,120,0.67,61,65,89
OceanDNA-b6582,313,3.0,0.0,0.0024,1.5,157,178,97,118,87,194,0.67,21,21,107
OceanDNA-b37508,143,9.5,0.2,2.6e-05,0.051,86,185,46,142,18,151,0.67,99,96,133
OceanDNA-b25279,160,-2.8,0.0,0.15,31.0,174,191,227,244,223,286,0.67,17,17,63
OceanDNA-b26913,1501,8.1,7.9,6.9e-05,0.14,12,99,9,101,1,105,0.67,87,92,104
OceanDNA-b31581,1882,4.0,0.0,0.0012,2.8,97,168,120,189,110,201,0.67,71,69,91
OceanDNA-b15938,254,-2.4,0.0,0.11,33.0,198,214,222,239,216,267,0.67,16,17,51
OceanDNA-b30224,1631,4.8,0.0,0.0007,1.3,177,219,237,285,229,316,0.67,42,48,87
OceanDNA-b36144,1955,18.2,0.2,1.2e-07,0.00015,104,190,160,268,145,291,0.67,86,108,146
OceanDNA-b26870,727,-3.6,0.0,0.26,790.0,250,276,383,409,377,422,0.67,26,26,45
OceanDNA-b37508,143,1.0,0.0,0.01,20.0,197,220,227,251,157,276,0.67,23,24,119
OceanDNA-b3909,235,16.0,0.0,5.4e-07,0.00034,152,225,160,241,142,250,0.67,73,81,108
OceanDNA-b36441,2119,10.0,0.0,3.7e-05,0.052,139,211,150,229,141,269,0.67,72,79,128
OceanDNA-b6820,3,8.4,0.0,5.5e-05,0.028,154,202,90,143,66,169,0.67,48,53,103
OceanDNA-b950,1814,10.2,0.0,3.1e-05,0.033,152,191,170,214,150,244,0.67,39,44,94
OceanDNA-b1358,1852,16.3,0.5,2.1e-07,0.00063,146,199,100,151,38,171,0.67,53,51,133
OceanDNA-b33307,615,9.1,0.1,3.3e-05,0.11,146,187,135,175,74,194,0.67,41,40,120
OceanDNA-b30157,926,11.2,0.2,7.8e-06,0.016,136,198,100,164,59,188,0.67,62,64,129
OceanDNA-b23396,1251,18.4,0.0,9.9e-08,0.0001,109,188,103,179,83,222,0.67,79,76,139
OceanDNA-b12501,1285,-0.7,0.0,0.034,49.0,189,228,209,250,196,288,0.67,39,41,92
OceanDNA-b40913,598,15.7,0.3,3.3e-07,0.00043,76,218,99,260,94,283,0.67,142,161,189
OceanDNA-b21028,518,16.1,0.0,5e-07,0.00065,89,244,99,281,93,288,0.67,155,182,195
OceanDNA-b33070,487,13.4,0.0,1.6e-06,0.0015,107,186,58,143,20,155,0.67,79,85,135
OceanDNA-b1154,1338,13.1,0.0,2.1e-06,0.0037,110,195,221,317,213,323,0.67,85,96,110
OceanDNA-b13590,599,23.3,0.6,6.6e-09,4.8e-06,138,225,347,438,272,458,0.67,87,91,186
OceanDNA-b20559,114,7.8,0.0,8.5e-05,0.026,125,192,211,280,201,340,0.67,67,69,139
OceanDNA-b23273,1319,0.9,0.0,0.011,24.0,153,186,313,350,307,360,0.67,33,37,53
OceanDNA-b19575,372,16.5,0.1,1.9e-07,7.1e-05,53,180,23,142,16,154,0.67,127,119,138
OceanDNA-b25939,345,-1.3,0.0,0.05,20.0,197,263,309,375,302,383,0.67,66,66,81
OceanDNA-b3385,1277,12.8,0.1,5e-06,0.0086,87,191,102,233,86,243,0.67,104,131,157
OceanDNA-b37601,1414,13.3,0.1,1.8e-06,0.0027,89,182,115,219,99,245,0.67,93,104,146
OceanDNA-b25927,19,-1.6,0.0,0.064,21.0,197,263,300,366,294,392,0.67,66,66,98
OceanDNA-b36076,862,3.0,0.1,0.005,6.4,138,176,186,225,165,282,0.67,38,39,117
OceanDNA-b23603,226,-2.0,0.0,0.081,190.0,188,246,293,347,283,368,0.67,58,54,85
OceanDNA-b3658,1305,14.7,0.1,1.4e-06,0.00094,72,192,66,193,32,200,0.67,120,127,168
OceanDNA-b37154,416,-0.2,0.0,0.023,14.0,205,259,276,326,267,332,0.67,54,50,65
OceanDNA-b44609,332,7.0,0.0,0.00029,0.27,198,248,620,670,615,689,0.67,50,50,74
OceanDNA-b5215,68,2.7,0.0,0.0032,0.91,192,228,199,234,194,275,0.67,36,35,81
OceanDNA-b19147,356,-0.3,0.0,0.051,9.1,130,175,119,165,114,177,0.67,45,46,63
OceanDNA-b26756,121,-3.7,0.0,0.28,380.0,94,121,54,84,51,86,0.67,27,30,35
OceanDNA-b19928,527,15.6,0.0,3.5e-07,0.00021,129,192,271,338,264,360,0.67,63,67,96
OceanDNA-b33100,1988,-3.5,0.0,0.23,530.0,189,216,261,288,259,293,0.67,27,27,34
OceanDNA-b12070,90,9.8,0.0,2.1e-05,0.0062,103,183,50,124,35,136,0.67,80,74,101
OceanDNA-b3869,277,12.1,0.0,4.2e-06,0.0024,152,244,155,250,98,265,0.67,92,95,167
OceanDNA-b21873,149,12.6,0.0,3e-06,0.00058,156,189,102,136,18,145,0.67,33,34,127
OceanDNA-b33397,92,11.9,0.0,5e-06,0.0015,79,212,30,176,12,224,0.67,133,146,212
OceanDNA-b38547,302,12.5,0.0,3.2e-06,0.0021,139,201,63,129,12,147,0.67,62,66,135
OceanDNA-b40733,387,10.4,0.2,1.3e-05,0.0065,82,180,102,222,75,231,0.67,98,120,156
OceanDNA-b26794,727,-4.0,0.0,0.35,820.0,199,215,229,245,226,257,0.67,16,16,31
OceanDNA-b16143,19,15.1,0.0,1e-06,0.00045,78,180,256,374,252,390,0.67,102,118,138
OceanDNA-b15507,1408,12.1,0.1,4.2e-06,0.008,79,197,43,170,23,179,0.67,118,127,156
OceanDNA-b34782,645,3.3,0.0,0.002,1.3,35,90,79,137,63,146,0.67,55,58,83
OceanDNA-b26380,46,20.3,0.1,1.4e-08,1.1e-05,90,191,47,153,41,171,0.66,101,106,130
OceanDNA-b34564,654,-1.7,0.0,0.069,51.0,198,229,236,267,232,291,0.66,31,31,59
OceanDNA-b38907,339,-2.8,0.0,0.15,140.0,12,47,689,727,685,739,0.66,35,38,54
OceanDNA-b1820,355,19.9,0.8,3.5e-08,3.7e-05,105,243,175,342,150,347,0.66,138,167,197
OceanDNA-b4143,1413,5.7,0.0,0.0011,0.61,100,185,54,138,31,160,0.66,85,84,129
OceanDNA-b12699,83,7.3,0.0,0.00012,0.051,155,181,81,107,14,117,0.66,26,26,103
OceanDNA-b46695,66,15.8,0.1,1.6e-06,0.00069,11,177,100,278,93,297,0.66,166,178,204
OceanDNA-b12096,376,3.8,0.0,0.0014,1.1,100,197,49,149,26,162,0.66,97,100,136
OceanDNA-b1333,1154,12.6,0.0,9.1e-06,0.0048,110,195,502,598,495,604,0.66,85,96,109
OceanDNA-b262,3012,23.1,0.0,1.9e-09,6.9e-06,152,188,176,212,154,285,0.66,36,36,131
OceanDNA-b4512,63,11.9,0.0,4.9e-06,0.0033,86,192,510,622,498,635,0.66,106,112,137
OceanDNA-b30168,970,16.3,0.0,2.3e-07,0.00035,108,190,143,223,118,253,0.66,82,80,135
OceanDNA-b23400,399,-1.3,0.1,0.052,110.0,66,104,229,271,215,310,0.66,38,42,95
OceanDNA-b41587,636,11.2,0.0,1.6e-05,0.0053,130,198,216,290,178,299,0.66,68,74,121
OceanDNA-b31521,1422,15.7,0.1,3.3e-07,0.00069,124,195,74,144,8,174,0.66,71,70,166
OceanDNA-b1751,2372,-2.5,0.0,0.11,320.0,24,55,156,188,148,221,0.66,31,32,73
OceanDNA-b10020,332,13.3,0.0,3.6e-06,0.00089,152,190,599,638,542,650,0.66,38,39,108
OceanDNA-b30719,763,11.7,0.3,5.5e-06,0.0069,156,214,138,196,29,204,0.66,58,58,175
OceanDNA-b46916,2442,16.4,0.1,4.1e-07,0.0011,138,246,214,325,206,333,0.66,108,111,127
OceanDNA-b23055,42,36.6,0.0,2.9e-13,1.1e-10,93,246,109,274,47,281,0.66,153,165,234
OceanDNA-b32135,345,-0.7,0.0,0.034,89.0,195,244,213,263,204,272,0.66,49,50,68
OceanDNA-b42821,541,13.5,0.0,1.6e-06,0.0014,158,184,159,185,136,231,0.66,26,26,95
OceanDNA-b17273,796,14.5,0.0,1.5e-06,0.0019,154,187,187,220,177,288,0.66,33,33,111
OceanDNA-b15769,787,18.0,0.1,2.6e-07,0.00011,85,202,32,158,12,168,0.66,117,126,156
OceanDNA-b17563,670,18.0,0.0,2.1e-07,0.00015,109,217,80,198,50,216,0.66,108,118,166
OceanDNA-b34551,807,-2.7,0.0,0.28,120.0,198,228,238,268,235,292,0.66,30,30,57
OceanDNA-b3323,1598,18.2,0.2,1.2e-07,0.0002,106,185,181,265,133,275,0.66,79,84,142
OceanDNA-b32682,108,26.8,0.5,1.4e-10,2.8e-07,76,243,86,298,57,341,0.66,167,212,284
OceanDNA-b37345,318,29.8,0.0,5.1e-11,2.4e-08,89,271,17,227,9,244,0.66,182,210,235
OceanDNA-b1347,1187,32.1,0.5,1.1e-11,5.1e-09,88,223,125,290,116,313,0.66,135,165,197
OceanDNA-b45279,1373,10.1,0.0,1.7e-05,0.028,151,176,149,174,121,257,0.66,25,25,136
OceanDNA-b27445,13,-1.9,0.0,0.077,17.0,198,247,300,346,294,361,0.66,49,46,67
OceanDNA-b22187,300,11.1,0.1,8.5e-06,0.026,105,189,80,171,71,177,0.66,84,91,106
OceanDNA-b4251,445,12.8,0.0,2.6e-06,0.003,110,187,144,221,88,233,0.66,77,77,145
OceanDNA-b30622,11,-3.2,0.0,0.19,130.0,107,136,77,108,62,120,0.66,29,31,58
OceanDNA-b20782,503,0.6,0.0,0.027,13.0,199,245,218,262,207,283,0.66,46,44,76
OceanDNA-b20756,163,48.1,0.0,4.4e-17,1.3e-14,72,246,96,298,73,338,0.65,174,202,265
OceanDNA-b15879,586,19.7,0.0,4.1e-08,3.6e-05,148,192,122,166,30,188,0.65,44,44,158
OceanDNA-a4358,55,6.9,0.0,0.00016,0.057,183,231,376,427,367,447,0.65,48,51,80
OceanDNA-b1765,1396,-1.0,0.2,0.04,93.0,16,49,58,91,25,111,0.65,33,33,86
OceanDNA-a4078,317,0.7,0.1,0.013,4.4,71,125,90,149,79,151,0.65,54,59,72
OceanDNA-b35892,2526,-2.7,0.0,0.13,480.0,197,228,413,443,410,445,0.65,31,30,35
OceanDNA-b38062,924,-0.7,0.0,0.033,31.0,151,190,95,137,45,153,0.65,39,42,108
OceanDNA-b35437,210,11.8,0.0,5.1e-06,0.0013,84,240,36,205,9,225,0.65,156,169,216
OceanDNA-b16107,394,15.1,0.1,5.2e-07,0.00036,78,176,236,355,233,364,0.65,98,119,131
OceanDNA-b40920,956,1.2,0.0,0.018,11.0,197,261,217,277,203,279,0.65,64,60,76
OceanDNA-b22296,1910,-0.4,0.0,0.028,91.0,196,219,288,311,284,350,0.65,23,23,66
OceanDNA-b45854,2076,11.2,0.0,1.6e-05,0.017,138,188,38,87,2,105,0.65,50,49,103
OceanDNA-b35314,474,2.1,0.0,0.0046,4.8,201,263,197,258,191,260,0.65,62,61,69
OceanDNA-b3385,1744,12.3,0.2,7.4e-06,0.013,88,187,34,131,26,137,0.65,99,97,111
OceanDNA-b1353,1053,10.8,0.1,2.1e-05,0.042,51,111,248,311,237,316,0.65,60,63,79
OceanDNA-b11616,217,3.7,0.1,0.0015,1.5,250,281,305,338,281,349,0.65,31,33,68
OceanDNA-b23525,1023,5.3,0.8,0.00051,1.0,86,187,42,145,12,180,0.65,101,103,168
OceanDNA-b46205,397,4.0,0.1,0.0013,2.0,138,206,184,267,170,310,0.65,68,83,140
OceanDNA-b40624,223,34.8,0.3,1e-12,5e-10,53,223,74,262,15,285,0.65,170,188,270
OceanDNA-b45271,128,-0.8,0.0,0.073,18.0,197,228,316,346,309,398,0.65,31,30,89
OceanDNA-b36616,37,17.2,0.3,1.2e-07,0.00034,104,172,167,251,160,292,0.65,68,84,132
OceanDNA-b21048,591,17.6,0.1,1.8e-07,0.00016,100,245,109,254,87,258,0.65,145,145,171
OceanDNA-b5452,195,13.1,0.0,2.1e-06,0.00093,74,187,178,301,136,309,0.65,113,123,173
OceanDNA-b3372,1713,18.2,0.1,1.2e-07,0.0002,105,185,206,291,159,301,0.65,80,85,142
OceanDNA-b32709,628,9.2,0.0,6.6e-05,0.056,149,178,237,266,170,287,0.65,29,29,117
OceanDNA-b33298,1568,8.4,0.5,5.7e-05,0.11,134,227,98,194,73,203,0.65,93,96,130
OceanDNA-b6211,233,-1.6,0.0,0.062,23.0,192,223,213,243,211,290,0.65,31,30,79
OceanDNA-b35278,377,11.6,0.1,1.2e-05,0.0048,68,191,17,155,6,163,0.65,123,138,157
OceanDNA-b23367,1849,-3.8,0.0,0.59,610.0,98,125,272,299,265,313,0.65,27,27,48
OceanDNA-b1776,2429,13.0,0.3,4.3e-06,0.0081,82,186,165,277,154,318,0.65,104,112,164
OceanDNA-b21344,633,17.9,0.0,7.2e-08,7.2e-05,151,249,129,230,63,254,0.64,98,101,191
OceanDNA-b32834,306,1.0,0.0,0.02,8.3,150,228,155,233,135,246,0.64,78,78,111
OceanDNA-b41608,419,12.2,0.0,3.8e-06,0.0022,90,214,51,193,26,215,0.64,124,142,189
OceanDNA-b21342,331,-3.1,0.0,0.18,88.0,197,230,194,226,189,240,0.64,33,32,51
OceanDNA-b41304,3569,10.9,0.0,9.9e-06,0.041,133,186,199,248,107,255,0.64,53,49,148
OceanDNA-b21002,2868,-0.9,0.1,0.076,210.0,117,140,117,139,111,191,0.64,23,22,80
OceanDNA-b3338,1288,14.1,0.8,1.1e-06,0.0037,88,187,47,144,37,163,0.64,99,97,126
OceanDNA-b21437,139,3.9,0.0,0.0013,0.3,109,185,26,101,6,122,0.64,76,75,116
OceanDNA-b20894,1026,4.7,0.0,0.0015,3.3,152,179,124,151,110,248,0.64,27,27,138
OceanDNA-b28262,307,9.7,0.0,2.2e-05,0.011,194,227,197,229,187,266,0.64,33,32,79
OceanDNA-b37264,824,-3.7,0.0,0.27,350.0,222,262,262,299,242,304,0.64,40,37,62
OceanDNA-b47092,283,2.7,0.2,0.0064,6.0,149,177,79,107,7,119,0.64,28,28,112
OceanDNA-b44154,508,-0.7,0.0,0.034,18.0,230,265,219,255,191,274,0.64,35,36,83
OceanDNA-b14328,67,11.7,0.0,5.8e-06,0.0027,148,248,102,202,93,217,0.64,100,100,124
OceanDNA-b45790,316,8.1,0.0,7e-05,0.029,91,194,69,172,48,178,0.64,103,103,130
OceanDNA-b26844,2414,11.9,0.6,4.9e-06,0.016,80,191,31,147,15,154,0.64,111,116,139
OceanDNA-b18171,65,-3.1,0.0,0.19,32.0,104,120,35,51,11,61,0.64,16,16,50
OceanDNA-b33195,96,-0.7,0.0,0.033,23.0,201,264,202,263,196,264,0.64,63,61,68
OceanDNA-b10294,339,-2.3,0.0,0.21,87.0,21,51,212,242,190,253,0.64,30,30,63
OceanDNA-b10085,654,17.5,0.0,9.4e-08,8.3e-05,153,243,360,452,342,467,0.64,90,92,125
OceanDNA-b45827,1430,11.8,0.0,5.1e-06,0.0082,110,185,206,287,197,296,0.64,75,81,99
OceanDNA-b31694,127,-3.4,0.0,0.22,300.0,93,123,38,71,22,80,0.64,30,33,58
OceanDNA-b16662,303,-0.3,0.0,0.024,24.0,194,265,424,501,394,511,0.64,71,77,117
OceanDNA-b9724,486,7.1,0.0,0.00014,0.069,153,240,90,191,73,217,0.64,87,101,144
OceanDNA-b17770,189,11.0,0.1,9.4e-06,0.0028,193,227,221,254,194,289,0.64,34,33,95
OceanDNA-b3684,19,4.9,0.0,0.00065,0.82,154,227,94,177,77,192,0.64,73,83,115
OceanDNA-b11392,106,8.8,0.0,4.1e-05,0.021,79,188,24,150,20,163,0.64,109,126,143
OceanDNA-b31513,460,12.4,0.0,3.4e-06,0.0019,105,211,122,238,104,249,0.64,106,116,145
OceanDNA-b41695,121,-2.3,0.0,0.2,19.0,197,252,215,266,209,271,0.64,55,51,62
OceanDNA-b23556,470,-2.5,0.1,0.12,280.0,11,42,70,103,63,109,0.64,31,33,46
OceanDNA-b43986,170,8.0,1.3,7.4e-05,0.018,124,175,141,194,72,198,0.64,51,53,126
OceanDNA-b23825,1195,12.6,0.2,6.1e-06,0.0048,49,179,45,196,40,203,0.64,130,151,163
OceanDNA-b40252,239,16.9,0.1,1.4e-07,0.00013,148,188,107,149,17,184,0.64,40,42,167
OceanDNA-b6750,437,6.5,0.0,0.00063,0.15,109,192,2,88,1,96,0.64,83,86,95
OceanDNA-b17564,520,-1.7,0.0,0.069,140.0,55,107,60,115,49,132,0.64,52,55,83
OceanDNA-b31573,834,11.4,0.0,1.3e-05,0.012,148,185,193,230,106,239,0.64,37,37,133
OceanDNA-b3242,329,12.0,0.3,4.4e-06,0.0037,61,186,64,204,4,229,0.64,125,140,225
OceanDNA-b22840,3818,-3.1,0.0,0.54,760.0,99,120,110,131,69,142,0.64,21,21,73
OceanDNA-b45289,7,11.3,0.0,1.4e-05,0.018,101,179,178,258,157,277,0.63,78,80,120
OceanDNA-b25026,751,12.2,0.1,4e-06,0.0035,103,208,93,201,78,209,0.63,105,108,131
OceanDNA-b25026,751,0.4,0.0,0.015,13.0,195,223,268,296,258,311,0.63,28,28,53
OceanDNA-b34301,471,5.9,0.0,0.00033,0.24,108,186,203,288,197,309,0.63,78,85,112
OceanDNA-b9835,190,-2.3,0.0,0.1,29.0,193,243,168,214,164,236,0.63,50,46,72
OceanDNA-b3315,1347,11.7,0.3,1.1e-05,0.02,89,194,44,148,36,162,0.63,105,104,126
OceanDNA-b32684,1044,9.5,0.4,2.6e-05,0.041,102,187,43,123,29,129,0.63,85,80,100
OceanDNA-b30640,51,-1.9,0.0,0.15,95.0,195,235,213,252,199,270,0.63,40,39,71
OceanDNA-b32851,680,1.5,0.0,0.007,5.5,137,214,143,220,125,241,0.63,77,77,116
OceanDNA-b5161,252,9.3,0.0,3.1e-05,0.0087,146,180,114,148,27,163,0.63,34,34,136
OceanDNA-b22022,2999,-1.6,0.0,0.12,210.0,28,59,81,112,46,132,0.63,31,31,86
OceanDNA-b1776,2429,-1.3,0.5,0.1,190.0,9,60,51,102,22,108,0.63,51,51,86
OceanDNA-b26737,1207,-3.1,0.0,0.18,420.0,96,122,69,98,63,102,0.63,26,29,39
OceanDNA-b23150,2605,11.0,0.2,9e-06,0.024,62,172,62,173,50,192,0.63,110,111,142
OceanDNA-b32144,436,-2.4,0.0,0.22,300.0,59,72,249,262,226,279,0.63,13,13,53
OceanDNA-b35243,734,6.2,0.0,0.00026,0.25,174,245,261,346,258,357,0.63,71,85,99
OceanDNA-b6504,238,6.2,0.0,0.00027,0.14,155,247,91,197,74,207,0.63,92,106,133
OceanDNA-b32734,108,9.3,0.1,3e-05,0.012,138,229,69,166,60,177,0.63,91,97,117
OceanDNA-b16209,388,12.6,0.0,6.1e-06,0.0038,88,122,284,318,272,403,0.63,34,34,131
OceanDNA-b2828,3215,13.8,0.0,1.2e-06,0.0044,161,244,126,210,120,215,0.63,83,84,95
OceanDNA-b16098,320,14.2,0.0,1.9e-06,0.00075,77,174,243,356,240,366,0.63,97,113,126
OceanDNA-b41358,957,-3.4,0.0,0.92,280.0,178,208,198,230,190,234,0.63,30,32,44
OceanDNA-b16215,916,-0.4,0.0,0.028,33.0,196,233,123,159,115,191,0.63,37,36,76
OceanDNA-b40777,480,16.4,2.6,4e-07,0.00023,17,221,7,245,1,272,0.63,204,238,271
OceanDNA-b16220,635,6.8,0.1,0.00034,0.21,143,171,196,224,187,323,0.63,28,28,136
OceanDNA-b21790,8,-1.1,0.0,0.043,12.0,201,252,673,724,665,738,0.63,51,51,73
OceanDNA-b30166,781,-3.0,0.0,0.17,300.0,7,34,50,78,48,81,0.63,27,28,33
OceanDNA-b21790,8,10.8,0.0,1e-05,0.0027,109,194,545,641,530,647,0.63,85,96,117
OceanDNA-b26870,727,16.1,0.4,2.6e-07,0.0008,84,171,138,236,133,242,0.63,87,98,109
OceanDNA-b41011,1460,14.5,0.0,1.6e-06,0.0019,103,177,152,222,127,233,0.63,74,70,106
OceanDNA-b8544,124,9.7,0.0,2.2e-05,0.0042,78,171,54,155,51,192,0.62,93,101,141
OceanDNA-b17743,3198,14.3,0.1,2.8e-06,0.0035,107,190,134,228,80,250,0.62,83,94,170
OceanDNA-b22320,1014,12.0,0.0,4.6e-06,0.0059,109,197,554,651,540,657,0.62,88,97,117
OceanDNA-b2585,1160,-2.1,0.2,0.087,210.0,98,163,321,389,308,401,0.62,65,68,93
OceanDNA-b42513,128,7.8,0.0,8.8e-05,0.023,198,238,262,301,255,316,0.62,40,39,61
OceanDNA-b35318,70,15.9,0.0,3e-07,0.00029,92,187,39,149,22,153,0.62,95,110,131
OceanDNA-b13871,832,12.2,0.1,4e-06,0.0039,55,180,40,166,7,178,0.62,125,126,171
OceanDNA-b4028,349,12.1,0.0,8.3e-06,0.0034,151,264,115,230,103,250,0.62,113,115,147
OceanDNA-b22127,244,-3.0,0.0,0.17,280.0,16,46,657,688,650,691,0.62,30,31,41
OceanDNA-b13264,1312,9.5,1.6,2.7e-05,0.041,75,168,45,153,20,158,0.62,93,108,138
OceanDNA-b24073,156,15.6,0.1,3.6e-07,0.00032,142,186,101,151,67,162,0.62,44,50,95
OceanDNA-b21048,127,22.0,0.1,8.1e-09,7.1e-06,91,229,111,283,104,307,0.62,138,172,203
OceanDNA-b23643,888,-0.1,0.0,0.022,54.0,197,245,232,280,227,299,0.62,48,48,72
OceanDNA-b40262,146,11.2,0.0,7.7e-06,0.0038,106,182,116,188,15,206,0.62,76,72,191
OceanDNA-b46894,843,-0.8,0.0,0.035,44.0,220,263,212,252,181,254,0.62,43,40,73
OceanDNA-b17609,3614,-3.3,0.0,0.2,970.0,25,47,44,66,34,80,0.61,22,22,46
OceanDNA-b929,256,-2.2,0.0,0.093,41.0,71,99,173,202,156,206,0.61,28,29,50
OceanDNA-b16135,213,14.9,0.3,1.8e-06,0.00054,89,181,265,377,249,385,0.61,92,112,136
OceanDNA-b26567,96,10.5,0.0,1.3e-05,0.013,156,187,119,151,37,157,0.61,31,32,120
OceanDNA-b13590,1844,3.1,0.1,0.0093,6.8,155,208,442,501,393,513,0.61,53,59,120
OceanDNA-b22997,222,-2.8,0.0,0.45,150.0,14,39,26,51,13,75,0.61,25,25,62
OceanDNA-b22296,1910,7.8,0.1,8.5e-05,0.28,16,202,28,213,13,221,0.61,186,185,208
OceanDNA-b425,789,16.8,0.2,1.5e-07,0.00014,90,221,112,268,107,300,0.61,131,156,193
OceanDNA-b10043,168,9.8,0.0,2.1e-05,0.0086,133,188,122,175,45,183,0.61,55,53,138
OceanDNA-a3195,798,12.7,0.0,2.9e-06,0.0033,11,126,39,160,30,218,0.61,115,121,188
OceanDNA-b16098,490,8.9,0.0,7.7e-05,0.03,90,175,79,182,60,192,0.61,85,103,132
OceanDNA-b960,417,-5.9,5.4,1.0,2100.0,4,4,147,147,67,190,0.61,0,0,123
OceanDNA-b16187,169,8.4,0.0,5.8e-05,0.052,57,175,217,355,197,366,0.61,118,138,169
OceanDNA-b20915,804,-3.7,0.0,0.27,220.0,185,196,159,170,154,173,0.61,11,11,19
OceanDNA-b14283,358,-3.8,0.0,0.3,140.0,224,248,273,296,247,310,0.61,24,23,63
OceanDNA-b26842,552,15.9,0.4,3e-07,0.00067,84,171,172,270,167,276,0.61,87,98,109
OceanDNA-b9635,310,5.1,0.0,0.00057,0.28,148,247,87,200,77,211,0.61,99,113,134
OceanDNA-b47053,235,-2.7,0.0,0.14,89.0,198,218,184,205,180,237,0.61,20,21,57
OceanDNA-b6503,557,3.9,0.0,0.0026,0.85,157,247,96,200,80,209,0.6,90,104,129
OceanDNA-b466,1643,-1.3,1.2,0.1,150.0,12,50,24,65,16,75,0.6,38,41,59
OceanDNA-b21004,1385,7.0,0.1,0.00045,0.29,92,179,166,264,154,282,0.6,87,98,128
OceanDNA-b16147,120,14.6,0.0,1.5e-06,0.00052,78,173,254,365,247,375,0.6,95,111,128
OceanDNA-a3737,266,4.1,0.0,0.0012,0.34,94,174,17,110,11,121,0.6,80,93,110
OceanDNA-b15777,1620,8.1,0.0,0.00021,0.12,147,180,101,134,23,160,0.6,33,33,137
OceanDNA-b440,696,8.1,0.0,0.00014,0.17,225,261,281,318,252,329,0.6,36,37,77
OceanDNA-b1347,737,-0.6,0.0,0.095,46.0,18,61,85,126,67,140,0.6,43,41,73
OceanDNA-b37855,698,-2.2,0.0,0.093,68.0,31,55,148,172,90,184,0.6,24,24,94
OceanDNA-b24591,1677,-1.8,0.0,0.15,200.0,76,121,43,94,5,100,0.59,45,51,95
OceanDNA-b22922,367,-3.1,0.0,0.17,290.0,55,114,126,143,116,155,0.59,59,17,39
OceanDNA-b33521,2359,-3.1,0.0,0.18,530.0,143,174,28,64,18,75,0.59,31,36,57
OceanDNA-b22827,3848,-2.6,0.0,0.26,650.0,103,123,242,262,233,271,0.59,20,20,38
OceanDNA-b22798,1185,9.9,0.3,2e-05,0.082,133,244,158,298,146,306,0.59,111,140,160
OceanDNA-b9654,484,5.2,0.0,0.001,0.3,159,239,102,195,80,217,0.59,80,93,137
OceanDNA-b12639,372,9.2,0.0,3.3e-05,0.02,139,185,109,154,22,160,0.59,46,45,138
OceanDNA-b19403,295,13.2,0.1,1.9e-06,0.0006,128,190,263,329,179,350,0.59,62,66,171
OceanDNA-b1765,1396,12.2,1.2,3.9e-06,0.009,83,188,172,285,167,320,0.59,105,113,153
OceanDNA-b31526,385,-0.4,0.0,0.081,28.0,107,122,184,199,151,264,0.59,15,15,113
OceanDNA-b3419,139,11.1,0.0,8.5e-06,0.012,104,176,54,135,48,143,0.59,72,81,95
OceanDNA-b23417,135,7.1,0.2,0.00041,0.4,78,121,87,130,83,263,0.59,43,43,180
OceanDNA-b16140,405,11.3,0.1,7.6e-06,0.007,89,177,271,379,255,401,0.59,88,108,146
OceanDNA-b22397,2136,-1.9,0.0,0.3,200.0,117,151,49,80,35,95,0.59,34,31,60
OceanDNA-b34923,521,0.7,0.0,0.013,9.7,109,170,97,164,62,177,0.59,61,67,115
OceanDNA-b2923,1425,-1.4,0.0,0.11,110.0,180,246,183,249,178,268,0.59,66,66,90
OceanDNA-b18470,294,13.4,0.0,3.4e-06,0.00055,152,185,137,170,35,173,0.58,33,33,138
OceanDNA-b23680,180,-2.5,0.0,0.12,210.0,189,248,234,289,227,310,0.58,59,55,83
OceanDNA-b19691,328,-3.1,0.0,0.18,69.0,16,56,280,319,272,334,0.58,40,39,62
OceanDNA-b23811,325,-2.5,0.0,0.12,180.0,189,248,234,289,227,310,0.58,59,55,83
OceanDNA-b40755,73,-1.9,0.0,0.079,51.0,19,65,38,81,25,86,0.58,46,43,61
OceanDNA-b38495,642,-3.5,0.0,0.69,190.0,194,284,237,257,234,267,0.58,90,20,33
OceanDNA-b1358,1852,-3.0,0.0,0.17,490.0,198,215,206,223,201,259,0.57,17,17,58
OceanDNA-b36934,678,-1.2,0.0,0.049,49.0,179,221,328,376,324,401,0.57,42,48,77
OceanDNA-b16719,140,8.8,0.1,4.2e-05,0.097,89,126,272,309,268,427,0.57,37,37,159
OceanDNA-b26501,866,12.0,0.1,4.4e-06,0.0069,156,186,170,200,86,207,0.57,30,30,121
OceanDNA-b34663,386,-3.0,0.0,0.33,130.0,140,170,481,512,443,521,0.57,30,31,78
OceanDNA-b24003,608,2.2,0.0,0.0086,6.3,99,181,437,525,422,534,0.56,82,88,112
OceanDNA-b114,76,-1.1,0.0,0.046,21.0,200,221,473,493,458,518,0.56,21,20,60
OceanDNA-b30095,1825,-2.0,0.0,0.25,210.0,198,251,209,258,180,268,0.56,53,49,88
OceanDNA-b41583,245,11.7,0.2,5.4e-06,0.0035,75,186,55,195,38,219,0.56,111,140,181
OceanDNA-b15551,376,-2.5,0.0,0.24,250.0,86,100,86,100,80,117,0.55,14,14,37
OceanDNA-b44627,225,8.6,0.2,9.9e-05,0.045,161,215,141,218,133,249,0.55,54,77,116
OceanDNA-b12076,229,10.5,0.6,1.3e-05,0.0055,68,181,30,156,19,166,0.54,113,126,147
OceanDNA-b27549,1961,-1.6,0.0,0.13,140.0,162,183,71,92,17,103,0.54,21,21,86
OceanDNA-b22817,1889,-2.8,0.1,0.14,610.0,11,184,9,33,3,42,0.53,173,24,39
OceanDNA-b20906,284,-2.7,0.0,0.14,580.0,23,62,16,56,6,64,0.53,39,40,58
OceanDNA-b1232,562,-2.9,1.4,0.15,300.0,41,52,37,48,5,87,0.52,11,11,82
OceanDNA-b45445,755,-3.7,0.0,0.27,470.0,189,214,6,31,4,45,0.52,25,25,41
OceanDNA-b46919,1190,-1.9,0.0,0.08,130.0,136,167,563,596,513,607,0.51,31,33,94
OceanDNA-b16480,1016,-0.0,0.0,0.021,23.0,93,119,158,184,152,257,0.51,26,26,105
OceanDNA-b28826,1069,-0.8,0.0,0.035,42.0,28,58,227,258,211,274,0.48,30,31,63
OceanDNA-b24286,2219,8.7,0.0,4.5e-05,0.15,145,214,146,231,50,270,0.48,69,85,220
OceanDNA-b39122,1487,-3.7,0.1,0.28,640.0,9,25,13,29,4,44,0.42,16,16,40
