File,SubFile,Score,Bias,EValue(C),EValue(I),HMM-From,HMM-To,Ali-From,Ali-To,Env-From,Env-To,Accuracy,HMM-Length,Ali-Length,Env-Length
OceanDNA-b17611,2100,29.7,0.0,5.4e-11,5.9e-08,124,191,45,112,42,119,0.95,67,67,77
OceanDNA-b41030,1870,314.1,0.0,1.3e-97,1.1e-94,35,296,69,333,59,333,0.94,261,264,274
OceanDNA-b22385,1572,17.3,0.1,2.2e-07,0.00042,154,187,266,299,256,303,0.93,33,33,47
OceanDNA-a4078,317,10.0,0.0,1.8e-05,0.0063,152,199,150,197,140,198,0.93,47,47,58
OceanDNA-b22917,1245,9.0,0.0,0.00015,0.11,77,120,67,110,64,117,0.93,43,43,53
OceanDNA-b22509,2558,17.0,0.0,1.4e-07,0.0004,153,186,204,237,200,245,0.93,33,33,45
OceanDNA-b6501,409,6.4,0.0,0.00068,0.12,196,257,373,434,354,437,0.93,61,61,83
OceanDNA-b22507,886,14.9,0.1,1.2e-06,0.0017,153,186,204,237,200,245,0.93,33,33,45
OceanDNA-b17160,71,13.7,0.0,1.4e-06,0.00025,81,120,188,227,183,236,0.93,39,39,53
OceanDNA-b38376,1463,325.9,0.1,5.6e-101,2.8e-98,33,296,85,353,76,353,0.93,263,268,277
OceanDNA-b23229,485,9.6,0.0,4.7e-05,0.033,153,184,206,237,197,247,0.92,31,31,50
OceanDNA-b33388,1370,17.3,0.0,5.6e-07,0.00043,155,185,327,357,312,365,0.92,30,30,53
OceanDNA-b39170,558,329.6,1.7,8e-103,1.7e-99,34,296,60,327,25,327,0.92,262,267,302
OceanDNA-b22512,912,14.5,0.0,1.6e-06,0.002,153,186,206,239,202,247,0.92,33,33,45
OceanDNA-b22406,2680,13.1,0.0,1e-05,0.0059,154,187,222,255,191,259,0.92,33,33,68
OceanDNA-b22816,1853,13.5,0.0,1.6e-06,0.0055,153,187,83,117,66,126,0.92,34,34,60
OceanDNA-b15979,255,19.4,0.0,4.9e-08,2.5e-05,152,197,169,214,159,226,0.92,45,45,67
OceanDNA-b15326,263,22.5,0.0,2.9e-09,8.2e-07,105,189,106,190,78,199,0.92,84,84,121
OceanDNA-b45233,1211,10.8,0.0,2.2e-05,0.016,154,186,175,207,164,213,0.92,32,32,49
OceanDNA-b46812,1104,15.0,0.1,1.6e-06,0.0013,153,186,231,264,221,269,0.92,33,33,48
OceanDNA-b22322,3173,10.3,0.0,4.4e-05,0.057,152,186,247,281,223,292,0.92,34,34,69
OceanDNA-b38936,521,336.9,1.1,9.5e-105,3.1e-102,37,296,49,313,20,313,0.92,259,264,293
OceanDNA-b46216,450,14.5,0.1,7.9e-07,0.0011,153,187,233,267,223,271,0.92,34,34,48
OceanDNA-b40641,971,3.1,0.0,0.0091,3.0,201,264,221,284,205,285,0.92,63,63,80
OceanDNA-b13585,772,23.4,0.0,7.7e-09,2.3e-06,129,190,114,175,109,186,0.92,61,61,77
OceanDNA-b12871,421,7.0,0.0,0.00015,0.066,154,188,234,268,216,274,0.92,34,34,58
OceanDNA-b18473,63,17.5,0.0,9.7e-08,4.6e-05,141,191,303,353,280,358,0.92,50,50,78
OceanDNA-b16480,1016,10.1,0.0,1.7e-05,0.019,197,246,319,368,311,374,0.92,49,49,63
OceanDNA-b24941,1854,12.7,0.0,5.5e-06,0.0078,157,187,107,137,78,177,0.92,30,30,99
OceanDNA-b22978,1591,13.0,0.1,4.4e-06,0.0049,152,186,217,251,213,256,0.92,34,34,43
OceanDNA-b24086,404,25.0,0.0,9.6e-10,2.8e-07,150,198,132,180,120,190,0.92,48,48,70
OceanDNA-b23584,548,11.8,0.0,1e-05,0.013,66,87,95,116,77,136,0.92,21,21,59
OceanDNA-b13457,125,4.3,0.1,0.0021,0.71,222,256,100,134,96,136,0.92,34,34,40
OceanDNA-b45578,722,14.3,0.0,9.1e-07,0.00096,153,187,243,277,236,286,0.91,34,34,50
OceanDNA-b46887,168,7.2,0.0,0.00027,0.092,108,176,79,147,68,159,0.91,68,68,91
OceanDNA-b46684,332,14.4,0.0,1.7e-06,0.00065,153,187,239,273,227,283,0.91,34,34,56
OceanDNA-b44876,223,12.3,0.0,3.7e-06,0.003,146,187,344,385,336,389,0.91,41,41,53
OceanDNA-b17593,1196,11.7,0.0,5.6e-06,0.014,104,130,70,96,61,120,0.91,26,26,59
OceanDNA-b20097,206,9.9,0.0,6.1e-05,0.006,154,193,2,41,1,55,0.91,39,39,54
OceanDNA-b45438,1698,15.9,0.1,3e-07,0.00058,154,186,203,235,198,242,0.91,32,32,44
OceanDNA-b45526,124,14.1,0.0,1.1e-06,0.00035,153,187,236,270,231,280,0.91,34,34,49
OceanDNA-b37342,417,17.5,0.0,9.8e-08,0.00013,154,180,182,208,166,222,0.91,26,26,56
OceanDNA-b27579,1754,12.3,0.0,7.5e-06,0.011,159,181,180,202,158,210,0.91,22,22,52
OceanDNA-b13229,111,19.6,0.0,4.4e-08,1.5e-05,139,183,126,170,118,180,0.91,44,44,62
OceanDNA-b20505,46,20.6,0.0,1.1e-08,3e-06,123,191,205,273,197,314,0.91,68,68,117
OceanDNA-b30499,1061,11.9,0.0,4.7e-06,0.0061,159,182,82,105,64,146,0.91,23,23,82
OceanDNA-b14104,281,18.9,0.0,1.1e-07,1.7e-05,151,189,160,198,155,203,0.91,38,38,48
OceanDNA-b20588,136,10.7,0.0,1.1e-05,0.0027,80,121,120,161,113,168,0.91,41,41,55
OceanDNA-b28238,1655,12.4,0.1,6.9e-06,0.008,86,118,81,113,66,121,0.91,32,32,55
OceanDNA-b15135,103,12.8,0.0,2.6e-06,0.0013,89,134,31,76,23,85,0.91,45,45,62
OceanDNA-b28083,995,19.5,0.0,4.6e-08,4e-05,154,179,140,165,126,179,0.91,25,25,53
OceanDNA-b45634,308,13.6,0.0,2.8e-06,0.001,153,187,229,263,198,273,0.91,34,34,75
OceanDNA-b27448,73,11.3,0.0,7.5e-06,0.002,153,193,224,264,198,276,0.91,40,40,78
OceanDNA-b22995,1641,12.9,0.0,1.2e-05,0.0051,154,180,217,243,204,250,0.91,26,26,46
OceanDNA-b31227,782,10.6,0.3,1.2e-05,0.011,131,158,101,128,94,137,0.91,27,27,43
OceanDNA-b4134,377,11.8,0.0,1e-05,0.0044,152,183,79,110,64,188,0.91,31,31,124
OceanDNA-b24136,3117,11.9,0.1,9.5e-06,0.017,152,188,138,174,128,186,0.91,36,36,58
OceanDNA-b23340,1830,18.0,0.0,6.6e-08,0.00013,157,185,140,168,127,176,0.91,28,28,49
OceanDNA-b23843,2041,19.2,0.0,2.8e-08,6.5e-05,154,185,159,190,142,197,0.91,31,31,55
OceanDNA-b23199,586,14.4,0.0,8.6e-07,0.0016,153,186,201,234,194,244,0.91,33,33,50
OceanDNA-b4726,421,11.7,0.0,5.5e-06,0.0043,158,180,114,136,109,178,0.91,22,22,69
OceanDNA-b45520,1064,21.5,0.0,1.1e-08,7.9e-06,132,186,178,233,169,240,0.91,54,55,71
OceanDNA-b45389,308,11.0,0.0,9.3e-06,0.012,152,191,175,214,159,222,0.91,39,39,63
OceanDNA-b2866,2165,13.1,0.0,6.3e-06,0.0055,122,191,452,520,446,581,0.91,69,68,135
OceanDNA-b3696,1147,-1.4,0.0,0.053,130.0,125,152,71,98,68,100,0.91,27,27,32
OceanDNA-b7949,171,9.3,0.0,3e-05,0.0091,135,185,108,156,32,169,0.91,50,48,137
OceanDNA-b45014,133,10.1,0.0,1.6e-05,0.012,154,189,137,172,125,180,0.91,35,35,55
OceanDNA-b33393,2192,10.7,0.0,2.2e-05,0.047,54,106,11,64,5,81,0.91,52,53,76
OceanDNA-b20819,330,13.9,0.0,2.4e-06,0.00083,155,192,239,276,198,281,0.91,37,37,83
OceanDNA-b29,2122,12.6,0.2,1.2e-05,0.015,69,105,211,247,204,254,0.91,36,36,50
OceanDNA-b22607,586,15.6,0.3,7.4e-07,0.00033,152,186,226,260,215,264,0.91,34,34,49
OceanDNA-b14889,170,11.2,0.0,7.7e-06,0.0018,136,183,42,89,32,95,0.91,47,47,63
OceanDNA-b17737,215,12.7,0.0,2.7e-06,0.0094,166,222,7,63,4,90,0.91,56,56,86
OceanDNA-b9656,589,12.3,0.0,7.4e-06,0.0026,186,215,56,85,49,105,0.91,29,29,56
OceanDNA-b23725,689,12.2,0.0,1.2e-05,0.0084,68,88,194,214,183,220,0.91,20,20,37
OceanDNA-b7262,306,142.3,0.0,9.3e-46,3.5e-43,74,288,66,287,48,293,0.91,214,221,245
OceanDNA-b45381,2554,15.3,0.1,4.4e-07,0.0012,152,187,360,395,351,406,0.91,35,35,55
OceanDNA-b45626,73,12.2,0.0,3.9e-06,0.0028,153,187,261,295,255,305,0.91,34,34,50
OceanDNA-b45487,190,11.5,0.0,6.3e-06,0.015,153,187,236,270,225,279,0.91,34,34,54
OceanDNA-b16133,307,12.9,0.0,7.2e-06,0.0027,152,183,142,173,122,278,0.91,31,31,156
OceanDNA-b10017,7,11.3,0.0,7.3e-06,0.0053,134,188,104,156,29,166,0.9,54,52,137
OceanDNA-b46725,1949,14.3,0.0,1.8e-06,0.0019,153,186,199,232,195,246,0.9,33,33,51
OceanDNA-b46530,745,-1.9,0.0,0.075,88.0,226,257,288,319,286,321,0.9,31,31,35
OceanDNA-b42818,121,16.0,0.0,2.8e-07,0.00023,153,187,493,528,483,536,0.9,34,35,53
OceanDNA-b43839,1693,8.6,0.0,9.9e-05,0.087,161,188,118,145,95,156,0.9,27,27,61
OceanDNA-b36076,862,7.9,0.1,0.00016,0.21,90,119,118,147,111,154,0.9,29,29,43
OceanDNA-b16626,660,4.0,0.0,0.0013,1.1,201,247,271,317,263,323,0.9,46,46,60
OceanDNA-b13153,314,18.6,0.0,4.4e-08,3.1e-05,139,185,126,172,119,179,0.9,46,46,60
OceanDNA-b30678,1209,12.1,0.0,4.1e-06,0.0057,154,176,148,170,136,186,0.9,22,22,50
OceanDNA-b3907,464,12.0,0.0,4.6e-06,0.0025,134,188,104,158,99,169,0.9,54,54,70
OceanDNA-b23907,1575,5.6,0.0,0.00081,0.8,195,230,254,289,239,313,0.9,35,35,74
OceanDNA-b22130,936,12.0,0.0,9.3e-06,0.012,158,189,2,33,1,42,0.9,31,31,41
OceanDNA-b42446,268,14.4,0.0,8.3e-07,0.00024,153,188,149,184,136,221,0.9,35,35,85
OceanDNA-b46326,1716,13.0,0.0,4.5e-06,0.0059,154,185,259,290,243,303,0.9,31,31,60
OceanDNA-b46697,1101,13.7,0.0,2.7e-06,0.0028,154,185,201,232,182,241,0.9,31,31,59
OceanDNA-b37345,174,16.1,0.0,7.4e-07,0.00034,154,180,155,181,141,194,0.9,26,26,53
OceanDNA-b14697,145,11.0,0.1,8.8e-06,0.0023,136,183,42,89,33,96,0.9,47,47,63
OceanDNA-b24900,1143,11.0,0.0,9.1e-06,0.017,152,187,93,128,78,134,0.9,35,35,56
OceanDNA-b10475,234,11.8,0.0,5.3e-06,0.0026,186,216,286,316,277,340,0.9,30,30,63
OceanDNA-b26884,1682,12.9,0.0,2.3e-06,0.0067,152,180,171,199,86,211,0.9,28,28,125
OceanDNA-b35208,909,8.5,0.0,5.2e-05,0.049,175,218,231,274,228,300,0.9,43,43,72
OceanDNA-b31575,1583,10.6,0.0,2.5e-05,0.021,150,185,160,195,88,204,0.9,35,35,116
OceanDNA-b4004,464,10.6,0.1,2.5e-05,0.014,110,170,88,148,74,155,0.9,60,60,81
OceanDNA-b7401,137,12.7,0.0,2.8e-06,0.00077,183,215,155,187,128,196,0.9,32,32,68
OceanDNA-b45835,357,16.6,0.0,3.6e-07,0.00018,154,186,127,159,117,180,0.9,32,32,63
OceanDNA-b13256,790,-3.9,0.0,2.1,600.0,92,113,826,847,822,848,0.9,21,21,26
OceanDNA-b24230,372,8.0,0.0,7.5e-05,0.032,152,185,181,215,158,255,0.9,33,34,97
OceanDNA-b36948,1090,22.7,0.0,2.5e-09,2.8e-06,149,192,239,282,191,302,0.9,43,43,111
OceanDNA-b46763,1273,10.8,0.2,2.1e-05,0.027,152,186,332,366,319,370,0.9,34,34,51
OceanDNA-b22935,660,15.9,0.0,2.9e-07,0.0011,152,184,221,253,208,261,0.9,32,32,53
OceanDNA-b13076,1906,15.3,0.5,4.5e-07,0.0012,52,109,65,123,48,129,0.9,57,58,81
OceanDNA-b22521,2208,10.9,0.0,9.9e-06,0.025,153,184,269,300,256,308,0.9,31,31,52
OceanDNA-b15497,403,12.1,0.1,4.2e-06,0.002,151,189,170,208,162,212,0.9,38,38,50
OceanDNA-b32011,1221,13.7,0.0,1.3e-06,0.0029,150,185,113,148,106,153,0.9,35,35,47
OceanDNA-b45131,359,14.3,0.0,9.3e-07,0.0012,151,190,178,217,171,224,0.9,39,39,53
OceanDNA-b20588,136,12.7,0.0,2.7e-06,0.00066,124,191,201,269,198,277,0.9,67,68,79
OceanDNA-b31130,128,6.0,0.0,0.00031,0.18,150,189,118,155,98,172,0.9,39,37,74
OceanDNA-b13674,206,13.8,0.0,1.3e-06,0.00029,154,192,179,217,170,226,0.9,38,38,56
OceanDNA-b11358,140,17.8,0.0,7.6e-08,3.2e-05,144,182,25,63,17,121,0.9,38,38,104
OceanDNA-b15539,807,12.9,0.0,2.4e-06,0.004,152,188,8,44,5,64,0.9,36,36,59
OceanDNA-b32861,660,20.3,0.0,2.7e-08,1.7e-05,153,180,154,181,140,201,0.9,27,27,61
OceanDNA-b22478,202,9.1,0.0,0.00011,0.082,153,182,278,307,259,312,0.9,29,29,53
OceanDNA-b46558,120,13.4,0.0,5.1e-06,0.001,153,187,197,231,193,243,0.9,34,34,50
OceanDNA-b14283,358,14.5,0.1,7.9e-07,0.00037,151,187,161,197,155,203,0.9,36,36,48
OceanDNA-b20708,83,6.2,0.0,0.00026,0.056,80,121,156,197,137,202,0.9,41,41,65
OceanDNA-b17564,520,10.9,0.0,2e-05,0.019,154,192,185,223,165,232,0.9,38,38,67
OceanDNA-b22615,804,188.6,0.0,2.2e-59,4.3e-56,41,281,80,327,60,337,0.9,240,247,277
OceanDNA-b22393,660,15.4,0.0,8.4e-07,0.00067,150,189,196,235,189,247,0.9,39,39,58
OceanDNA-b50,2159,12.2,0.0,3.8e-06,0.01,151,189,233,271,226,289,0.9,38,38,63
OceanDNA-b13250,1592,15.3,0.0,4.5e-06,0.0018,93,186,72,166,52,171,0.9,93,94,119
OceanDNA-b11613,391,11.2,0.0,8e-06,0.0067,187,217,343,373,323,382,0.9,30,30,59
OceanDNA-b33243,962,20.5,0.1,1.1e-08,3.1e-05,149,186,180,217,171,238,0.9,37,37,67
OceanDNA-b45576,1161,12.3,0.0,7.2e-06,0.0048,153,187,194,228,188,239,0.9,34,34,51
OceanDNA-b20918,1824,15.6,0.0,7.1e-07,0.0011,107,156,64,116,57,135,0.9,49,52,78
OceanDNA-b22083,915,10.6,0.0,1.2e-05,0.031,153,192,177,216,151,226,0.9,39,39,75
OceanDNA-b22566,1112,10.7,0.1,2.2e-05,0.013,152,186,238,272,229,277,0.9,34,34,48
OceanDNA-b32790,63,14.2,0.1,9.7e-07,0.00027,145,197,155,207,146,219,0.9,52,52,73
OceanDNA-b15784,572,9.5,0.0,2.6e-05,0.028,152,197,111,156,98,161,0.9,45,45,63
OceanDNA-b23327,1031,11.4,0.1,1.4e-05,0.011,157,180,78,101,72,110,0.9,23,23,38
OceanDNA-b45659,148,12.7,0.0,2.7e-06,0.00092,153,187,230,264,221,275,0.9,34,34,54
OceanDNA-b40254,276,10.4,0.1,2.8e-05,0.009,161,185,171,195,161,203,0.9,24,24,42
OceanDNA-b30572,993,15.0,0.0,5.6e-07,0.0016,154,179,169,194,153,231,0.9,25,25,78
OceanDNA-b20782,423,15.1,0.0,9.9e-07,0.00048,154,192,251,289,221,298,0.9,38,38,77
OceanDNA-b20668,73,15.2,0.0,9.8e-07,0.00013,147,192,227,272,206,280,0.9,45,45,74
OceanDNA-b37527,1146,24.4,0.0,1.5e-09,1.7e-06,137,191,124,177,115,183,0.9,54,53,68
OceanDNA-b13164,157,18.7,0.0,4.1e-08,2.8e-05,139,185,126,172,117,180,0.9,46,46,63
OceanDNA-b17441,966,216.5,0.1,2.3e-68,2.3e-65,42,277,49,291,42,306,0.9,235,242,264
OceanDNA-b46812,1757,13.2,0.0,5.9e-06,0.0048,154,183,122,151,113,158,0.9,29,29,45
OceanDNA-b37298,235,19.3,0.0,5.2e-08,2.5e-05,154,181,159,186,146,203,0.9,27,27,57
OceanDNA-b7374,41,129.3,0.0,8.4e-42,2.7e-39,53,275,43,273,35,291,0.89,222,230,256
OceanDNA-b31716,2338,14.9,0.0,5.8e-07,0.0014,155,181,171,197,160,209,0.89,26,26,49
OceanDNA-b31456,54,18.5,0.0,4.8e-08,9.1e-05,154,184,148,178,143,187,0.89,30,30,44
OceanDNA-b30127,816,14.7,0.2,6.8e-07,0.0016,158,186,150,178,134,191,0.89,28,28,57
OceanDNA-b23187,394,13.7,0.0,1.4e-06,0.0016,151,185,34,68,23,73,0.89,34,34,50
OceanDNA-b32692,1303,7.3,0.0,0.00012,0.3,153,179,73,99,64,107,0.89,26,26,43
OceanDNA-b44638,2053,11.4,0.0,6.9e-06,0.024,151,180,191,220,167,241,0.89,29,29,74
OceanDNA-b22131,703,19.1,0.0,6.4e-08,2.7e-05,153,217,409,473,397,490,0.89,64,64,93
OceanDNA-b31172,1603,3.5,0.0,0.0018,2.9,150,188,209,247,199,260,0.89,38,38,61
OceanDNA-b44662,2521,10.7,0.0,2.3e-05,0.031,152,179,116,143,104,163,0.89,27,27,59
OceanDNA-b3462,229,9.8,0.0,2.1e-05,0.014,150,185,43,78,20,89,0.89,35,35,69
OceanDNA-b31459,42,18.5,0.0,4.8e-08,9.2e-05,154,184,148,178,143,187,0.89,30,30,44
OceanDNA-b15551,376,10.6,0.0,2.4e-05,0.025,151,191,164,204,150,212,0.89,40,40,62
OceanDNA-b38220,389,17.5,0.0,9.6e-08,0.00012,139,179,139,180,130,193,0.89,40,41,63
OceanDNA-b44662,2521,-0.2,0.0,0.048,65.0,178,211,215,248,210,259,0.89,33,33,49
OceanDNA-b510,1351,13.9,0.0,2.5e-06,0.0027,149,182,110,143,38,154,0.89,33,33,116
OceanDNA-b37442,373,2.9,0.0,0.0054,2.7,89,121,138,170,79,176,0.89,32,32,97
OceanDNA-b24230,372,17.0,0.0,1.4e-07,5.8e-05,59,118,67,125,59,141,0.89,59,58,82
OceanDNA-b31577,2131,12.8,0.0,2.5e-06,0.0057,154,185,159,190,145,196,0.89,31,31,51
OceanDNA-b36890,852,-1.8,0.0,0.073,110.0,141,160,20,39,18,43,0.89,19,19,25
OceanDNA-b12867,392,13.1,0.0,2e-06,0.00087,193,256,64,127,47,138,0.89,63,63,91
OceanDNA-b30718,465,17.1,0.0,1.2e-07,0.00025,156,185,151,180,134,208,0.89,29,29,74
OceanDNA-b17187,892,11.8,0.0,5.3e-06,0.0054,152,187,62,97,50,107,0.89,35,35,57
OceanDNA-b33317,1303,2.1,0.0,0.0046,13.0,197,230,239,271,235,282,0.89,33,32,47
OceanDNA-a4458,450,11.0,0.0,8.8e-06,0.0041,153,185,16,48,5,84,0.89,32,32,79
OceanDNA-b31245,1431,22.6,0.0,2.7e-09,5.1e-06,156,185,147,176,122,195,0.89,29,29,73
OceanDNA-b58,793,9.4,0.0,2.7e-05,0.035,150,185,235,270,220,277,0.89,35,35,57
OceanDNA-b45166,151,13.1,0.4,2.1e-06,0.003,157,187,319,349,311,357,0.89,30,30,46
OceanDNA-b24820,498,16.5,0.0,1.9e-07,0.00013,154,181,143,170,128,183,0.89,27,27,55
OceanDNA-b28125,933,18.3,0.0,5.6e-08,0.00015,153,179,180,206,165,241,0.89,26,26,76
OceanDNA-b28567,65,17.0,0.0,1.4e-07,9.9e-05,153,176,185,208,170,220,0.89,23,23,50
OceanDNA-b38332,52,17.4,0.0,1e-07,0.00015,139,179,129,170,120,183,0.89,40,41,63
OceanDNA-b23364,1374,11.3,0.1,1.4e-05,0.017,158,182,140,164,130,174,0.89,24,24,44
OceanDNA-b24045,1891,12.1,0.0,1.3e-05,0.011,152,196,109,153,92,210,0.89,44,44,118
OceanDNA-b45859,2819,8.5,0.0,0.0001,0.19,196,235,349,388,340,401,0.89,39,39,61
OceanDNA-b24005,575,13.2,0.0,1.9e-06,0.0033,198,269,585,658,571,662,0.89,71,73,91
OceanDNA-b45838,706,147.1,0.0,3.1e-47,3.9e-44,38,279,97,345,80,353,0.89,241,248,273
OceanDNA-b3711,1465,10.4,0.0,1.4e-05,0.043,124,163,436,476,430,482,0.89,39,40,52
OceanDNA-b45437,549,8.8,0.1,4.2e-05,0.053,150,189,91,130,81,141,0.89,39,39,60
OceanDNA-b38311,923,17.3,0.0,1.1e-07,0.00016,139,179,129,170,124,183,0.89,40,41,59
OceanDNA-b47105,25,11.1,0.0,8.4e-06,0.0026,192,230,247,284,242,302,0.89,38,37,60
OceanDNA-b16723,473,11.4,0.0,7.1e-06,0.0064,153,186,166,199,150,205,0.89,33,33,55
OceanDNA-b15921,218,13.4,0.0,1.7e-06,0.00058,157,181,100,124,85,132,0.89,24,24,47
OceanDNA-b15447,354,10.4,0.0,1.4e-05,0.0051,150,192,146,188,110,199,0.89,42,42,89
OceanDNA-b6218,393,11.5,0.0,6.2e-06,0.0034,187,217,282,312,273,352,0.89,30,30,79
OceanDNA-b11630,448,10.8,0.0,1.1e-05,0.0055,186,216,271,301,263,313,0.89,30,30,50
OceanDNA-b26636,3711,8.6,0.1,4.8e-05,0.19,131,168,152,189,132,189,0.89,37,37,57
OceanDNA-b13585,772,6.3,0.0,0.0013,0.38,84,119,39,74,33,89,0.89,35,35,56
OceanDNA-b32695,807,13.3,0.0,1.8e-06,0.0016,196,262,218,280,195,281,0.89,66,62,86
OceanDNA-b19928,527,3.0,0.0,0.0025,1.5,84,120,198,234,192,250,0.89,36,36,58
OceanDNA-b41583,245,6.6,0.0,0.0002,0.13,198,235,260,297,244,306,0.89,37,37,62
OceanDNA-b156,162,1.2,0.0,0.0088,24.0,162,189,165,192,151,199,0.89,27,27,48
OceanDNA-b2837,2702,3.5,0.0,0.0017,5.3,199,217,185,203,146,210,0.89,18,18,64
OceanDNA-b4522,214,10.0,0.0,1.8e-05,0.0089,160,181,83,104,78,116,0.89,21,21,38
OceanDNA-b13844,27,17.1,0.0,1.3e-07,3.8e-05,153,192,180,219,166,228,0.89,39,39,62
OceanDNA-b13539,88,15.2,0.0,9.4e-07,0.00072,152,184,502,534,485,540,0.89,32,32,55
OceanDNA-b17611,2516,11.2,0.0,2.4e-05,0.026,150,189,190,229,178,233,0.89,39,39,55
OceanDNA-b31542,1510,15.9,0.1,2.9e-07,0.00049,154,179,9,34,4,47,0.89,25,25,43
OceanDNA-b211,630,6.7,0.1,0.00037,0.17,157,176,183,202,165,213,0.89,19,19,48
OceanDNA-b38353,719,21.2,0.0,1.4e-08,1.7e-05,139,186,149,197,143,210,0.89,47,48,67
OceanDNA-b15876,457,10.7,0.1,2.3e-05,0.015,149,183,152,186,141,195,0.89,34,34,54
OceanDNA-b38938,372,16.3,0.0,2.2e-07,0.00016,159,185,149,175,129,183,0.89,26,26,54
OceanDNA-b22118,1516,16.4,0.0,2.1e-07,0.00043,134,193,513,570,509,576,0.89,59,57,67
OceanDNA-b61,724,16.7,0.0,1.6e-07,0.00019,126,185,159,218,152,226,0.89,59,59,74
OceanDNA-b27556,2014,8.6,0.0,9.8e-05,0.11,195,220,180,205,171,224,0.89,25,25,53
OceanDNA-b15465,725,1.2,0.0,0.026,9.1,197,251,297,351,280,356,0.89,54,54,76
OceanDNA-b20094,30,10.9,0.0,3e-05,0.0038,154,192,243,281,222,335,0.89,38,38,113
OceanDNA-b15465,725,9.3,0.0,9.3e-05,0.033,151,189,218,256,203,265,0.89,38,38,62
OceanDNA-b19934,261,4.5,0.0,0.00089,0.32,82,120,196,234,184,247,0.89,38,38,63
OceanDNA-b45514,593,15.0,0.0,5.5e-07,0.0011,152,187,231,266,201,277,0.89,35,35,76
OceanDNA-b44623,260,6.6,0.0,0.0002,0.43,154,182,537,565,530,578,0.89,28,28,48
OceanDNA-b15465,1021,12.4,0.0,1e-05,0.0036,150,192,6,48,3,62,0.89,42,42,59
OceanDNA-b7010,154,150.4,0.0,6.3e-48,1.3e-45,53,276,57,288,46,303,0.89,223,231,257
OceanDNA-b10577,120,12.6,0.0,3.1e-06,0.00099,184,216,273,305,261,329,0.89,32,32,68
OceanDNA-b36755,2942,13.5,0.1,3.1e-06,0.0059,156,187,99,130,84,139,0.89,31,31,55
OceanDNA-b31687,6,11.4,0.0,6.9e-06,0.019,187,263,258,332,245,339,0.89,76,74,94
OceanDNA-b3414,1223,11.8,0.2,5.2e-06,0.0075,159,187,80,108,76,114,0.89,28,28,38
OceanDNA-b24973,397,11.0,0.0,9e-06,0.004,150,189,181,220,170,238,0.89,39,39,68
OceanDNA-b16220,635,7.7,0.0,0.00018,0.11,77,151,105,181,103,195,0.89,74,76,92
OceanDNA-b42824,223,16.5,0.0,1.9e-07,0.00036,153,189,231,268,216,274,0.89,36,37,58
OceanDNA-b3621,155,4.7,0.0,0.00076,0.67,84,120,175,211,161,217,0.89,36,36,56
OceanDNA-b4494,680,5.4,0.0,0.0009,0.51,159,185,142,168,91,174,0.89,26,26,83
OceanDNA-b22864,2687,12.0,0.0,4.6e-06,0.016,150,196,236,282,228,288,0.89,46,46,60
OceanDNA-b45857,2941,7.5,0.0,0.00021,0.42,196,235,255,294,245,307,0.89,39,39,62
OceanDNA-b14655,306,10.3,0.0,1.4e-05,0.0072,151,187,163,199,153,208,0.89,36,36,55
OceanDNA-b19147,46,11.1,0.0,1.7e-05,0.003,89,121,209,241,203,258,0.89,32,32,55
OceanDNA-b17589,1703,10.9,0.0,1.9e-05,0.018,104,130,59,85,49,94,0.89,26,26,45
OceanDNA-b31592,1648,15.2,0.0,4.9e-07,0.0012,154,185,161,192,145,199,0.89,31,31,54
OceanDNA-b45370,3,12.8,0.1,2.6e-06,0.0033,152,187,241,276,232,286,0.89,35,35,54
OceanDNA-b17273,142,215.4,0.1,1.5e-67,1.3e-64,54,281,65,300,50,311,0.89,227,235,261
OceanDNA-b33113,70,5.3,0.0,0.0005,0.27,192,221,170,199,161,213,0.89,29,29,52
OceanDNA-b21028,240,16.1,0.0,5e-07,0.00065,153,185,189,221,175,229,0.89,32,32,54
OceanDNA-b3704,1601,18.4,0.0,5e-08,0.00014,154,180,142,168,135,180,0.89,26,26,45
OceanDNA-b35898,1605,15.8,0.0,3.1e-07,0.00061,152,203,151,201,96,207,0.89,51,50,111
OceanDNA-b32,528,10.9,0.0,1.9e-05,0.0058,144,176,129,161,86,167,0.89,32,32,81
OceanDNA-b32969,132,14.8,0.0,6.5e-07,0.00033,155,185,157,187,150,222,0.89,30,30,72
OceanDNA-b34266,2223,10.5,0.0,1.3e-05,0.035,102,136,225,259,208,267,0.89,34,34,59
OceanDNA-b17589,1582,12.2,0.0,8.1e-06,0.0078,104,132,8,36,2,46,0.89,28,28,44
OceanDNA-b28578,509,14.4,0.0,8.6e-07,0.00053,154,176,143,165,127,185,0.89,22,22,58
OceanDNA-b10366,399,12.9,0.0,5e-06,0.004,175,230,249,304,244,312,0.89,55,55,68
OceanDNA-b17623,1212,10.9,0.4,2e-05,0.03,140,185,151,196,61,209,0.88,45,45,148
OceanDNA-b42522,68,7.8,0.0,0.00017,0.026,195,237,260,301,254,311,0.88,42,41,57
OceanDNA-b46188,73,7.1,0.0,0.00014,0.11,197,262,178,240,171,243,0.88,65,62,72
OceanDNA-b2796,846,21.9,0.0,8.7e-09,8.8e-06,146,190,306,352,291,360,0.88,44,46,69
OceanDNA-b17034,171,14.2,0.0,1.9e-06,0.00088,154,221,176,243,162,263,0.88,67,67,101
OceanDNA-b4007,753,17.0,0.1,1.3e-07,0.00014,193,266,194,265,187,284,0.88,73,71,97
OceanDNA-b21437,139,6.5,0.0,0.00022,0.048,192,218,175,201,169,230,0.88,26,26,61
OceanDNA-b30757,244,13.4,0.0,1.7e-06,0.0007,153,184,167,198,153,207,0.88,31,31,54
OceanDNA-b23850,1393,8.6,0.0,0.00015,0.073,155,183,141,169,135,181,0.88,28,28,46
OceanDNA-b40629,357,7.5,0.0,0.0001,0.064,160,187,89,116,75,126,0.88,27,27,51
OceanDNA-b26155,41,22.2,0.0,3.6e-09,1.8e-06,86,183,67,168,59,207,0.88,97,101,148
OceanDNA-b46309,65,17.6,0.0,2.7e-07,0.00021,147,193,228,274,218,281,0.88,46,46,63
OceanDNA-b28583,702,2.8,0.0,0.0028,2.7,192,229,244,281,228,295,0.88,37,37,67
OceanDNA-b45859,1146,17.1,0.0,2.5e-07,0.00046,152,185,146,179,132,185,0.88,33,33,53
OceanDNA-b23054,1548,10.5,0.0,2.6e-05,0.032,105,141,53,89,43,112,0.88,36,36,69
OceanDNA-b46695,283,13.9,0.1,7.1e-06,0.0026,151,186,161,196,150,207,0.88,35,35,57
OceanDNA-b13836,229,5.5,0.0,0.00044,0.13,197,228,583,613,568,621,0.88,31,30,53
OceanDNA-b7584,366,12.9,0.0,2.3e-06,0.00089,187,217,287,317,281,345,0.88,30,30,64
OceanDNA-b4858,199,123.9,0.0,3.6e-40,7.2e-38,55,282,35,273,25,284,0.88,227,238,259
OceanDNA-b25027,809,11.1,0.1,8.2e-06,0.0068,161,187,149,175,135,183,0.88,26,26,48
OceanDNA-b24641,274,13.4,0.1,1.7e-06,0.00056,190,265,179,252,168,255,0.88,75,73,87
OceanDNA-b13615,335,13.1,0.0,2.1e-06,0.00075,149,183,108,142,95,151,0.88,34,34,56
OceanDNA-b44435,2563,11.0,0.0,1.8e-05,0.023,198,264,475,543,469,546,0.88,66,68,77
OceanDNA-b15450,1537,21.2,0.0,1.4e-08,1.4e-05,194,243,166,213,151,223,0.88,49,47,72
OceanDNA-b23783,1703,12.3,0.1,3.7e-06,0.007,153,180,224,251,139,264,0.88,27,27,125
OceanDNA-b5215,68,14.8,0.0,6.5e-07,0.00019,139,185,97,143,92,156,0.88,46,46,64
OceanDNA-b46536,1384,13.1,0.0,2.1e-06,0.003,147,194,169,216,158,223,0.88,47,47,65
OceanDNA-b28259,95,19.3,0.0,2.6e-08,1.1e-05,154,185,139,170,123,179,0.88,31,31,56
OceanDNA-b29509,2319,4.4,0.0,0.0018,4.1,156,191,151,186,139,208,0.88,35,35,69
OceanDNA-b45508,965,9.6,0.1,2.4e-05,0.027,151,191,126,166,116,175,0.88,40,40,59
OceanDNA-b10602,177,12.1,0.0,8.6e-06,0.0014,185,216,281,312,268,323,0.88,31,31,55
OceanDNA-b24725,2081,8.1,0.0,0.00014,0.19,155,217,173,234,150,240,0.88,62,61,90
OceanDNA-b6582,313,14.0,0.0,1.1e-06,0.00068,173,220,196,243,193,257,0.88,47,47,64
OceanDNA-b3982,21,13.7,0.0,4.2e-06,0.00084,159,185,154,180,136,188,0.88,26,26,52
OceanDNA-b23370,2087,13.1,0.1,4.2e-06,0.0044,160,185,306,331,301,339,0.88,25,25,38
OceanDNA-b20951,1368,12.5,0.0,6.3e-06,0.008,123,185,28,92,18,114,0.88,62,64,96
OceanDNA-b5399,377,45.9,0.1,2.2e-16,1.1e-13,156,245,147,239,67,248,0.88,89,92,181
OceanDNA-b26776,1836,6.0,0.0,0.00059,0.7,194,230,261,297,245,307,0.88,36,36,62
OceanDNA-b30447,350,7.8,0.1,8.3e-05,0.22,160,187,177,204,168,214,0.88,27,27,46
OceanDNA-b20991,1065,12.1,0.0,1.3e-05,0.0082,153,186,295,328,279,358,0.88,33,33,79
OceanDNA-b38741,416,-1.5,0.0,0.059,30.0,107,121,178,192,163,196,0.88,14,14,33
OceanDNA-b5654,190,15.4,0.0,4.2e-07,0.00011,149,232,118,199,107,222,0.88,83,81,115
OceanDNA-b36886,1428,15.1,0.0,5.2e-07,0.00095,154,179,138,163,123,182,0.88,25,25,59
OceanDNA-b43,3730,10.8,0.0,2e-05,0.068,198,265,650,719,641,722,0.88,67,69,81
OceanDNA-b46308,465,10.9,0.0,1e-05,0.02,144,193,236,283,227,300,0.88,49,47,73
OceanDNA-b109,1050,2.3,0.0,0.0039,10.0,195,257,470,532,449,541,0.88,62,62,92
OceanDNA-b28155,1056,4.0,0.0,0.0012,1.9,159,188,88,117,68,150,0.88,29,29,82
OceanDNA-b7003,11,147.9,0.0,1.9e-47,8.2e-45,53,275,52,282,28,298,0.88,222,230,270
OceanDNA-b33318,3389,19.7,0.0,2.1e-08,9.5e-05,154,183,144,173,129,189,0.88,29,29,60
OceanDNA-b42,3294,10.6,0.0,1.2e-05,0.067,198,264,449,517,440,523,0.88,66,68,83
OceanDNA-b1333,585,2.1,0.0,0.014,7.2,91,134,249,292,233,297,0.88,43,43,64
OceanDNA-b15834,331,11.7,0.0,5.5e-06,0.0063,151,186,168,203,156,209,0.88,35,35,53
OceanDNA-b46906,628,14.1,0.0,1.1e-06,0.00083,132,176,147,191,128,229,0.88,44,44,101
OceanDNA-b34949,338,10.3,0.0,4.5e-05,0.015,71,121,19,69,4,86,0.88,50,50,82
OceanDNA-b28646,761,12.7,0.0,2.7e-06,0.0031,154,176,146,168,129,186,0.88,22,22,57
OceanDNA-b36072,497,13.9,0.0,1.2e-06,0.0011,154,180,13,39,5,52,0.88,26,26,47
OceanDNA-b22917,2318,10.2,0.0,6.5e-05,0.046,157,185,154,182,125,187,0.88,28,28,62
OceanDNA-b24654,471,13.5,0.0,1.5e-06,0.0011,76,119,51,96,23,104,0.88,43,45,81
OceanDNA-b32277,1368,19.6,0.0,2.2e-08,4.5e-05,154,181,153,180,138,193,0.88,27,27,55
OceanDNA-b24169,608,9.7,0.0,2.2e-05,0.022,140,180,75,115,43,128,0.88,40,40,85
OceanDNA-b45257,1415,12.4,0.1,3.4e-06,0.0075,149,188,211,250,153,253,0.88,39,39,100
OceanDNA-b32281,1901,21.0,0.0,8e-09,1.6e-05,154,182,26,54,11,65,0.88,28,28,54
OceanDNA-b24637,144,12.7,0.0,2.8e-06,0.0019,69,115,159,205,149,216,0.88,46,46,67
OceanDNA-b26781,1409,12.9,0.0,4.7e-06,0.0041,154,180,71,97,63,110,0.88,26,26,47
OceanDNA-b24637,144,0.0,0.1,0.02,13.0,94,111,71,88,56,92,0.88,17,17,36
OceanDNA-b40527,138,5.7,0.0,0.00075,0.29,201,264,232,295,224,298,0.88,63,63,74
OceanDNA-b26699,34,15.4,0.0,4.1e-07,0.001,152,190,191,229,179,239,0.88,38,38,60
OceanDNA-b6509,444,3.6,0.0,0.0017,1.7,229,272,250,291,239,297,0.88,43,41,58
OceanDNA-b37918,626,15.8,0.0,3.1e-07,0.00024,154,181,32,59,25,85,0.88,27,27,60
OceanDNA-b31567,588,15.4,0.1,8.3e-07,0.0007,155,185,5,35,3,42,0.88,30,30,39
OceanDNA-b29579,235,14.5,0.1,8e-07,0.00057,153,177,138,162,130,178,0.88,24,24,48
OceanDNA-b29612,2274,8.6,0.1,4.7e-05,0.13,155,193,129,167,125,175,0.88,38,38,50
OceanDNA-b13250,3720,8.5,0.0,0.00051,0.21,189,230,248,288,240,296,0.88,41,40,56
OceanDNA-b32144,436,26.5,0.1,1.7e-10,4.6e-07,75,189,52,164,37,175,0.88,114,112,138
OceanDNA-b30722,230,13.5,0.0,1.5e-06,0.0014,154,178,144,168,129,187,0.88,24,24,58
OceanDNA-b46309,179,6.0,0.4,0.00093,0.72,157,181,179,203,171,210,0.88,24,24,39
OceanDNA-b22287,1008,12.3,0.0,3.6e-06,0.0052,152,184,133,165,126,178,0.88,32,32,52
OceanDNA-b9937,387,11.6,0.0,6e-06,0.0025,134,188,99,151,90,158,0.88,54,52,68
OceanDNA-b46224,597,10.6,0.0,2.4e-05,0.012,147,195,201,249,191,257,0.88,48,48,66
OceanDNA-b22421,360,11.1,0.0,8.8e-06,0.033,134,173,156,192,135,209,0.88,39,36,74
OceanDNA-b42457,240,6.5,0.0,0.00042,0.066,196,238,268,309,263,331,0.88,42,41,68
OceanDNA-b8264,535,11.0,0.0,1.8e-05,0.0065,182,216,287,321,275,328,0.88,34,34,53
OceanDNA-b20995,1577,10.5,0.1,2.5e-05,0.065,147,185,53,91,40,95,0.88,38,38,55
OceanDNA-b32911,528,8.7,0.0,4.5e-05,0.06,176,220,190,234,184,271,0.88,44,44,87
OceanDNA-b11455,288,13.0,0.0,2.2e-06,0.0017,150,188,236,274,198,280,0.88,38,38,82
OceanDNA-b19896,68,2.3,0.0,0.0041,1.6,89,121,208,240,199,252,0.88,32,32,53
OceanDNA-b26893,2035,5.4,0.0,0.00095,1.6,189,244,248,303,243,310,0.88,55,55,67
OceanDNA-b13263,277,10.3,0.0,3e-05,0.015,153,191,149,187,86,191,0.88,38,38,105
OceanDNA-b30095,1634,10.6,0.0,2.5e-05,0.031,160,182,83,105,73,130,0.88,22,22,57
OceanDNA-b13088,539,13.8,0.0,1.3e-06,0.0047,198,264,608,676,603,679,0.88,66,68,76
OceanDNA-b28587,550,8.6,0.0,4.8e-05,0.041,192,227,244,279,226,294,0.88,35,35,68
OceanDNA-b24045,1983,4.2,0.0,0.0033,2.9,160,192,98,130,86,137,0.88,32,32,51
OceanDNA-b38880,867,3.4,0.0,0.0038,1.8,187,213,190,216,175,238,0.88,26,26,63
OceanDNA-b32153,1760,9.7,0.0,2.2e-05,0.056,196,235,273,312,250,328,0.88,39,39,78
OceanDNA-b44357,392,13.4,0.0,1.7e-06,0.00096,150,184,97,131,75,137,0.88,34,34,62
OceanDNA-b15080,267,12.0,0.0,4.5e-06,0.0046,157,181,126,150,118,158,0.88,24,24,40
OceanDNA-b211,220,13.0,0.0,4.3e-06,0.002,151,188,136,174,107,184,0.88,37,38,77
OceanDNA-b22387,366,13.7,0.0,2.7e-06,0.003,151,190,238,277,230,289,0.88,39,39,59
OceanDNA-b37094,887,13.6,0.0,1.5e-06,0.0014,198,264,646,714,610,717,0.88,66,68,107
OceanDNA-b10708,286,151.7,0.0,1.3e-48,5.5e-46,51,276,40,272,11,291,0.88,225,232,280
OceanDNA-b32925,605,8.1,0.0,6.9e-05,0.16,176,220,192,236,186,273,0.88,44,44,87
OceanDNA-b6503,557,9.2,0.1,6.3e-05,0.02,175,219,197,241,192,262,0.88,44,44,70
OceanDNA-b24743,76,12.5,0.0,3.2e-06,0.0025,154,181,156,183,141,196,0.88,27,27,55
OceanDNA-b22383,3202,10.5,0.2,5e-05,0.043,161,188,135,162,130,178,0.88,27,27,48
OceanDNA-b13621,87,14.7,0.0,1.4e-06,0.00021,151,183,129,161,118,170,0.88,32,32,52
OceanDNA-b6173,392,133.1,0.2,5.9e-43,3.3e-40,72,281,53,273,20,287,0.88,209,220,267
OceanDNA-b22885,1053,13.0,0.0,4.4e-06,0.0093,146,195,188,237,169,302,0.88,49,49,133
OceanDNA-b15541,126,11.6,0.0,1.8e-05,0.012,150,191,150,191,133,199,0.88,41,41,66
OceanDNA-b15769,856,11.7,0.0,2.2e-05,0.0097,151,186,185,220,175,226,0.88,35,35,51
OceanDNA-b14831,96,11.9,0.1,4.7e-06,0.0013,67,111,140,184,126,200,0.88,44,44,74
OceanDNA-b22513,1918,9.7,0.0,2.2e-05,0.063,150,189,222,261,209,269,0.88,39,39,60
OceanDNA-b45536,507,15.8,0.0,3e-07,0.00018,153,188,250,285,245,300,0.88,35,35,55
OceanDNA-b6423,306,157.0,0.1,3e-50,1.5e-47,48,275,38,272,8,287,0.88,227,234,279
OceanDNA-b35167,467,30.0,0.0,1.5e-11,1.2e-08,134,188,34,85,22,98,0.88,54,51,76
OceanDNA-b32271,1556,18.6,0.0,4.5e-08,8.1e-05,155,181,145,171,130,184,0.88,26,26,54
OceanDNA-b40685,345,211.2,0.2,1.9e-66,1.1e-63,44,274,25,270,21,281,0.88,230,245,260
OceanDNA-b33388,2817,18.2,0.0,2.8e-07,0.00022,154,183,414,443,399,462,0.88,29,29,63
OceanDNA-b22842,1272,18.8,0.0,7.4e-08,0.00017,84,185,222,324,214,332,0.88,101,102,118
OceanDNA-b36722,553,9.5,0.0,5.1e-05,0.025,161,181,147,167,132,175,0.88,20,20,43
OceanDNA-b17549,984,14.3,0.0,9.2e-07,0.0035,154,189,270,305,257,317,0.88,35,35,60
OceanDNA-b4683,266,133.7,0.0,3.8e-43,1.9e-40,71,275,56,266,27,283,0.88,204,210,256
OceanDNA-b44039,31,22.7,0.0,4.8e-09,7.3e-07,154,182,136,164,119,176,0.88,28,28,57
OceanDNA-b46656,3169,11.5,0.1,2e-05,0.022,153,186,242,275,227,282,0.88,33,33,55
OceanDNA-b44350,592,11.2,0.0,8e-06,0.0048,150,186,268,304,243,339,0.88,36,36,96
OceanDNA-b7279,223,14.4,0.0,1.7e-06,0.00032,182,217,78,113,65,123,0.88,35,35,58
OceanDNA-b29383,363,11.4,0.0,6.9e-06,0.0059,159,182,82,105,24,118,0.88,23,23,94
OceanDNA-b23484,1131,10.9,0.0,2e-05,0.018,154,180,143,169,125,182,0.88,26,26,57
OceanDNA-b47086,269,9.2,0.1,6.5e-05,0.14,149,192,268,311,257,323,0.88,43,43,66
OceanDNA-b6345,278,143.2,0.1,4.9e-46,1.4e-43,72,282,66,287,40,299,0.88,210,221,259
OceanDNA-b23004,1653,10.1,0.1,1.7e-05,0.074,157,185,170,198,165,207,0.88,28,28,42
OceanDNA-b23104,2618,11.0,0.0,2.7e-05,0.036,153,193,7,48,2,113,0.88,40,41,111
OceanDNA-b31076,1999,15.8,0.0,9.6e-07,0.00095,149,192,181,224,170,236,0.88,43,43,66
OceanDNA-b4060,782,14.8,0.0,1.3e-06,0.0005,160,184,148,172,121,181,0.88,24,24,60
OceanDNA-b17563,225,8.8,0.0,8.6e-05,0.095,154,192,191,229,172,238,0.88,38,38,66
OceanDNA-b15876,464,13.3,0.0,3.6e-06,0.0023,151,187,168,204,157,210,0.88,36,36,53
OceanDNA-b46625,550,13.8,0.0,3.9e-06,0.0012,153,188,197,232,193,244,0.88,35,35,51
OceanDNA-b7184,341,16.4,0.0,4.2e-07,0.00011,183,215,272,304,262,313,0.88,32,32,51
OceanDNA-b3978,495,14.0,0.0,1.1e-06,0.001,159,185,156,182,137,191,0.88,26,26,54
OceanDNA-b20952,4,12.4,0.0,3.3e-06,0.012,124,185,29,92,19,114,0.88,61,63,95
OceanDNA-b36729,927,7.3,0.1,0.00012,0.27,153,184,235,266,217,282,0.88,31,31,65
OceanDNA-b22324,2077,13.5,0.0,4.6e-06,0.0063,152,185,232,265,219,281,0.88,33,33,62
OceanDNA-b6778,256,9.4,0.0,2.7e-05,0.017,186,215,273,302,265,314,0.88,29,29,49
OceanDNA-b26613,119,12.2,0.1,4e-06,0.0023,157,190,90,123,59,144,0.88,33,33,85
OceanDNA-b46252,2090,0.2,0.1,0.072,41.0,181,199,125,143,116,147,0.87,18,18,31
OceanDNA-b13544,146,-0.9,0.1,0.037,43.0,88,116,53,81,48,83,0.87,28,28,35
OceanDNA-b33284,2828,15.6,0.0,3.5e-07,0.0017,155,180,155,180,137,198,0.87,25,25,61
OceanDNA-b45293,154,10.4,0.0,1.4e-05,0.018,155,180,159,184,142,198,0.87,25,25,56
OceanDNA-b32911,528,6.6,0.0,0.00019,0.26,148,180,86,118,67,125,0.87,32,32,58
OceanDNA-b30257,76,16.3,0.0,2.2e-07,0.00046,154,179,172,197,156,220,0.87,25,25,64
OceanDNA-b31535,300,16.1,0.0,2.5e-07,0.00071,155,180,161,186,144,201,0.87,25,25,57
OceanDNA-b13544,146,8.3,0.0,6e-05,0.071,159,188,122,151,118,162,0.87,29,29,44
OceanDNA-b33299,3441,13.5,0.1,1.6e-06,0.0063,155,179,454,478,448,492,0.87,24,24,44
OceanDNA-b15137,1468,17.8,0.0,2.4e-07,0.00016,153,190,115,152,98,200,0.87,37,37,102
OceanDNA-b15777,892,1.3,0.0,0.025,14.0,160,178,141,159,121,169,0.87,18,18,48
OceanDNA-b15517,600,15.3,0.0,4.3e-07,0.0005,122,198,86,155,56,163,0.87,76,69,107
OceanDNA-b29386,888,10.9,0.0,2e-05,0.019,127,184,117,173,90,183,0.87,57,56,93
OceanDNA-b26737,1759,5.5,0.0,0.00083,0.99,230,268,232,271,208,276,0.87,38,39,68
OceanDNA-b13261,228,56.6,0.0,2.3e-19,1.4e-16,107,269,184,343,169,364,0.87,162,159,195
OceanDNA-b37895,508,9.3,0.0,5.9e-05,0.023,198,266,601,671,596,674,0.87,68,70,78
OceanDNA-b21507,90,3.4,0.0,0.0019,0.33,216,255,192,231,184,249,0.87,39,39,65
OceanDNA-b20092,192,9.6,0.0,2.4e-05,0.0058,154,192,247,285,226,298,0.87,38,38,72
OceanDNA-b15078,251,13.6,0.1,1.5e-06,0.0016,158,182,19,43,13,51,0.87,24,24,38
OceanDNA-b27600,381,13.0,0.0,2.3e-06,0.0037,154,178,147,171,130,184,0.87,24,24,54
OceanDNA-b9617,142,11.2,0.0,7.9e-06,0.0019,157,180,100,123,82,131,0.87,23,23,49
OceanDNA-b6426,302,148.1,0.0,1.6e-47,1.1e-44,49,275,35,268,4,277,0.87,226,233,273
OceanDNA-b11822,70,10.0,0.1,1.8e-05,0.017,157,181,131,155,126,164,0.87,24,24,38
OceanDNA-b40618,49,198.7,0.0,2.5e-62,3.8e-60,68,275,51,275,32,288,0.87,207,224,256
OceanDNA-b9609,10,21.2,0.1,7.1e-09,2.2e-06,151,195,136,183,45,189,0.87,44,47,144
OceanDNA-b23379,1414,14.5,0.1,1.6e-06,0.0018,157,182,267,292,251,298,0.87,25,25,47
OceanDNA-b13158,100,12.5,0.0,3.3e-06,0.0017,140,184,125,169,119,177,0.87,44,44,58
OceanDNA-b23382,1938,11.8,0.1,5.3e-06,0.012,161,184,190,213,179,222,0.87,23,23,43
OceanDNA-b22808,143,23.2,0.0,1.7e-09,7.2e-06,151,188,98,136,84,170,0.87,37,38,86
OceanDNA-b32139,904,9.2,0.2,6.3e-05,0.074,160,189,124,154,113,159,0.87,29,30,46
OceanDNA-b19574,99,1.6,0.0,0.0065,2.5,89,120,243,274,235,289,0.87,31,31,54
OceanDNA-b33388,2196,14.2,0.0,4.8e-06,0.0036,151,190,139,177,82,191,0.87,39,38,109
OceanDNA-b36140,786,11.1,0.0,1.7e-05,0.024,149,184,110,145,58,153,0.87,35,35,95
OceanDNA-b18796,201,5.4,0.1,0.00045,0.13,89,122,203,236,196,273,0.87,33,33,77
OceanDNA-b20505,46,1.6,0.0,0.0069,1.9,80,120,125,165,111,173,0.87,40,40,62
OceanDNA-b27579,40,5.6,0.1,0.00082,1.2,153,187,117,151,96,168,0.87,34,34,72
OceanDNA-b32285,973,13.2,0.0,2e-06,0.002,157,180,149,172,138,190,0.87,23,23,52
OceanDNA-b11789,1224,10.9,0.0,1e-05,0.013,154,180,125,151,66,203,0.87,26,26,137
OceanDNA-b41272,1357,3.7,0.0,0.0015,3.5,161,185,114,138,97,170,0.87,24,24,73
OceanDNA-b45854,1983,12.1,0.0,1.3e-05,0.009,155,184,45,74,21,80,0.87,29,29,59
OceanDNA-b38049,473,9.5,0.0,2.7e-05,0.021,198,264,624,692,619,695,0.87,66,68,76
OceanDNA-b37268,282,21.8,0.0,4.7e-09,7.5e-06,153,180,143,170,124,186,0.87,27,27,62
OceanDNA-a3660,363,21.2,0.0,6.9e-09,2.9e-06,153,194,67,109,53,134,0.87,41,42,81
OceanDNA-b30001,1264,6.5,0.0,0.00043,0.35,195,228,261,294,245,316,0.87,33,33,71
OceanDNA-b46229,1046,10.6,0.1,2.4e-05,0.018,153,186,246,279,235,286,0.87,33,33,51
OceanDNA-b31270,447,15.6,0.1,3.5e-07,0.00083,156,180,166,190,162,203,0.87,24,24,41
OceanDNA-b23394,1879,13.1,0.1,4.2e-06,0.0052,161,183,193,215,187,225,0.87,22,22,38
OceanDNA-b32786,393,10.5,0.0,3.9e-05,0.021,149,185,234,270,179,275,0.87,36,36,96
OceanDNA-b10020,85,14.0,0.0,3.3e-06,0.00054,193,266,194,265,186,282,0.87,73,71,96
OceanDNA-b35127,740,15.7,0.0,3.3e-07,0.00033,198,264,622,690,600,692,0.87,66,68,92
OceanDNA-b46695,1303,16.8,0.0,9.2e-07,0.00034,133,185,131,178,118,205,0.87,52,47,87
OceanDNA-b19403,295,9.2,0.0,3.1e-05,0.0095,84,121,191,228,180,244,0.87,37,37,64
OceanDNA-b23974,166,10.2,0.0,1.6e-05,0.02,193,229,136,172,120,197,0.87,36,36,77
OceanDNA-b13585,50,18.6,0.0,2.2e-07,6.7e-05,139,180,138,181,128,207,0.87,41,43,79
OceanDNA-b45857,4007,17.1,0.0,2.6e-07,0.00052,136,185,180,229,173,237,0.87,49,49,64
OceanDNA-b7450,617,22.3,0.1,6.5e-09,4.2e-06,192,268,184,258,176,282,0.87,76,74,106
OceanDNA-b23327,1031,-3.4,0.0,0.43,340.0,124,140,248,264,246,264,0.87,16,16,18
OceanDNA-b5623,189,16.8,0.0,1.6e-07,4.9e-05,151,232,145,225,133,249,0.87,81,80,116
OceanDNA-b23327,389,12.0,0.0,9.3e-06,0.0074,160,182,222,244,211,258,0.87,22,22,47
OceanDNA-b10365,545,8.7,0.0,9.1e-05,0.031,160,178,65,83,3,101,0.87,18,18,98
OceanDNA-b30042,1923,5.1,0.0,0.0018,2.0,195,220,191,216,156,245,0.87,25,25,89
OceanDNA-b22174,57,-3.1,0.0,0.18,110.0,82,101,294,313,291,321,0.87,19,19,30
OceanDNA-b9951,224,148.1,0.0,1.6e-47,6.4e-45,54,278,43,275,30,293,0.87,224,232,263
OceanDNA-b23655,661,5.0,0.0,0.0012,1.1,197,230,268,300,252,308,0.87,33,32,56
OceanDNA-b33329,23,11.6,0.0,1.7e-05,0.0091,153,183,440,470,427,482,0.87,30,30,55
OceanDNA-b32913,1254,11.8,0.3,1e-05,0.0096,131,185,233,284,228,288,0.87,54,51,60
OceanDNA-b23825,839,8.7,0.1,8.8e-05,0.069,159,189,133,163,118,195,0.87,30,30,77
OceanDNA-b22078,326,12.1,0.0,4.2e-06,0.0066,154,189,142,177,54,194,0.87,35,35,140
OceanDNA-b13585,820,11.5,0.0,3.1e-05,0.0094,153,189,93,129,80,139,0.87,36,36,59
OceanDNA-b36882,1133,5.4,0.0,0.00046,0.73,84,120,78,114,56,120,0.87,36,36,64
OceanDNA-b19665,207,12.0,0.0,9.1e-06,0.0022,147,194,74,121,62,129,0.87,47,47,67
OceanDNA-b28506,368,11.9,0.0,4.9e-06,0.0027,160,180,150,170,138,193,0.87,20,20,55
OceanDNA-b19665,86,0.5,0.0,0.028,6.8,91,120,227,256,219,262,0.87,29,29,43
OceanDNA-b21004,1525,15.3,0.0,1.3e-06,0.00084,180,261,187,264,182,267,0.87,81,77,85
OceanDNA-b40884,305,26.6,0.0,1.6e-10,6e-08,138,181,125,170,116,184,0.87,43,45,68
OceanDNA-b36882,1133,3.8,0.1,0.0014,2.2,154,177,169,193,147,225,0.87,23,24,78
OceanDNA-b20913,6767,11.2,0.1,1.6e-05,0.06,161,182,133,154,122,165,0.87,21,21,43
OceanDNA-b45222,860,12.5,0.0,3.3e-06,0.0083,152,208,179,236,120,241,0.87,56,57,121
OceanDNA-b22997,133,67.9,0.0,1.3e-22,4.4e-20,33,244,18,235,2,249,0.87,211,217,247
OceanDNA-b3983,730,12.4,0.0,1e-05,0.0036,152,188,347,384,331,413,0.87,36,37,82
OceanDNA-b42457,210,10.1,0.0,3.4e-05,0.0055,160,189,139,168,123,251,0.87,29,29,128
OceanDNA-b7440,29,145.0,0.0,1.4e-46,4.7e-44,50,275,37,269,8,286,0.87,225,232,278
OceanDNA-b39627,78,2.1,0.1,0.0045,1.9,135,161,123,149,112,164,0.87,26,26,52
OceanDNA-b13006,155,13.3,0.0,1.8e-06,0.00066,152,191,207,247,195,273,0.87,39,40,78
OceanDNA-b8077,136,14.3,0.0,9.2e-07,0.00018,134,185,99,148,35,159,0.87,51,49,124
OceanDNA-b46702,1106,15.4,0.0,8.4e-07,0.00075,151,186,159,194,147,205,0.87,35,35,58
OceanDNA-b32925,605,6.2,0.0,0.00026,0.59,147,180,87,120,65,126,0.87,33,33,61
OceanDNA-b19626,358,10.1,0.0,3.5e-05,0.0085,221,277,255,311,226,314,0.87,56,56,88
OceanDNA-b46124,102,10.5,0.0,1.3e-05,0.0036,152,196,139,183,130,294,0.87,44,44,164
OceanDNA-b16280,24,6.6,0.0,0.0002,0.054,89,121,236,268,226,278,0.87,32,32,52
OceanDNA-b29496,1108,13.3,0.1,3.6e-06,0.0047,157,182,149,174,105,192,0.87,25,25,87
OceanDNA-b6501,215,15.9,0.0,8.9e-07,0.00015,198,264,611,679,606,680,0.87,66,68,74
OceanDNA-b45383,5853,12.0,0.0,8.8e-06,0.04,160,220,15,75,8,88,0.87,60,60,80
OceanDNA-b2866,2501,12.4,0.0,1e-05,0.0091,154,180,164,190,147,198,0.87,26,26,51
OceanDNA-b17033,808,13.4,0.0,3.3e-06,0.0026,180,230,231,282,207,314,0.87,50,51,107
OceanDNA-b19626,143,23.9,0.0,2.1e-09,5.1e-07,147,196,216,264,160,299,0.87,49,48,139
OceanDNA-b33391,2935,20.0,0.1,1.7e-08,9.6e-05,79,172,42,134,23,144,0.87,93,92,121
OceanDNA-b20982,1046,8.0,0.0,7.5e-05,0.22,153,180,137,164,127,176,0.87,27,27,49
OceanDNA-b32753,11,1.8,0.0,0.0058,2.8,196,219,296,319,280,346,0.87,23,23,66
OceanDNA-b31694,127,18.1,0.0,6.3e-08,8.6e-05,154,181,124,151,108,161,0.87,27,27,53
OceanDNA-b16265,572,4.5,0.0,0.00084,1.0,91,119,124,152,111,167,0.87,28,28,56
OceanDNA-b31271,856,16.6,0.0,1.7e-07,0.00043,156,181,168,193,163,205,0.87,25,25,42
OceanDNA-b16123,88,12.7,0.0,5.3e-06,0.002,154,181,143,170,127,244,0.87,27,27,117
OceanDNA-b26639,931,0.6,0.0,0.013,18.0,197,220,208,231,196,233,0.87,23,23,37
OceanDNA-b8222,62,12.2,0.0,3.9e-06,0.0011,186,217,200,231,194,261,0.87,31,31,67
OceanDNA-b31995,2721,2.0,0.0,0.005,17.0,60,75,211,226,207,234,0.87,15,15,27
OceanDNA-b37593,2183,10.0,0.0,1.8e-05,0.047,75,119,70,114,63,122,0.87,44,44,59
OceanDNA-b2854,33,14.4,0.0,2.6e-06,0.003,138,173,225,260,216,275,0.87,35,35,59
OceanDNA-b466,148,12.7,0.0,8e-06,0.0078,153,181,143,171,125,179,0.87,28,28,54
OceanDNA-b24083,575,9.0,0.0,3.6e-05,0.025,151,196,121,167,50,173,0.87,45,46,123
OceanDNA-b22806,2866,12.1,0.0,1.3e-05,0.02,150,183,244,277,233,285,0.87,33,33,52
OceanDNA-b9687,398,12.3,0.0,7.1e-06,0.0031,198,266,621,691,617,693,0.87,68,70,76
OceanDNA-b23643,1966,9.8,0.0,4.2e-05,0.052,115,185,69,133,61,144,0.87,70,64,83
OceanDNA-b36617,25,10.9,0.0,1.9e-05,0.0095,159,192,198,231,168,243,0.87,33,33,75
OceanDNA-b22386,1518,18.3,0.0,2.1e-07,0.00011,138,191,75,128,66,138,0.87,53,53,72
OceanDNA-b2592,2047,18.4,0.0,1e-07,0.00013,150,190,181,223,171,229,0.87,40,42,58
OceanDNA-b22888,200,12.9,0.1,4.6e-06,0.0031,108,176,188,254,154,261,0.87,68,66,107
OceanDNA-b40232,2108,212.3,0.0,8.7e-67,1e-63,45,275,112,357,104,370,0.87,230,245,266
OceanDNA-b22387,1226,16.5,0.0,3.9e-07,0.00043,138,191,253,306,245,316,0.87,53,53,71
OceanDNA-b11787,224,40.9,0.0,7.1e-15,4.6e-12,76,243,138,311,135,321,0.87,167,173,186
OceanDNA-b28141,466,10.6,0.0,2.4e-05,0.02,155,182,178,205,156,220,0.87,27,27,64
OceanDNA-b41014,1477,11.4,0.0,2.1e-05,0.015,94,131,70,108,54,117,0.87,37,38,63
OceanDNA-b9835,190,13.6,0.0,1.5e-06,0.00044,144,189,69,114,42,125,0.87,45,45,83
OceanDNA-b34860,267,13.5,0.0,1.5e-06,0.0011,198,265,615,684,578,686,0.87,67,69,108
OceanDNA-b288,2663,34.1,0.0,8.2e-13,2.5e-09,151,245,221,317,189,326,0.87,94,96,137
OceanDNA-b20918,1140,16.9,0.0,2.9e-07,0.00046,147,214,221,289,202,298,0.87,67,68,96
OceanDNA-b37704,397,14.2,0.0,9.9e-07,0.00059,151,180,170,199,149,211,0.87,29,29,62
OceanDNA-b29993,55,15.4,0.0,4.3e-07,0.00061,153,177,145,169,129,186,0.87,24,24,57
OceanDNA-b35812,173,0.8,0.0,0.012,21.0,234,265,276,307,243,309,0.87,31,31,66
OceanDNA-b10504,90,28.9,0.0,3.3e-11,9e-09,140,198,124,183,86,207,0.87,58,59,121
OceanDNA-b21014,2057,11.3,0.0,7.2e-06,0.022,153,186,151,184,134,214,0.87,33,33,80
OceanDNA-b22184,660,11.4,0.0,6.8e-06,0.017,147,195,20,68,9,83,0.87,48,48,74
OceanDNA-b32747,410,7.4,0.0,0.00011,0.053,147,187,218,258,150,275,0.87,40,40,125
OceanDNA-b16778,122,12.2,0.0,8e-06,0.0064,148,188,79,119,53,160,0.87,40,40,107
OceanDNA-b488,1357,6.6,0.0,0.0004,0.51,231,268,386,424,355,428,0.87,37,38,73
OceanDNA-b19786,331,12.6,0.0,3e-06,0.0012,153,195,164,206,148,249,0.87,42,42,101
OceanDNA-b46722,1228,15.4,0.0,1.3e-06,0.00068,151,186,159,194,147,205,0.87,35,35,58
OceanDNA-b496,923,15.5,0.0,7.6e-07,0.00098,153,182,104,133,87,140,0.87,29,29,53
OceanDNA-b23019,3479,10.2,0.0,3.2e-05,0.061,195,244,296,342,288,353,0.87,49,46,65
OceanDNA-b28045,26,16.3,0.0,2.2e-07,0.00027,153,180,170,197,153,212,0.87,27,27,59
OceanDNA-b40018,534,21.3,0.0,6.6e-09,3.6e-06,153,180,138,165,118,205,0.87,27,27,87
OceanDNA-b29503,1498,5.2,0.0,0.0011,2.2,154,181,68,95,58,129,0.87,27,27,71
OceanDNA-b23260,70,10.5,0.0,1.3e-05,0.0094,195,257,206,267,128,271,0.87,62,61,143
OceanDNA-b45663,108,22.1,0.0,7.7e-09,3.4e-06,152,187,167,203,149,207,0.87,35,36,58
OceanDNA-b22220,1345,15.9,0.1,5.9e-07,0.0005,139,190,12,64,10,71,0.87,51,52,61
OceanDNA-b32757,170,0.7,0.0,0.013,6.1,197,219,293,315,285,343,0.87,22,22,58
OceanDNA-b24680,406,12.0,0.1,4.6e-06,0.0039,77,118,45,88,38,96,0.87,41,43,58
OceanDNA-b26126,494,5.5,0.0,0.00042,0.28,151,185,74,108,58,116,0.87,34,34,58
OceanDNA-b13541,1191,16.6,0.0,1.8e-07,0.00025,152,184,218,250,195,257,0.87,32,32,62
OceanDNA-b15711,143,19.6,0.0,4.5e-08,2.6e-05,122,198,82,151,51,161,0.87,76,69,110
OceanDNA-b17591,1464,16.6,0.0,1.8e-07,0.00028,139,191,175,227,161,240,0.87,52,52,79
OceanDNA-b32136,343,12.0,0.3,4.4e-06,0.0091,150,182,55,87,47,105,0.87,32,32,58
OceanDNA-b27542,1349,15.5,0.2,1.1e-06,0.00082,195,266,198,267,191,269,0.87,71,69,78
OceanDNA-b23089,3322,14.5,0.0,1.6e-06,0.0031,140,182,310,352,303,369,0.87,42,42,66
OceanDNA-b34653,194,13.0,0.0,2.2e-06,0.0017,196,258,570,632,556,640,0.87,62,62,84
OceanDNA-b23524,1143,19.1,0.0,9.3e-08,4.4e-05,140,180,127,169,116,185,0.87,40,42,69
OceanDNA-b34938,785,14.0,0.0,2.2e-06,0.0014,198,263,629,696,617,699,0.87,65,67,82
OceanDNA-b46648,1274,11.0,0.0,1.8e-05,0.021,139,193,358,410,349,429,0.87,54,52,80
OceanDNA-b41214,2347,1.6,0.0,0.0065,25.0,149,183,81,115,53,142,0.87,34,34,89
OceanDNA-b13203,166,5.5,0.0,0.00043,0.44,161,188,112,139,53,156,0.87,27,27,103
OceanDNA-b22178,122,0.5,0.0,0.014,4.9,82,103,262,283,256,289,0.87,21,21,33
OceanDNA-b45647,130,13.5,0.0,1.6e-06,0.001,194,261,175,239,171,243,0.87,67,64,72
OceanDNA-b23634,108,8.2,0.0,0.00019,0.16,196,236,260,299,253,321,0.87,40,39,68
OceanDNA-b17212,2925,8.5,0.2,0.00011,0.22,157,175,18,36,6,42,0.87,18,18,36
OceanDNA-b231,9,29.7,0.0,1.9e-11,1.7e-08,153,245,120,213,91,222,0.87,92,93,131
OceanDNA-b9726,71,10.8,0.0,1.1e-05,0.0049,159,182,86,109,23,142,0.87,23,23,119
OceanDNA-b30215,1298,16.3,0.0,4.4e-07,0.0004,154,179,172,197,156,220,0.87,25,25,64
OceanDNA-b5007,104,110.8,0.0,3.6e-36,9.9e-34,53,280,32,269,20,283,0.87,227,237,263
OceanDNA-b6298,319,15.2,0.0,9.5e-07,0.0002,144,185,73,114,59,127,0.87,41,41,68
OceanDNA-b6838,638,11.6,0.0,6.1e-06,0.0046,144,188,78,122,55,133,0.87,44,44,78
OceanDNA-b23017,1958,15.1,0.0,5.1e-07,0.0025,151,182,205,236,180,280,0.87,31,31,100
OceanDNA-b28240,1776,14.6,0.3,7e-07,0.0018,128,184,211,268,204,273,0.87,56,57,69
OceanDNA-b22322,2331,18.8,0.0,1.1e-07,0.00014,132,186,221,276,215,285,0.87,54,55,70
OceanDNA-b32974,2789,5.3,0.0,0.001,1.5,196,218,246,268,234,291,0.87,22,22,57
OceanDNA-b30459,1839,8.1,0.1,7.1e-05,0.18,159,187,176,204,159,214,0.87,28,28,55
OceanDNA-b47092,283,6.6,0.0,0.00039,0.37,196,235,210,249,186,265,0.87,39,39,79
OceanDNA-b15853,401,8.1,0.0,0.00021,0.13,139,186,509,556,473,573,0.87,47,47,100
OceanDNA-b46638,531,11.8,0.0,1e-05,0.0081,153,187,53,87,49,105,0.87,34,34,56
OceanDNA-b15453,1057,10.7,0.0,3.3e-05,0.024,150,193,172,215,156,225,0.87,43,43,69
OceanDNA-a5075,29,17.8,0.0,7.6e-08,2.9e-05,153,195,273,316,260,336,0.87,42,43,76
OceanDNA-b4339,186,40.2,0.0,1.2e-14,3.1e-12,152,243,143,236,115,245,0.87,91,93,130
OceanDNA-b10094,20,136.6,0.1,5e-44,2.4e-41,48,276,33,268,8,283,0.87,228,235,275
OceanDNA-b25306,13,11.5,0.0,6.5e-06,0.0014,154,184,88,118,76,127,0.86,30,30,51
OceanDNA-b28232,217,16.0,0.0,2.8e-07,0.0007,154,176,139,161,122,176,0.86,22,22,54
OceanDNA-b35250,67,3.5,0.0,0.0017,1.1,155,186,507,539,491,551,0.86,31,32,60
OceanDNA-b24140,199,4.8,0.0,0.0007,0.51,192,215,199,222,178,232,0.86,23,23,54
OceanDNA-b27523,377,12.6,0.0,5.8e-06,0.0038,154,178,205,229,187,244,0.86,24,24,57
OceanDNA-b22760,2709,14.9,0.1,6.1e-07,0.0022,139,189,236,286,231,294,0.86,50,50,63
OceanDNA-b33288,2766,14.2,0.0,1.9e-06,0.0027,157,185,384,412,365,429,0.86,28,28,64
OceanDNA-b22858,2614,13.1,0.0,4e-06,0.0069,138,192,230,278,222,305,0.86,54,48,83
OceanDNA-b22858,1665,10.1,0.0,3.4e-05,0.058,148,193,242,287,231,292,0.86,45,45,61
OceanDNA-b6846,218,19.0,0.0,3.3e-08,2e-05,187,263,269,340,252,340,0.86,76,71,88
OceanDNA-b27612,1540,12.9,0.0,2.4e-06,0.0058,154,176,153,175,135,194,0.86,22,22,59
OceanDNA-b28146,1182,9.2,0.1,3.2e-05,0.06,200,266,174,238,164,240,0.86,66,64,76
OceanDNA-b39367,257,18.1,0.0,6.3e-08,4.7e-05,154,181,148,175,129,190,0.86,27,27,61
OceanDNA-b31567,1370,10.0,0.1,3.7e-05,0.031,161,186,163,189,158,196,0.86,25,26,38
OceanDNA-b38907,339,13.0,0.2,2.3e-06,0.0022,83,142,570,630,562,668,0.86,59,60,106
OceanDNA-b15512,531,10.3,0.0,1.5e-05,0.019,149,193,148,192,118,202,0.86,44,44,84
OceanDNA-b30373,1656,15.2,0.1,4.8e-07,0.0012,154,177,169,192,163,220,0.86,23,23,57
OceanDNA-b16210,288,14.6,0.0,1.4e-06,0.0008,139,185,81,129,74,137,0.86,46,48,63
OceanDNA-b30206,2000,12.5,0.1,6.5e-06,0.0074,198,265,213,278,206,282,0.86,67,65,76
OceanDNA-b23984,818,13.0,0.1,4.4e-06,0.0038,102,154,49,102,12,108,0.86,52,53,96
OceanDNA-b31573,692,12.6,0.0,5.9e-06,0.0054,154,180,161,187,145,202,0.86,26,26,57
OceanDNA-b31510,971,3.3,0.0,0.0041,2.3,155,189,493,528,482,539,0.86,34,35,57
OceanDNA-b1825,2392,-2.3,0.0,0.2,360.0,253,279,721,747,714,752,0.86,26,26,38
OceanDNA-b1825,1867,12.1,0.0,8.4e-06,0.015,121,188,443,509,404,524,0.86,67,66,120
OceanDNA-b16187,169,1.1,0.0,0.0096,8.8,195,230,418,453,397,468,0.86,35,35,71
OceanDNA-b46704,1023,12.4,0.1,6.7e-06,0.0065,152,186,294,328,279,335,0.86,34,34,56
OceanDNA-b41651,61,10.3,0.0,1.4e-05,0.0033,152,187,88,123,73,128,0.86,35,35,55
OceanDNA-b20982,1046,8.0,0.0,7.6e-05,0.23,176,212,233,269,226,285,0.86,36,36,59
OceanDNA-b36083,798,10.7,0.0,2.3e-05,0.022,157,185,220,248,214,256,0.86,28,28,42
OceanDNA-b40523,459,15.6,0.0,3.6e-07,0.00037,158,184,151,177,131,192,0.86,26,26,61
OceanDNA-b31519,410,2.5,0.0,0.0035,2.3,155,189,503,538,485,545,0.86,34,35,60
OceanDNA-b11418,498,4.1,0.0,0.0011,0.63,161,185,108,132,78,145,0.86,24,24,67
OceanDNA-b15831,1481,12.2,0.0,3.9e-06,0.0068,151,187,168,204,158,212,0.86,36,36,54
OceanDNA-b22840,3847,11.6,0.0,1.8e-05,0.025,149,189,235,275,222,285,0.86,40,40,63
OceanDNA-b16123,12,10.0,0.0,3.8e-05,0.014,153,185,141,173,121,185,0.86,32,32,64
OceanDNA-b23525,1023,9.4,0.0,2.7e-05,0.054,197,268,200,269,190,276,0.86,71,69,86
OceanDNA-b46594,693,12.4,0.0,3.5e-06,0.0053,152,188,217,253,213,272,0.86,36,36,59
OceanDNA-b16227,471,-0.4,0.0,0.08,28.0,89,120,300,331,288,338,0.86,31,31,50
OceanDNA-b39489,22,9.0,0.0,3.8e-05,0.026,198,264,657,725,643,728,0.86,66,68,85
OceanDNA-b10365,327,14.9,0.0,1.2e-06,0.00041,159,235,147,225,134,232,0.86,76,78,98
OceanDNA-b22830,3137,13.9,0.0,2.5e-06,0.0057,146,184,233,271,219,280,0.86,38,38,61
OceanDNA-b16127,236,4.6,0.0,0.0016,0.5,77,120,31,75,28,81,0.86,43,44,53
OceanDNA-b30045,558,18.8,0.0,3.8e-08,9.8e-05,140,176,154,192,150,204,0.86,36,38,54
OceanDNA-b27563,76,7.1,0.1,0.00014,0.21,156,180,55,79,40,117,0.86,24,24,77
OceanDNA-b44440,1094,10.0,0.0,3.7e-05,0.045,198,264,633,701,627,704,0.86,66,68,77
OceanDNA-b6424,505,12.1,0.0,1.3e-05,0.0026,157,184,71,98,55,118,0.86,27,27,63
OceanDNA-b20370,55,10.7,0.0,1.1e-05,0.0042,154,196,603,649,597,655,0.86,42,46,58
OceanDNA-b45823,1426,13.5,0.0,3.2e-06,0.0028,153,186,135,168,115,212,0.86,33,33,97
OceanDNA-b30408,365,11.2,0.0,7.8e-06,0.018,166,230,283,349,272,372,0.86,64,66,100
OceanDNA-b23463,1474,11.9,0.0,5e-06,0.0097,159,185,40,66,30,73,0.86,26,26,43
OceanDNA-b202,248,5.2,0.0,0.0016,1.2,158,177,81,100,63,113,0.86,19,19,50
OceanDNA-b22117,2422,18.0,0.0,6.7e-08,0.00018,136,203,174,235,166,253,0.86,67,61,87
OceanDNA-b20413,301,1.4,0.0,0.0075,2.3,160,177,147,164,130,179,0.86,17,17,49
OceanDNA-b24003,129,17.2,0.0,2.3e-07,0.00017,140,182,123,167,119,182,0.86,42,44,63
OceanDNA-b22965,2749,-0.7,0.0,0.097,140.0,162,181,47,66,42,84,0.86,19,19,42
OceanDNA-b20510,60,15.4,0.0,4.3e-07,0.00014,125,191,211,279,206,337,0.86,66,68,131
OceanDNA-b23517,47,7.6,0.0,9.7e-05,0.14,195,237,263,304,256,330,0.86,42,41,74
OceanDNA-b46852,1158,13.7,0.0,4.1e-06,0.0017,153,185,143,175,129,192,0.86,32,32,63
OceanDNA-b22876,3254,9.1,0.0,6.7e-05,0.12,202,264,251,312,244,315,0.86,62,61,71
OceanDNA-b30085,1262,11.8,0.0,1.6e-05,0.012,159,183,120,144,103,155,0.86,24,24,52
OceanDNA-b47035,354,12.3,0.0,1.1e-05,0.0024,153,186,164,197,152,213,0.86,33,33,61
OceanDNA-b26926,1267,27.2,0.2,1.1e-10,3.1e-07,86,181,129,231,51,236,0.86,95,102,185
OceanDNA-b202,248,3.6,0.1,0.005,3.7,197,229,202,234,197,241,0.86,32,32,44
OceanDNA-b9797,260,3.5,0.0,0.0018,0.9,146,189,123,166,110,179,0.86,43,43,69
OceanDNA-b1424,451,8.5,0.1,0.00011,0.042,147,188,81,122,72,138,0.86,41,41,66
OceanDNA-b13830,55,10.6,0.0,2.4e-05,0.003,131,185,204,252,200,260,0.86,54,48,60
OceanDNA-b26750,148,9.8,0.0,2.1e-05,0.013,181,215,236,271,219,285,0.86,34,35,66
OceanDNA-b21040,1032,17.1,0.0,3.7e-07,0.00058,146,197,395,447,385,453,0.86,51,52,68
OceanDNA-b39325,137,37.2,0.0,9.5e-14,2.6e-11,153,251,160,262,148,270,0.86,98,102,122
OceanDNA-b42,3294,4.1,0.0,0.0012,6.5,151,189,367,405,319,414,0.86,38,38,95
OceanDNA-b30011,1745,11.7,0.0,5.6e-06,0.011,87,153,203,268,196,284,0.86,66,65,88
OceanDNA-b27570,926,17.2,0.0,1.2e-07,0.00032,154,179,150,175,133,189,0.86,25,25,56
OceanDNA-b16133,1080,12.6,0.0,8.9e-06,0.0033,158,180,156,178,138,199,0.86,22,22,61
OceanDNA-b36733,877,6.7,0.0,0.00038,0.38,153,184,168,199,154,217,0.86,31,31,63
OceanDNA-b22833,1824,17.2,0.0,1.2e-07,0.00049,151,182,254,285,224,299,0.86,31,31,75
OceanDNA-b40552,42,24.0,0.0,9.7e-10,4.3e-07,139,185,123,171,115,185,0.86,46,48,70
OceanDNA-b45445,755,14.6,0.0,7.5e-07,0.0013,154,184,130,160,115,206,0.86,30,30,91
OceanDNA-b37750,321,26.5,0.0,1.8e-10,1.4e-07,140,184,134,181,128,213,0.86,44,47,85
OceanDNA-b42068,240,14.7,0.0,6.7e-07,0.0002,153,216,145,210,131,252,0.86,63,65,121
OceanDNA-b15453,1319,16.7,0.1,5.1e-07,0.00037,88,179,293,381,239,423,0.86,91,88,184
OceanDNA-b1345,2514,5.4,0.0,0.00045,1.2,155,180,97,122,77,129,0.86,25,25,52
OceanDNA-b10017,7,0.8,0.0,0.012,8.7,192,214,210,232,206,257,0.86,22,22,51
OceanDNA-b5857,282,10.4,0.0,1.4e-05,0.0059,187,220,271,304,264,311,0.86,33,33,47
OceanDNA-b30082,62,10.6,0.1,2.4e-05,0.021,161,184,103,126,92,134,0.86,23,23,42
OceanDNA-b30408,365,4.1,0.0,0.0011,2.6,154,187,188,221,178,232,0.86,33,33,54
OceanDNA-b3982,579,19.4,0.0,7.5e-08,1.5e-05,143,184,136,177,115,187,0.86,41,41,72
OceanDNA-b23049,1569,11.6,0.0,5.9e-06,0.013,196,261,194,255,188,258,0.86,65,61,70
OceanDNA-b23458,1638,3.4,0.0,0.0018,5.1,105,119,189,203,180,211,0.86,14,14,31
OceanDNA-b19767,37,4.2,0.0,0.0011,0.34,85,120,35,70,27,86,0.86,35,35,59
OceanDNA-b29509,2319,4.9,0.0,0.0013,3.0,195,218,264,287,257,304,0.86,23,23,47
OceanDNA-b22385,2068,11.6,0.0,1.2e-05,0.022,147,193,177,223,167,227,0.86,46,46,60
OceanDNA-b26660,3743,10.6,0.0,1.2e-05,0.047,153,220,171,241,152,249,0.86,67,70,97
OceanDNA-b31152,642,15.1,0.0,1e-06,0.00043,150,196,243,290,237,294,0.86,46,47,57
OceanDNA-b30022,2137,18.0,0.0,6.6e-08,0.00022,154,178,170,194,152,209,0.86,24,24,57
OceanDNA-b40777,1138,207.8,0.0,2.1e-65,1.2e-62,48,275,36,278,10,292,0.86,227,242,282
OceanDNA-b36670,896,8.7,0.1,4.4e-05,0.061,153,183,147,177,20,235,0.86,30,30,215
OceanDNA-b3323,131,15.8,0.2,6.1e-07,0.001,136,181,135,180,98,183,0.86,45,45,85
OceanDNA-b7470,187,20.8,0.0,9.4e-09,5.2e-06,134,185,100,150,87,165,0.86,51,50,78
OceanDNA-b23103,4082,17.4,0.0,1.1e-07,0.00052,149,197,92,141,83,145,0.86,48,49,62
OceanDNA-b22548,1091,10.3,0.0,4.4e-05,0.019,150,189,216,255,203,265,0.86,39,39,62
OceanDNA-b22548,1091,-1.5,0.0,0.17,74.0,105,122,155,172,132,174,0.86,17,17,42
OceanDNA-b22548,674,12.6,0.0,8.7e-06,0.0037,109,185,518,593,509,656,0.86,76,75,147
OceanDNA-b17430,13,11.3,0.0,7.1e-06,0.015,155,176,116,137,98,144,0.86,21,21,46
OceanDNA-b30676,105,11.0,0.1,9e-06,0.015,192,265,200,271,189,278,0.86,73,71,89
OceanDNA-b23401,359,18.2,0.1,6e-08,0.00013,147,187,550,592,539,596,0.86,40,42,57
OceanDNA-b23974,166,1.8,0.1,0.0059,7.5,157,179,15,37,9,49,0.86,22,22,40
OceanDNA-b6820,3,2.8,0.0,0.0028,1.4,195,220,214,239,207,272,0.86,25,25,65
OceanDNA-b12722,62,11.0,0.0,9.3e-06,0.0021,192,243,209,256,201,270,0.86,51,47,69
OceanDNA-b40493,544,18.3,0.0,5.2e-08,4.6e-05,155,184,145,174,129,189,0.86,29,29,60
OceanDNA-b3934,51,1.5,0.0,0.014,4.9,253,282,362,391,354,403,0.86,29,29,49
OceanDNA-b5721,663,10.0,0.0,1.9e-05,0.019,187,216,291,320,285,331,0.86,29,29,46
OceanDNA-b4111,10,14.9,0.0,5.8e-07,0.00038,134,196,103,166,94,170,0.86,62,63,76
OceanDNA-b22348,719,11.2,0.0,1.6e-05,0.0092,152,182,131,161,118,168,0.86,30,30,50
OceanDNA-b440,696,5.5,0.0,0.00088,1.1,162,189,156,185,147,195,0.86,27,29,48
OceanDNA-b22895,1221,10.1,0.0,3.3e-05,0.026,127,186,194,253,189,267,0.86,59,59,78
OceanDNA-b11730,547,10.0,0.0,1.8e-05,0.013,186,217,321,352,309,364,0.86,31,31,55
OceanDNA-b40262,146,-2.1,0.0,0.087,43.0,195,213,277,295,274,315,0.86,18,18,41
OceanDNA-b32108,317,17.0,0.0,2.8e-07,0.00036,155,185,141,171,124,179,0.86,30,30,55
OceanDNA-b23344,1819,12.6,0.1,2.9e-06,0.0055,160,182,100,122,87,129,0.86,22,22,42
OceanDNA-b23907,1575,5.3,0.1,0.001,0.99,160,181,134,155,125,166,0.86,21,21,41
OceanDNA-b23907,61,-2.3,0.0,0.2,200.0,155,180,542,567,531,573,0.86,25,25,42
OceanDNA-b16135,34,15.0,0.0,1.1e-06,0.0005,154,180,146,172,129,195,0.86,26,26,66
OceanDNA-b34471,261,12.3,0.0,3.6e-06,0.0032,198,268,664,737,646,739,0.86,70,73,93
OceanDNA-b36646,1282,0.4,0.0,0.016,32.0,196,218,247,269,224,277,0.86,22,22,53
OceanDNA-b19686,210,11.3,0.0,1.5e-05,0.0034,151,196,597,646,590,652,0.86,45,49,62
OceanDNA-b31464,1668,6.5,0.0,0.00021,0.41,199,265,195,259,184,273,0.86,66,64,89
OceanDNA-b12901,218,10.6,0.0,1.2e-05,0.0063,162,247,269,354,263,367,0.86,85,85,104
OceanDNA-b22397,2422,15.6,0.0,1.4e-06,0.00095,152,179,245,272,234,279,0.86,27,27,45
OceanDNA-b22092,161,10.1,0.0,1.7e-05,0.021,158,191,337,370,311,387,0.86,33,33,76
OceanDNA-b34263,107,9.2,0.0,6.5e-05,0.021,148,188,508,549,465,565,0.86,40,41,100
OceanDNA-b46617,448,10.8,0.0,1e-05,0.018,147,194,172,219,161,226,0.86,47,47,65
OceanDNA-b22849,1949,12.3,0.0,1.1e-05,0.0073,153,186,171,204,101,209,0.86,33,33,108
OceanDNA-b32730,416,10.0,0.0,3.8e-05,0.0098,134,184,222,266,180,276,0.86,50,44,96
OceanDNA-b38157,624,13.7,0.2,4e-06,0.00094,42,76,48,82,21,90,0.86,34,34,69
OceanDNA-b30459,1839,7.2,0.1,0.00013,0.33,166,230,266,332,240,350,0.86,64,66,110
OceanDNA-b13147,274,15.3,0.0,4.4e-07,0.00017,140,181,129,170,123,184,0.86,41,41,61
OceanDNA-b22306,1201,13.0,0.1,4.5e-06,0.0037,149,190,244,285,235,297,0.86,41,41,62
OceanDNA-b29510,1279,0.3,0.0,0.05,42.0,192,245,293,343,274,350,0.86,53,50,76
OceanDNA-b34918,458,18.5,0.0,1.5e-07,5.1e-05,139,178,169,209,164,223,0.86,39,40,59
OceanDNA-b20657,47,52.5,0.2,4e-18,6.1e-16,54,190,64,207,60,213,0.86,136,143,153
OceanDNA-b39796,352,18.5,0.0,4.7e-08,3.3e-05,154,180,142,168,123,188,0.86,26,26,65
OceanDNA-b23356,1225,11.7,0.0,5.6e-06,0.01,161,184,171,194,159,210,0.86,23,23,51
OceanDNA-b46728,421,12.5,0.1,1.3e-05,0.0053,152,186,273,307,258,314,0.86,34,34,56
OceanDNA-b33394,1170,15.8,0.0,6.4e-07,0.00085,155,183,68,96,62,106,0.86,28,28,44
OceanDNA-b46581,1256,10.4,0.0,2.8e-05,0.023,152,194,176,218,163,228,0.86,42,42,65
OceanDNA-b6295,91,10.0,0.0,3.6e-05,0.0088,153,199,134,181,120,214,0.86,46,47,94
OceanDNA-b60,1272,2.4,0.0,0.0037,4.7,231,266,235,271,171,276,0.86,35,36,105
OceanDNA-b46919,1190,12.1,0.0,4.1e-06,0.0065,137,185,205,254,198,259,0.86,48,49,61
OceanDNA-b45275,81,9.1,0.0,6.9e-05,0.011,137,197,228,283,220,300,0.86,60,55,80
OceanDNA-b29592,1803,13.6,0.0,1.5e-06,0.0036,153,174,531,552,514,580,0.86,21,21,66
OceanDNA-b20915,804,11.6,0.0,5.9e-06,0.0049,157,179,113,135,99,146,0.86,22,22,47
OceanDNA-b10018,226,11.0,0.0,8.9e-06,0.0063,172,224,150,204,134,231,0.86,52,54,97
OceanDNA-b22801,867,9.6,0.0,5e-05,0.063,149,189,289,329,274,339,0.86,40,40,65
OceanDNA-b46970,790,16.0,0.0,2.7e-07,0.00022,151,186,172,207,142,219,0.86,35,35,77
OceanDNA-b25279,160,12.5,0.0,3.2e-06,0.00067,161,186,96,121,88,129,0.86,25,25,41
OceanDNA-b1719,2754,13.3,0.0,3.7e-06,0.0055,156,182,106,132,87,140,0.86,26,26,53
OceanDNA-b6205,629,12.3,0.0,3.6e-06,0.0025,111,144,45,78,38,88,0.86,33,33,50
OceanDNA-b9009,46,16.2,0.0,4.9e-07,5.3e-05,150,188,146,185,135,192,0.86,38,39,57
OceanDNA-b38062,924,15.7,0.0,3.3e-07,0.00031,198,264,177,245,141,252,0.86,66,68,111
OceanDNA-b23468,540,15.6,0.0,7.1e-07,0.00097,155,182,139,166,127,177,0.86,27,27,50
OceanDNA-b17719,2192,9.3,0.0,3.1e-05,0.13,124,177,104,152,99,157,0.86,53,48,58
OceanDNA-b27445,13,16.1,0.0,2.6e-07,5.7e-05,151,197,216,263,190,274,0.86,46,47,84
OceanDNA-b26845,3023,14.1,0.1,2.1e-06,0.0032,154,179,148,173,129,185,0.86,25,25,56
OceanDNA-b46255,2822,11.0,0.2,2.7e-05,0.03,152,186,243,277,226,284,0.86,34,34,58
OceanDNA-b16140,391,8.4,0.0,0.00011,0.05,144,188,213,257,194,266,0.86,44,44,72
OceanDNA-b25111,205,13.2,0.1,1.9e-06,0.0021,160,187,116,143,104,161,0.86,27,27,57
OceanDNA-b41695,55,15.8,0.0,6.3e-07,5.8e-05,142,189,90,139,66,168,0.86,47,49,102
OceanDNA-b30493,1068,4.3,0.0,0.00099,1.4,160,188,151,179,105,196,0.86,28,28,91
OceanDNA-b30786,1244,13.1,0.0,2e-06,0.0027,148,195,167,214,155,224,0.86,47,47,69
OceanDNA-b35796,702,9.4,0.0,2.8e-05,0.029,144,184,127,167,118,182,0.86,40,40,64
OceanDNA-b40594,236,149.5,0.1,5.9e-48,2.2e-45,70,283,79,308,15,314,0.86,213,229,299
OceanDNA-b46255,2575,14.8,0.0,2e-06,0.0022,150,188,143,182,127,189,0.86,38,39,62
OceanDNA-b31575,576,8.0,0.0,0.00015,0.13,198,265,215,280,207,287,0.86,67,65,80
OceanDNA-b46908,1333,10.8,0.0,1e-05,0.036,155,190,390,426,375,435,0.86,35,36,60
OceanDNA-b23367,1849,20.4,0.0,2.5e-08,2.5e-05,146,180,118,155,113,161,0.86,34,37,48
OceanDNA-b28166,2674,3.4,0.0,0.0019,5.1,160,186,140,166,115,175,0.86,26,26,60
OceanDNA-b45382,4338,10.5,0.0,1.3e-05,0.062,157,193,237,273,212,281,0.86,36,36,69
OceanDNA-b16222,285,5.8,0.0,0.00034,0.57,154,185,174,205,166,220,0.86,31,31,54
OceanDNA-b22805,5940,13.9,0.0,3.6e-06,0.0081,153,188,181,217,169,227,0.86,35,36,58
OceanDNA-b24169,608,-1.9,0.0,0.079,80.0,188,211,205,228,192,232,0.86,23,23,40
OceanDNA-b26869,83,7.1,0.0,0.00014,0.45,152,186,212,246,181,254,0.86,34,34,73
OceanDNA-b512,417,8.7,0.0,9.2e-05,0.077,161,184,94,117,81,150,0.86,23,23,69
OceanDNA-b24941,2495,10.2,0.0,3.1e-05,0.044,153,185,133,165,117,182,0.86,32,32,65
OceanDNA-b22722,737,13.2,0.0,1.9e-06,0.0021,154,185,148,179,133,224,0.86,31,31,91
OceanDNA-b23655,703,12.3,0.0,7.1e-06,0.0066,155,181,155,181,135,194,0.86,26,26,59
OceanDNA-b46952,658,11.6,0.0,5.9e-06,0.0048,152,186,107,141,92,148,0.86,34,34,56
OceanDNA-b34301,471,16.2,0.0,2.4e-07,0.00017,197,265,334,404,300,406,0.86,68,70,106
OceanDNA-b3434,756,10.2,0.0,1.6e-05,0.024,149,188,116,155,104,162,0.85,39,39,58
OceanDNA-b36740,366,2.6,0.0,0.0032,1.8,197,238,265,305,257,309,0.85,41,40,52
OceanDNA-b15938,254,11.2,0.0,8.2e-06,0.0024,157,181,100,124,66,133,0.85,24,24,67
OceanDNA-b22650,1489,6.1,0.1,0.00058,0.69,153,178,22,47,7,55,0.85,25,25,48
OceanDNA-b20820,150,16.2,0.0,4.7e-07,0.00013,153,192,239,278,208,286,0.85,39,39,78
OceanDNA-b40457,1543,10.6,0.1,1.2e-05,0.019,199,252,283,332,278,341,0.85,53,49,63
OceanDNA-b23643,1966,-2.3,0.0,0.21,260.0,197,209,198,210,191,211,0.85,12,12,20
OceanDNA-b16121,452,10.8,0.0,1e-05,0.0079,147,181,340,374,321,387,0.85,34,34,66
OceanDNA-b24941,2495,4.2,0.0,0.0021,3.0,197,229,262,293,257,306,0.85,32,31,49
OceanDNA-b23292,1686,11.4,0.1,7e-06,0.014,145,181,70,109,53,121,0.85,36,39,68
OceanDNA-b31521,15,13.0,0.0,4.4e-06,0.0045,197,264,673,742,648,743,0.85,67,69,95
OceanDNA-b2828,2148,7.1,0.1,0.00043,0.51,79,116,19,57,12,69,0.85,37,38,57
OceanDNA-b36649,521,25.3,0.0,4e-10,3.3e-07,153,190,260,298,246,369,0.85,37,38,123
OceanDNA-b10027,423,14.2,0.0,9.4e-07,0.00051,197,266,190,257,183,265,0.85,69,67,82
OceanDNA-b37076,208,6.4,0.0,0.00023,0.26,89,121,150,182,135,187,0.85,32,32,52
OceanDNA-b15470,77,11.9,0.0,4.9e-06,0.0044,148,193,161,206,142,221,0.85,45,45,79
OceanDNA-b34663,386,14.4,0.0,1.7e-06,0.00071,196,247,566,617,559,635,0.85,51,51,76
OceanDNA-b11858,507,10.3,0.0,1.5e-05,0.019,188,218,341,371,328,380,0.85,30,30,52
OceanDNA-b26071,297,13.2,0.0,1.9e-06,0.00061,157,180,150,173,130,195,0.85,23,23,65
OceanDNA-b22876,1950,-1.0,0.0,0.082,150.0,100,121,95,116,90,128,0.85,21,21,38
OceanDNA-b31541,2238,12.0,0.2,4.5e-06,0.01,163,233,46,114,29,118,0.85,70,68,89
OceanDNA-b20676,16,112.9,0.0,1.6e-36,2.8e-34,53,282,19,257,14,268,0.85,229,238,254
OceanDNA-b30136,297,18.2,0.0,5.7e-08,0.00012,153,179,167,193,151,207,0.85,26,26,56
OceanDNA-b20511,29,12.2,0.0,3.8e-06,0.0011,124,190,208,276,204,301,0.85,66,68,97
OceanDNA-b22382,1222,10.9,0.0,2.8e-05,0.037,156,181,136,161,88,174,0.85,25,25,86
OceanDNA-b27556,2014,2.2,0.0,0.0088,9.5,157,181,68,92,57,103,0.85,24,24,46
OceanDNA-b9687,373,15.9,0.0,5.9e-07,0.00026,193,267,194,266,187,291,0.85,74,72,104
OceanDNA-b27590,926,17.7,0.0,8.5e-08,0.0002,154,185,173,204,157,237,0.85,31,31,80
OceanDNA-b30042,2509,12.9,0.1,7.4e-06,0.0085,149,185,118,154,110,162,0.85,36,36,52
OceanDNA-b9009,59,9.1,0.0,6.7e-05,0.0074,197,264,614,683,593,689,0.85,67,69,96
OceanDNA-b34938,31,14.0,0.0,2.2e-06,0.0013,159,185,166,192,139,201,0.85,26,26,62
OceanDNA-b20908,8483,1.5,0.0,0.0069,68.0,253,285,283,315,268,320,0.85,32,32,52
OceanDNA-b26049,90,14.6,0.0,7.1e-07,0.00021,155,180,8,33,3,58,0.85,25,25,55
OceanDNA-b30001,346,4.9,0.0,0.0013,1.1,194,244,279,330,260,334,0.85,50,51,74
OceanDNA-b10019,206,4.7,0.0,0.00076,0.39,153,189,535,571,517,582,0.85,36,36,65
OceanDNA-b16121,452,4.1,0.0,0.0011,0.86,89,122,262,295,247,309,0.85,33,33,62
OceanDNA-b32606,3261,7.8,0.0,8.6e-05,0.39,153,169,194,210,178,223,0.85,16,16,45
OceanDNA-b44368,64,12.5,0.1,3.1e-06,0.00069,152,186,170,205,106,217,0.85,34,35,111
OceanDNA-b41273,1153,12.4,0.1,6.9e-06,0.0066,102,166,36,101,15,112,0.85,64,65,97
OceanDNA-b2828,2148,2.3,0.0,0.012,14.0,160,178,99,117,79,128,0.85,18,18,49
OceanDNA-b7194,522,11.2,0.0,3.1e-05,0.0066,152,184,149,181,117,218,0.85,32,32,101
OceanDNA-b40947,36,122.3,0.0,2.4e-39,9.3e-37,67,266,69,282,50,296,0.85,199,213,246
OceanDNA-b37266,1047,9.7,0.0,2.3e-05,0.079,198,265,622,691,615,695,0.85,67,69,80
OceanDNA-b24946,2170,7.4,0.0,0.00012,0.28,154,185,139,170,127,195,0.85,31,31,68
OceanDNA-b39304,776,20.2,0.0,1.4e-08,1.7e-05,150,188,164,202,110,228,0.85,38,38,118
OceanDNA-b20976,3532,7.8,0.0,0.00017,0.53,153,180,125,152,111,172,0.85,27,27,61
OceanDNA-b41265,427,-0.5,0.0,0.029,39.0,161,179,40,58,32,98,0.85,18,18,66
OceanDNA-b22805,721,17.2,0.0,3.4e-07,0.00076,151,185,163,197,143,218,0.85,34,34,75
OceanDNA-b11392,106,0.5,0.0,0.015,7.5,191,217,203,229,198,243,0.85,26,26,45
OceanDNA-b46717,981,18.4,0.0,1e-07,0.00018,152,188,222,259,213,272,0.85,36,37,59
OceanDNA-b4608,21,18.8,0.0,7.4e-08,1.9e-05,194,269,185,260,178,290,0.85,75,75,112
OceanDNA-b39186,25,21.2,0.0,7e-09,3.8e-06,139,183,129,175,123,185,0.85,44,46,62
OceanDNA-b30046,1421,3.5,0.0,0.0035,5.2,152,184,176,208,165,220,0.85,32,32,55
OceanDNA-b32974,2789,4.7,0.0,0.0015,2.3,161,188,139,166,119,172,0.85,27,27,53
OceanDNA-b31195,338,11.1,0.0,8.6e-06,0.0053,180,260,193,270,136,276,0.85,80,77,140
OceanDNA-b23482,159,3.7,0.0,0.0015,2.4,192,231,273,312,260,335,0.85,39,39,75
OceanDNA-b20911,6129,11.9,0.3,4.9e-06,0.034,163,194,22,52,9,62,0.85,31,30,53
OceanDNA-b47053,235,14.0,0.0,1.1e-06,0.0007,158,198,103,143,70,149,0.85,40,40,79
OceanDNA-b22882,788,12.4,0.0,3.5e-06,0.015,139,189,223,267,214,277,0.85,50,44,63
OceanDNA-b394,393,20.1,0.0,1.6e-08,1.6e-05,129,190,182,238,106,262,0.85,61,56,156
OceanDNA-b24091,193,10.6,0.0,2.5e-05,0.012,150,184,217,251,205,272,0.85,34,34,67
OceanDNA-b46208,3,10.9,0.0,1.9e-05,0.0098,154,178,95,119,81,132,0.85,24,24,51
OceanDNA-b29543,472,10.5,0.0,1.3e-05,0.017,153,180,145,172,114,180,0.85,27,27,66
OceanDNA-b24611,64,13.6,0.1,1.4e-06,0.00061,135,188,124,171,114,231,0.85,53,47,117
OceanDNA-b35035,536,9.0,0.0,7.5e-05,0.029,198,267,607,674,597,677,0.85,69,67,80
OceanDNA-b46265,1268,13.0,0.1,4.4e-06,0.0039,153,186,239,272,224,279,0.85,33,33,55
OceanDNA-b20676,199,53.0,0.1,3e-18,5.1e-16,54,190,66,209,63,220,0.85,136,143,157
OceanDNA-b24625,397,14.3,0.0,9e-07,0.00047,154,185,139,170,121,179,0.85,31,31,58
OceanDNA-b4004,18,13.3,0.1,3.7e-06,0.0021,195,266,139,208,131,230,0.85,71,69,99
OceanDNA-b44609,332,6.5,0.0,0.00041,0.38,154,182,546,574,529,581,0.85,28,28,52
OceanDNA-b30854,1876,24.0,0.5,1.9e-09,2.2e-06,88,183,112,214,26,226,0.85,95,102,200
OceanDNA-b45275,46,10.2,0.0,3.2e-05,0.0049,137,202,218,278,207,283,0.85,65,60,76
OceanDNA-b24103,1975,12.5,0.1,6.3e-06,0.0083,160,185,85,110,53,118,0.85,25,25,65
OceanDNA-b23229,1345,13.4,0.0,3.4e-06,0.0024,150,180,116,146,104,146,0.85,30,30,42
OceanDNA-b27826,351,12.7,0.0,2.7e-06,0.0012,158,182,82,106,60,129,0.85,24,24,69
OceanDNA-b13836,229,4.4,0.0,0.00092,0.27,153,187,504,538,490,552,0.85,34,34,62
OceanDNA-b23364,1374,-2.7,0.0,0.26,310.0,61,76,97,112,90,118,0.85,15,15,28
OceanDNA-b44719,526,-0.9,0.0,0.039,23.0,189,214,197,222,186,244,0.85,25,25,58
OceanDNA-b35278,403,1.1,0.0,0.019,7.6,155,186,513,545,503,555,0.85,31,32,52
OceanDNA-b35076,477,11.4,0.0,1.4e-05,0.0052,198,266,183,249,164,253,0.85,68,66,89
OceanDNA-b8408,166,8.0,0.0,7.4e-05,0.015,198,264,601,669,596,671,0.85,66,68,75
OceanDNA-b23003,1276,16.2,0.0,1.2e-06,0.00057,153,189,285,322,266,374,0.85,36,37,108
OceanDNA-b4143,1413,14.1,0.0,3.1e-06,0.0017,195,266,193,262,182,285,0.85,71,69,103
OceanDNA-b9010,182,10.0,0.0,1.8e-05,0.0045,198,264,189,257,177,263,0.85,66,68,86
OceanDNA-b36657,158,11.3,0.0,7.4e-06,0.003,157,180,146,169,125,181,0.85,23,23,56
OceanDNA-b15333,114,7.2,0.0,0.00013,0.04,154,180,135,161,114,170,0.85,26,26,56
OceanDNA-b20148,305,1.2,0.0,0.0087,3.4,87,120,142,175,103,182,0.85,33,33,79
OceanDNA-b22507,1506,10.5,0.0,2.6e-05,0.038,144,189,263,308,255,317,0.85,45,45,62
OceanDNA-b29530,932,-1.1,0.0,0.043,140.0,197,218,236,257,222,268,0.85,21,21,46
OceanDNA-b440,2424,11.9,0.0,9.7e-06,0.012,149,185,113,150,63,156,0.85,36,37,93
OceanDNA-b34805,485,-3.3,0.1,0.21,120.0,85,110,369,394,365,399,0.85,25,25,34
OceanDNA-b46295,1974,10.3,0.0,2.9e-05,0.042,154,181,94,121,50,131,0.85,27,27,81
OceanDNA-b23261,218,12.5,0.0,6.4e-06,0.0075,161,199,125,167,99,176,0.85,38,42,77
OceanDNA-b515,1005,16.6,0.1,1.8e-07,0.00045,139,183,3,49,1,60,0.85,44,46,59
OceanDNA-b22487,2098,10.1,0.0,1.7e-05,0.041,149,193,25,69,12,75,0.85,44,44,63
OceanDNA-b46326,1026,18.8,0.2,7.7e-08,0.0001,151,186,286,321,276,325,0.85,35,35,49
OceanDNA-b12668,103,17.3,0.0,1.1e-07,5e-05,187,269,184,264,181,286,0.85,82,80,105
OceanDNA-b2854,2986,1.6,0.0,0.02,23.0,192,230,239,276,224,289,0.85,38,37,65
OceanDNA-b22656,602,1.3,0.0,0.0082,6.7,105,122,198,215,186,220,0.85,17,17,34
OceanDNA-b46675,479,10.8,0.1,1e-05,0.021,139,193,539,591,531,611,0.85,54,52,80
OceanDNA-b35148,1178,13.6,0.0,2.9e-06,0.003,140,180,121,162,115,173,0.85,40,41,58
OceanDNA-b40225,275,1.2,0.0,0.0091,3.6,88,117,97,125,90,142,0.85,29,28,52
OceanDNA-b46982,145,9.9,0.0,5.9e-05,0.013,147,194,174,221,161,229,0.85,47,47,68
OceanDNA-b13010,20,10.7,0.0,1.1e-05,0.0037,152,191,186,226,170,252,0.85,39,40,82
OceanDNA-b22893,2288,14.2,0.0,2.8e-06,0.0022,108,170,174,240,163,250,0.85,62,66,87
OceanDNA-b8082,149,15.4,0.0,4.2e-07,0.00012,137,186,114,161,106,171,0.85,49,47,65
OceanDNA-b14516,393,5.7,0.0,0.00037,0.21,154,182,85,113,81,127,0.85,28,28,46
OceanDNA-b23725,1,-1.7,0.0,0.21,150.0,194,230,251,287,245,290,0.85,36,36,45
OceanDNA-b23519,427,6.6,0.0,0.0002,0.3,193,268,199,272,191,293,0.85,75,73,102
OceanDNA-b24609,149,5.0,0.0,0.00062,0.43,149,180,165,196,150,223,0.85,31,31,73
OceanDNA-b38574,185,10.0,0.0,1.9e-05,0.013,146,189,108,151,21,158,0.85,43,43,137
OceanDNA-b22406,1775,20.5,0.0,5.7e-08,3.3e-05,154,215,170,233,158,264,0.85,61,63,106
OceanDNA-b21342,331,10.8,0.0,1e-05,0.0051,155,185,127,157,105,163,0.85,30,30,58
OceanDNA-b13084,750,-0.9,0.0,0.078,98.0,152,174,359,381,353,405,0.85,22,22,52
OceanDNA-b13084,1039,14.8,0.1,1.3e-06,0.0016,82,168,60,147,20,157,0.85,86,87,137
OceanDNA-b3982,297,10.4,0.0,4.1e-05,0.0082,161,196,107,146,23,154,0.85,35,39,131
OceanDNA-b22767,1464,15.0,0.0,1.1e-06,0.0015,142,188,144,190,137,208,0.85,46,46,71
OceanDNA-b22760,2709,0.2,0.0,0.017,61.0,105,122,186,203,175,207,0.85,17,17,32
OceanDNA-b30043,1162,7.4,0.0,0.00023,0.23,161,198,112,153,57,166,0.85,37,41,109
OceanDNA-b30025,2079,19.4,0.0,2.6e-08,6.3e-05,140,178,131,171,125,187,0.85,38,40,62
OceanDNA-b11624,517,12.7,0.0,2.8e-06,0.0029,186,220,294,328,282,333,0.85,34,34,51
OceanDNA-b45747,1546,19.4,0.0,2.5e-08,5.7e-05,150,188,156,195,139,226,0.85,38,39,87
OceanDNA-b46939,472,12.3,0.0,3.6e-06,0.0048,196,263,192,256,182,258,0.85,67,64,76
OceanDNA-b35286,34,17.5,0.0,9.6e-08,6.5e-05,139,181,128,171,121,189,0.85,42,43,68
OceanDNA-b31529,2007,14.9,0.0,5.7e-07,0.0012,136,189,186,238,175,254,0.85,53,52,79
OceanDNA-b1712,1930,5.7,0.1,0.00037,0.98,157,181,93,117,77,126,0.85,24,24,49
OceanDNA-b20043,325,15.1,0.0,1e-06,0.00017,151,197,172,222,165,233,0.85,46,50,68
OceanDNA-b12692,254,-0.5,0.0,0.029,17.0,198,218,213,233,207,244,0.85,20,20,37
OceanDNA-b9654,563,12.1,0.0,8.3e-06,0.0024,160,182,157,179,139,187,0.85,22,22,48
OceanDNA-b11706,669,11.3,0.0,7.1e-06,0.0066,186,217,217,248,205,257,0.85,31,31,52
OceanDNA-b32156,2476,14.1,0.0,2.1e-06,0.0029,154,180,152,178,134,191,0.85,26,26,57
OceanDNA-b16198,1641,13.3,0.0,1.8e-06,0.0031,131,177,25,71,9,78,0.85,46,46,69
OceanDNA-b22656,602,13.7,0.0,1.4e-06,0.0011,145,189,254,298,242,305,0.85,44,44,63
OceanDNA-b22995,1823,11.8,0.0,2.5e-05,0.011,144,194,296,344,283,362,0.85,50,48,79
OceanDNA-b22995,150,10.7,0.1,5.7e-05,0.024,153,184,180,211,165,219,0.85,31,31,54
OceanDNA-b15134,177,18.3,0.0,5.3e-08,1.6e-05,152,195,240,284,228,309,0.85,43,44,81
OceanDNA-b13590,1708,3.4,0.0,0.0075,5.5,200,237,227,263,220,271,0.85,37,36,51
OceanDNA-b4488,2233,10.3,0.1,3e-05,0.04,152,185,259,292,249,306,0.85,33,33,57
OceanDNA-b4488,407,10.6,0.1,2.4e-05,0.033,156,191,93,129,76,136,0.85,35,36,60
OceanDNA-b36675,330,2.9,0.0,0.0026,3.1,154,184,517,548,455,555,0.85,30,31,100
OceanDNA-b40681,438,19.0,0.0,3.3e-08,1.7e-05,153,181,142,170,124,184,0.85,28,28,60
OceanDNA-b22478,1038,13.2,0.0,5.9e-06,0.0046,140,196,132,182,122,188,0.85,56,50,66
OceanDNA-b38915,32,13.4,0.0,1.7e-06,0.00089,147,186,106,145,87,173,0.85,39,39,86
OceanDNA-b8547,29,7.6,0.1,0.0001,0.022,198,264,601,669,596,671,0.85,66,68,75
OceanDNA-b22859,218,13.4,0.0,1.7e-06,0.0047,146,184,241,279,229,286,0.85,38,38,57
OceanDNA-b23312,2294,13.2,0.1,2e-06,0.0055,147,216,136,208,90,219,0.85,69,72,129
OceanDNA-b31229,288,14.7,0.0,1.4e-06,0.001,153,180,140,167,124,180,0.85,27,27,56
OceanDNA-b24705,1141,15.3,0.0,4.4e-07,0.00099,153,213,213,275,184,291,0.85,60,62,107
OceanDNA-b1657,50,14.8,0.0,1.2e-06,0.00051,126,190,89,149,55,213,0.85,64,60,158
OceanDNA-b22396,1374,14.3,0.0,8.8e-07,0.0024,148,193,213,258,200,263,0.85,45,45,63
OceanDNA-b46887,583,11.7,0.0,1.1e-05,0.0039,131,177,133,179,112,214,0.85,46,46,102
OceanDNA-b22817,460,10.3,0.0,3e-05,0.063,150,189,233,272,219,285,0.85,39,39,66
OceanDNA-b41178,1745,4.2,0.0,0.0022,2.4,154,186,103,135,91,140,0.85,32,32,49
OceanDNA-b16778,1295,16.8,0.0,3.2e-07,0.00025,146,188,256,298,200,306,0.85,42,42,106
OceanDNA-b32734,108,1.1,0.0,0.0095,3.7,197,216,202,221,191,236,0.85,19,19,45
OceanDNA-b40171,78,2.0,0.0,0.0049,2.3,198,228,302,331,292,346,0.85,30,29,54
OceanDNA-b22965,2488,11.6,0.0,1.8e-05,0.026,149,180,96,127,77,134,0.85,31,31,57
OceanDNA-b4587,117,19.3,0.1,2.8e-08,1.9e-05,187,266,181,258,171,283,0.85,79,77,112
OceanDNA-b26167,208,15.0,0.0,5.4e-07,0.00047,87,182,60,159,51,172,0.85,95,99,121
OceanDNA-b32047,2007,13.4,0.0,5e-06,0.006,155,180,210,235,194,247,0.85,25,25,53
OceanDNA-b4307,173,12.5,0.0,3.1e-06,0.00096,152,188,139,175,83,203,0.85,36,36,120
OceanDNA-b26750,148,0.7,0.2,0.013,8.0,161,175,126,140,121,143,0.85,14,14,22
OceanDNA-b37977,501,17.9,0.1,7e-08,5.9e-05,138,198,125,184,116,186,0.85,60,59,70
OceanDNA-b33061,911,19.0,0.0,3.2e-08,0.0001,126,177,140,191,98,260,0.85,51,51,162
OceanDNA-b4116,368,8.5,0.0,5.3e-05,0.034,196,236,264,303,241,327,0.85,40,39,86
OceanDNA-b46298,1400,10.6,0.0,1.2e-05,0.055,138,189,305,350,287,367,0.85,51,45,80
OceanDNA-b1353,3339,-3.3,0.0,0.61,800.0,155,173,295,313,293,315,0.85,18,18,22
OceanDNA-b2923,446,10.0,0.1,3.7e-05,0.036,158,187,350,379,332,388,0.85,29,29,56
OceanDNA-b31192,461,9.3,0.0,3e-05,0.023,157,192,63,100,53,108,0.85,35,37,55
OceanDNA-b11661,726,11.5,0.0,6.6e-06,0.0067,186,217,333,364,321,372,0.85,31,31,51
OceanDNA-b34788,303,16.5,0.0,2e-07,0.00012,138,185,139,187,131,195,0.85,47,48,64
OceanDNA-b12531,133,29.2,0.0,2.7e-11,9.7e-09,213,282,2,74,1,89,0.85,69,72,88
OceanDNA-b34299,307,11.3,0.0,2.9e-05,0.015,108,179,452,527,449,543,0.85,71,75,94
OceanDNA-b37510,372,12.9,0.0,4.7e-06,0.0038,198,264,620,688,610,695,0.85,66,68,85
OceanDNA-b44662,1421,-2.4,0.0,0.23,310.0,87,97,724,734,715,738,0.85,10,10,23
OceanDNA-b22542,190,11.2,0.0,7.8e-06,0.0063,152,195,104,147,93,175,0.85,43,43,82
OceanDNA-b29589,1432,10.5,0.2,2.5e-05,0.04,87,185,80,182,56,195,0.85,98,102,139
OceanDNA-b23333,179,13.7,0.1,2.7e-06,0.0022,153,187,548,583,530,587,0.85,34,35,57
OceanDNA-b20491,67,2.8,0.0,0.0057,0.95,80,121,134,175,126,199,0.85,41,41,73
OceanDNA-b27544,463,11.5,0.1,6.4e-06,0.01,198,266,181,247,169,251,0.85,68,66,82
OceanDNA-b33096,1031,7.7,0.0,0.00027,0.11,189,218,187,216,140,246,0.85,29,29,106
OceanDNA-b45383,7997,-1.1,0.0,0.087,400.0,241,268,116,143,107,153,0.85,27,27,46
OceanDNA-b22926,2357,11.1,0.0,1.7e-05,0.038,149,180,271,302,254,310,0.85,31,31,56
OceanDNA-b9808,317,16.1,0.0,5.1e-07,0.00015,133,179,95,140,83,154,0.85,46,45,71
OceanDNA-b7219,294,18.8,0.0,4e-08,1.3e-05,136,185,101,148,87,165,0.85,49,47,78
OceanDNA-b17033,596,11.9,0.0,1e-05,0.0079,153,186,107,140,97,144,0.85,33,33,47
OceanDNA-b36658,307,16.4,0.0,4.3e-07,0.00019,158,180,57,79,35,91,0.85,22,22,56
OceanDNA-b19626,358,41.3,0.0,1.1e-14,2.7e-12,72,171,77,181,54,202,0.85,99,104,148
OceanDNA-b45582,707,8.2,0.0,6.6e-05,0.15,196,261,282,344,274,349,0.85,65,62,75
OceanDNA-b32785,766,11.0,0.0,9.3e-06,0.0098,152,185,92,125,14,142,0.85,33,33,128
OceanDNA-b22627,179,10.4,0.0,1.4e-05,0.045,148,195,226,273,213,294,0.85,47,47,81
OceanDNA-b38495,642,11.0,0.0,2.8e-05,0.0078,153,184,132,163,115,178,0.85,31,31,63
OceanDNA-b22840,3818,1.6,0.0,0.02,28.0,194,230,269,304,250,327,0.85,36,35,77
OceanDNA-b44384,279,16.8,0.0,1.5e-07,0.00015,188,262,328,402,286,406,0.85,74,74,120
OceanDNA-b19079,130,18.7,0.0,4e-08,1.3e-05,151,189,124,163,92,204,0.85,38,39,112
OceanDNA-b36666,772,14.6,0.0,2.2e-06,0.00091,158,186,162,190,141,208,0.85,28,28,67
OceanDNA-b32,528,0.5,0.0,0.029,9.1,196,215,262,281,257,293,0.85,19,19,36
OceanDNA-b31575,1583,0.5,0.0,0.029,26.0,197,214,264,281,261,291,0.85,17,17,30
OceanDNA-b20043,202,105.5,0.0,3e-34,5.1e-32,54,282,225,465,215,474,0.85,228,240,259
OceanDNA-b13135,256,10.1,0.0,1.7e-05,0.0085,157,185,145,173,127,183,0.85,28,28,56
OceanDNA-b47086,2846,12.3,0.1,7.4e-06,0.015,137,189,96,142,74,161,0.85,52,46,87
OceanDNA-b46922,163,9.1,0.0,3.4e-05,0.077,160,182,180,202,171,219,0.85,22,22,48
OceanDNA-b33192,401,5.6,0.0,0.00078,0.17,162,197,1,40,1,50,0.85,35,39,49
OceanDNA-b3599,397,18.7,0.0,7.9e-08,3e-05,148,188,153,194,141,229,0.85,40,41,88
OceanDNA-b3934,230,11.6,0.0,1.2e-05,0.0043,190,266,180,254,174,259,0.85,76,74,85
OceanDNA-b12544,188,133.7,0.0,3.9e-43,1.2e-40,66,281,73,298,45,309,0.85,215,225,264
OceanDNA-a3473,410,10.4,0.0,1.4e-05,0.0059,151,205,47,101,35,120,0.85,54,54,85
OceanDNA-b37665,933,18.6,0.0,8.9e-08,6.9e-05,139,181,140,184,128,198,0.85,42,44,70
OceanDNA-b10020,371,4.7,0.0,0.0023,0.38,153,189,534,570,516,581,0.85,36,36,65
OceanDNA-b23345,103,13.3,0.1,1.9e-06,0.0037,147,184,683,720,630,731,0.85,37,37,101
OceanDNA-b20668,130,50.5,0.1,1.7e-17,2.3e-15,55,189,65,206,61,214,0.85,134,141,153
OceanDNA-b7279,119,11.4,0.0,1.4e-05,0.0026,133,182,104,151,41,164,0.85,49,47,123
OceanDNA-b20096,2,11.2,0.0,1.5e-05,0.0024,154,197,601,648,593,656,0.85,43,47,63
OceanDNA-b29080,323,17.5,0.0,9.2e-08,0.00015,153,177,134,158,117,182,0.85,24,24,65
OceanDNA-b46695,1180,46.0,0.0,1.2e-15,4.3e-13,153,244,150,244,140,256,0.85,91,94,116
OceanDNA-b33411,1017,6.3,0.0,0.00051,0.33,124,187,222,287,212,309,0.85,63,65,97
OceanDNA-b46349,97,19.0,0.2,3.4e-08,8.9e-05,151,186,247,282,237,286,0.85,35,35,49
OceanDNA-b22993,1301,18.5,0.0,4.7e-08,6.4e-05,130,175,91,137,15,161,0.85,45,46,146
OceanDNA-b15136,655,14.8,0.0,6.5e-07,0.00043,197,266,615,686,593,688,0.85,69,71,95
OceanDNA-b16135,213,5.1,0.0,0.0011,0.52,88,120,264,296,248,306,0.85,32,32,58
OceanDNA-b5372,199,10.2,0.0,1.6e-05,0.0083,153,181,73,101,59,118,0.85,28,28,59
OceanDNA-b36140,2310,7.8,0.0,0.00018,0.25,198,264,648,716,644,722,0.85,66,68,78
OceanDNA-b30640,764,9.6,0.0,7.5e-05,0.031,139,187,215,262,196,296,0.85,48,47,100
OceanDNA-b34674,221,36.4,0.1,1.7e-13,1e-10,67,173,134,254,118,261,0.85,106,120,143
OceanDNA-b20957,2309,10.0,0.0,3.7e-05,0.074,194,265,148,217,142,222,0.85,71,69,80
OceanDNA-b23489,873,9.9,0.1,1.9e-05,0.042,159,183,134,158,126,168,0.85,24,24,42
OceanDNA-b3607,603,19.8,0.0,1.9e-08,4.8e-05,153,216,106,168,69,195,0.85,63,62,126
OceanDNA-b34760,599,15.5,0.1,3.9e-07,0.00024,198,254,261,317,251,325,0.85,56,56,74
OceanDNA-b32709,1359,-3.7,0.0,0.53,450.0,198,217,316,335,311,342,0.85,19,19,31
OceanDNA-b20967,119,-0.4,0.0,0.027,41.0,73,94,272,293,267,300,0.85,21,21,33
OceanDNA-b44576,177,11.3,0.0,7.3e-06,0.0016,127,168,156,197,131,208,0.85,41,41,77
OceanDNA-b40548,301,4.1,0.0,0.0023,1.3,195,238,303,347,294,355,0.85,43,44,61
OceanDNA-b40548,301,9.2,0.1,6.5e-05,0.037,107,170,142,201,139,221,0.85,63,59,82
OceanDNA-b28321,428,13.0,0.0,2.3e-06,0.0011,154,178,2,26,1,49,0.85,24,24,48
OceanDNA-b26825,261,10.7,0.0,1.1e-05,0.011,161,187,120,146,67,162,0.85,26,26,95
OceanDNA-b46641,1672,15.3,0.0,4.3e-07,0.00085,149,197,90,138,83,148,0.85,48,48,65
OceanDNA-b45652,255,10.8,0.0,2.1e-05,0.0061,136,183,126,170,112,180,0.85,47,44,68
OceanDNA-b13103,517,11.5,0.1,1.3e-05,0.006,94,189,719,809,713,822,0.85,95,90,109
OceanDNA-b6771,196,14.9,0.1,2.4e-06,0.00056,173,244,218,286,214,298,0.85,71,68,84
OceanDNA-b38157,181,6.3,0.0,0.00076,0.18,54,121,42,108,30,115,0.85,67,66,85
OceanDNA-b3605,370,21.0,0.0,1.6e-08,1.6e-05,154,215,152,212,134,222,0.85,61,60,88
OceanDNA-b14822,76,2.9,0.0,0.0027,0.63,216,254,141,179,131,189,0.85,38,38,58
OceanDNA-b2668,146,12.7,0.0,5.6e-06,0.0011,152,189,9,47,1,53,0.85,37,38,52
OceanDNA-b22976,1905,31.1,0.0,6.9e-12,3.2e-08,152,247,185,284,166,290,0.85,95,99,124
OceanDNA-b9684,662,14.7,0.1,1.3e-06,0.00049,145,191,76,123,70,132,0.85,46,47,62
OceanDNA-b3975,757,11.5,0.0,2.5e-05,0.0052,160,182,159,181,140,192,0.85,22,22,52
OceanDNA-b40669,87,12.2,0.0,7.9e-06,0.0025,192,246,220,272,188,284,0.85,54,52,96
OceanDNA-b24595,2814,12.4,0.0,3.4e-06,0.012,196,230,235,269,224,285,0.85,34,34,61
OceanDNA-b45508,965,0.1,0.0,0.019,22.0,106,122,65,81,51,85,0.85,16,16,34
OceanDNA-b3820,2333,13.6,0.0,1.5e-06,0.0038,186,218,54,86,41,97,0.85,32,32,56
OceanDNA-b44448,147,12.9,0.0,2.3e-06,0.00061,154,184,151,181,129,190,0.85,30,30,61
OceanDNA-b3594,247,7.7,0.0,8.9e-05,0.094,237,273,299,336,294,354,0.85,36,37,60
OceanDNA-b12582,169,14.0,0.0,1.1e-06,0.00038,154,185,121,152,116,164,0.85,31,31,48
OceanDNA-b26901,3435,7.9,0.1,7.8e-05,0.29,161,187,140,166,85,182,0.85,26,26,97
OceanDNA-b21002,2996,9.1,0.1,0.0001,0.19,197,245,352,398,327,411,0.85,48,46,84
OceanDNA-b13830,31,3.5,0.0,0.0034,0.43,197,227,251,280,235,289,0.85,30,29,54
OceanDNA-b27416,97,10.2,0.0,1.6e-05,0.0041,151,190,221,260,211,277,0.85,39,39,66
OceanDNA-b33331,208,17.7,0.0,1.7e-07,0.00013,140,181,126,168,120,180,0.85,41,42,60
OceanDNA-b36885,333,17.8,0.0,7.5e-08,5.1e-05,148,192,217,261,185,283,0.85,44,44,98
OceanDNA-b24003,608,9.5,0.0,5.1e-05,0.038,196,252,577,633,564,639,0.85,56,56,75
OceanDNA-b8264,293,12.2,0.0,8e-06,0.0029,135,181,116,161,105,174,0.85,46,45,69
OceanDNA-b28010,562,8.2,0.1,6.6e-05,0.21,198,266,208,274,200,277,0.85,68,66,77
OceanDNA-b1751,2372,21.9,0.1,4.4e-09,1.2e-05,149,185,72,108,63,135,0.85,36,36,72
OceanDNA-b28010,562,9.5,0.0,2.7e-05,0.086,162,198,127,167,124,177,0.85,36,40,53
OceanDNA-b29381,649,8.9,0.0,3.8e-05,0.036,194,244,260,310,253,318,0.85,50,50,65
OceanDNA-b24046,1227,11.0,0.0,1.8e-05,0.022,154,198,2,46,1,58,0.85,44,44,57
OceanDNA-b37582,1724,14.6,0.1,1.4e-06,0.0017,137,187,162,214,157,231,0.85,50,52,74
OceanDNA-b22885,443,12.1,0.0,8.5e-06,0.018,148,180,240,272,222,285,0.84,32,32,63
OceanDNA-b13570,390,21.2,0.0,2.1e-08,9.3e-06,91,177,21,105,11,123,0.84,86,84,112
OceanDNA-b1435,454,6.9,0.1,0.00048,0.13,154,188,120,154,106,169,0.84,34,34,63
OceanDNA-b30046,2482,6.1,0.0,0.00055,0.81,195,235,192,232,183,244,0.84,40,40,61
OceanDNA-b30006,1262,14.8,0.0,6.5e-07,0.0023,155,181,351,377,333,397,0.84,26,26,64
OceanDNA-b27545,1368,-3.2,0.0,0.2,430.0,144,158,352,366,347,369,0.84,14,14,22
OceanDNA-b20976,1531,2.7,0.0,0.006,18.0,194,223,331,360,326,370,0.84,29,29,44
OceanDNA-b22496,4234,17.1,0.0,2.6e-07,0.0006,105,178,95,166,81,174,0.84,73,71,93
OceanDNA-b13570,213,11.4,0.1,2.1e-05,0.0092,150,187,134,171,93,197,0.84,37,37,104
OceanDNA-b30773,857,12.3,0.0,3.6e-06,0.011,196,265,246,313,236,318,0.84,69,67,82
OceanDNA-b23644,7,-1.1,0.0,0.045,120.0,193,221,308,336,305,346,0.84,28,28,41
OceanDNA-b36401,772,11.4,0.0,2e-05,0.0076,91,121,124,154,119,172,0.84,30,30,53
OceanDNA-b13457,695,12.1,0.0,8.4e-06,0.0029,146,197,24,77,16,83,0.84,51,53,67
OceanDNA-b23461,1360,13.1,0.0,2.1e-06,0.0064,149,179,168,198,153,245,0.84,30,30,92
OceanDNA-b202,123,18.2,0.0,1.8e-07,0.00013,152,215,458,523,432,545,0.84,63,65,113
OceanDNA-b35376,2203,3.9,0.0,0.0013,3.4,187,211,256,280,240,290,0.84,24,24,50
OceanDNA-b36730,3243,10.7,0.0,2.3e-05,0.037,197,264,189,258,182,265,0.84,67,69,83
OceanDNA-b10366,922,11.1,0.0,1.7e-05,0.014,181,267,644,730,635,736,0.84,86,86,101
OceanDNA-b26667,3672,10.1,0.5,1.7e-05,0.093,142,179,65,101,56,107,0.84,37,36,51
OceanDNA-b32645,804,13.0,0.0,2.2e-06,0.0018,61,118,19,76,2,85,0.84,57,57,83
OceanDNA-b31070,2171,10.7,0.0,2.3e-05,0.035,136,192,99,149,87,157,0.84,56,50,70
OceanDNA-b40617,78,14.2,0.0,1.9e-06,0.00039,94,181,28,109,15,120,0.84,87,81,105
OceanDNA-b23054,1823,13.3,0.0,3.6e-06,0.0045,85,117,70,102,19,103,0.84,32,32,84
OceanDNA-b11732,492,15.5,0.0,3.8e-07,0.00038,186,222,298,334,286,341,0.84,36,36,55
OceanDNA-b24680,406,-1.6,0.0,0.062,52.0,248,284,278,314,272,319,0.84,36,36,47
OceanDNA-b42626,228,10.1,0.0,1.7e-05,0.0042,192,218,200,226,190,242,0.84,26,26,52
OceanDNA-b34725,188,13.0,0.0,4.5e-06,0.0016,197,246,564,613,558,633,0.84,49,49,75
OceanDNA-b31526,855,21.2,0.0,2.1e-08,7.2e-06,80,122,206,248,200,274,0.84,42,42,74
OceanDNA-b36666,625,12.1,0.0,1.3e-05,0.0052,158,184,154,180,139,189,0.84,26,26,50
OceanDNA-b44367,149,11.6,0.0,6e-06,0.0018,152,178,164,190,144,202,0.84,26,26,58
OceanDNA-b13078,1187,11.6,0.0,5.8e-06,0.0076,105,188,97,182,47,196,0.84,83,85,149
OceanDNA-b22249,621,7.3,0.0,0.00012,0.37,160,184,167,191,154,197,0.84,24,24,43
OceanDNA-b37535,1422,11.2,0.0,1.5e-05,0.014,144,180,25,61,11,81,0.84,36,36,70
OceanDNA-b42439,10,15.2,0.0,9.2e-07,0.00012,143,189,104,151,96,155,0.84,46,47,59
OceanDNA-b23996,1022,11.1,0.0,1.7e-05,0.0096,197,267,110,182,95,184,0.84,70,72,89
OceanDNA-b24946,2170,1.1,0.0,0.0093,22.0,197,229,267,298,262,307,0.84,32,31,45
OceanDNA-b25128,263,14.7,0.0,1.3e-06,0.00058,197,246,340,387,332,406,0.84,49,47,74
OceanDNA-b30001,1264,3.1,0.0,0.0046,3.7,148,182,129,163,114,178,0.84,34,34,64
OceanDNA-b289,3696,13.7,0.0,2.6e-06,0.0051,195,240,184,227,175,239,0.84,45,43,64
OceanDNA-b37161,189,-1.9,0.0,0.078,85.0,196,215,208,227,203,235,0.84,19,19,32
OceanDNA-b4297,78,3.0,0.0,0.0025,0.69,153,189,520,556,507,567,0.84,36,36,60
OceanDNA-b32861,681,14.0,0.1,2.2e-06,0.0014,123,194,113,187,105,196,0.84,71,74,91
OceanDNA-b23275,379,18.5,0.0,4.7e-08,0.00016,141,181,150,192,137,203,0.84,40,42,66
OceanDNA-b3696,1147,13.2,0.0,1.9e-06,0.0048,186,215,324,353,309,381,0.84,29,29,72
OceanDNA-b18620,306,19.8,0.0,3.9e-08,8e-06,151,185,130,164,110,190,0.84,34,34,80
OceanDNA-b18620,349,9.9,0.0,3.9e-05,0.008,147,192,201,246,177,250,0.84,45,45,73
OceanDNA-b32474,247,18.8,0.0,3.9e-08,1.3e-05,155,246,111,206,96,219,0.84,91,95,123
OceanDNA-b23624,1244,10.9,0.0,2e-05,0.023,155,180,199,224,112,237,0.84,25,25,125
OceanDNA-b32757,170,14.5,0.0,7.5e-07,0.00037,138,192,203,251,193,266,0.84,54,48,73
OceanDNA-b22890,1494,11.7,0.0,1.6e-05,0.011,148,212,61,124,44,144,0.84,64,63,100
OceanDNA-b46852,925,14.9,0.1,1.8e-06,0.00074,150,186,236,272,222,286,0.84,36,36,64
OceanDNA-b10067,117,3.9,0.0,0.0013,0.62,152,190,534,572,518,582,0.84,38,38,64
OceanDNA-b17609,3614,-0.5,0.0,0.028,140.0,202,221,306,325,302,365,0.84,19,19,63
OceanDNA-b22178,122,11.8,0.0,5.2e-06,0.0018,149,195,486,532,471,554,0.84,46,46,83
OceanDNA-b27542,367,10.3,0.9,4.6e-05,0.034,87,188,74,182,60,204,0.84,101,108,144
OceanDNA-b15801,1332,11.0,0.0,1.8e-05,0.013,152,180,128,156,95,165,0.84,28,28,70
OceanDNA-b23644,7,14.1,0.1,1e-06,0.0027,157,185,187,215,173,236,0.84,28,28,63
OceanDNA-b36084,2329,0.6,0.0,0.014,37.0,254,266,449,461,439,464,0.84,12,12,25
OceanDNA-b13457,125,6.8,0.1,0.00035,0.12,58,90,168,200,163,214,0.84,32,32,51
OceanDNA-b34087,371,17.4,0.4,1.1e-07,5.2e-05,193,267,187,259,181,261,0.84,74,72,80
OceanDNA-b37433,682,7.5,0.0,0.00011,0.13,147,186,126,165,114,181,0.84,39,39,67
OceanDNA-b37047,313,-0.7,0.0,0.032,23.0,107,121,106,120,84,130,0.84,14,14,46
OceanDNA-b32141,2451,11.7,0.1,1.1e-05,0.017,155,175,320,340,311,357,0.84,20,20,46
OceanDNA-b46188,73,7.9,0.0,7.9e-05,0.065,151,196,91,136,79,143,0.84,45,45,64
OceanDNA-b38580,272,11.4,0.1,7e-06,0.0044,210,246,57,95,49,106,0.84,36,38,57
OceanDNA-b46982,311,20.2,0.0,4.3e-08,9.5e-06,139,187,111,160,92,173,0.84,48,49,81
OceanDNA-b31120,118,11.8,0.0,1.6e-05,0.0058,160,181,146,167,125,185,0.84,21,21,60
OceanDNA-b43875,440,16.2,0.0,2.3e-07,0.00013,153,185,113,145,91,153,0.84,32,32,62
OceanDNA-b4282,21,30.0,0.0,1.5e-11,4.2e-09,152,243,144,237,131,248,0.84,91,93,117
OceanDNA-b20674,70,54.5,0.0,5.2e-19,1.6e-16,55,189,71,212,68,220,0.84,134,141,152
OceanDNA-b46728,883,14.3,0.0,3.6e-06,0.0015,150,186,176,212,164,226,0.84,36,36,62
OceanDNA-b16224,1390,3.9,0.0,0.0013,2.0,152,178,343,369,318,377,0.84,26,26,59
OceanDNA-b24875,724,13.4,0.0,5.2e-06,0.003,145,178,119,152,99,236,0.84,33,33,137
OceanDNA-b10297,536,11.8,0.0,5.2e-06,0.003,198,266,608,678,601,678,0.84,68,70,77
OceanDNA-b401,641,20.2,0.0,1.4e-08,1.4e-05,129,190,178,234,92,258,0.84,61,56,166
OceanDNA-b32762,963,20.1,0.1,1.5e-08,2.3e-05,88,197,65,177,31,184,0.84,109,112,153
OceanDNA-b9758,999,15.9,0.0,5.7e-07,0.00033,155,188,176,210,159,244,0.84,33,34,85
OceanDNA-b44610,1442,7.7,0.0,9.5e-05,0.16,154,185,217,248,162,256,0.84,31,31,94
OceanDNA-b37023,300,2.3,0.0,0.0082,3.0,197,238,296,336,290,342,0.84,41,40,52
OceanDNA-b21002,3953,13.7,0.0,4e-06,0.0075,142,189,292,339,271,352,0.84,47,47,81
OceanDNA-b22498,2720,7.6,0.0,0.0002,0.31,150,195,229,274,216,281,0.84,45,45,65
OceanDNA-b22498,2435,14.5,0.0,1.6e-06,0.0025,148,188,150,191,138,198,0.84,40,41,60
OceanDNA-b5526,273,146.7,0.0,8.2e-47,2.1e-44,71,283,94,318,60,328,0.84,212,224,268
OceanDNA-b13175,254,12.1,0.0,4.1e-06,0.0037,154,180,145,171,127,204,0.84,26,26,77
OceanDNA-b36139,1700,12.9,0.0,4.9e-06,0.0049,139,198,130,188,119,195,0.84,59,58,76
OceanDNA-b1588,529,7.9,0.1,7.8e-05,0.064,150,188,109,146,93,155,0.84,38,37,62
OceanDNA-b36862,909,9.8,0.0,4.2e-05,0.024,131,186,33,82,14,87,0.84,55,49,73
OceanDNA-b38574,185,-1.7,0.0,0.067,46.0,197,215,245,263,227,272,0.84,18,18,45
OceanDNA-b17640,25,19.9,0.0,1.7e-08,1.2e-05,151,196,185,231,133,276,0.84,45,46,143
OceanDNA-b35240,640,5.2,0.0,0.001,0.55,159,189,162,193,151,204,0.84,30,31,53
OceanDNA-b4249,812,8.1,0.0,6.9e-05,0.096,161,197,122,162,95,171,0.84,36,40,76
OceanDNA-b22944,383,11.4,0.0,7e-06,0.03,148,180,296,328,280,335,0.84,32,32,55
OceanDNA-b12581,54,127.4,0.0,3.2e-41,7.9e-39,71,269,61,270,29,290,0.84,198,209,261
OceanDNA-b30043,1162,8.6,0.1,9.5e-05,0.094,198,266,194,260,185,262,0.84,68,66,77
OceanDNA-b12858,57,10.8,0.0,1e-05,0.0049,158,187,72,101,67,137,0.84,29,29,70
OceanDNA-b30703,272,14.5,0.0,8e-07,0.0014,154,180,144,170,127,184,0.84,26,26,57
OceanDNA-b47086,269,1.6,0.0,0.013,28.0,106,123,209,226,199,231,0.84,17,17,32
OceanDNA-b35110,497,11.0,0.0,9e-06,0.007,151,186,70,105,35,122,0.84,35,35,87
OceanDNA-b38572,538,5.2,0.0,0.00055,0.31,197,225,234,262,224,273,0.84,28,28,49
OceanDNA-b41695,121,16.1,0.0,5.3e-07,4.8e-05,97,187,32,120,28,127,0.84,90,88,99
OceanDNA-b31338,206,10.6,0.0,1.2e-05,0.0029,191,246,57,110,49,122,0.84,55,53,73
OceanDNA-b229,508,26.3,0.0,2e-10,1.9e-07,153,245,120,213,93,218,0.84,92,93,125
OceanDNA-b35243,734,5.2,0.0,0.00054,0.52,159,189,170,201,159,215,0.84,30,31,56
OceanDNA-b27518,1644,16.0,0.0,2.7e-07,0.00049,153,176,144,167,127,182,0.84,23,23,55
OceanDNA-b11479,73,11.1,0.1,8.3e-06,0.0043,197,268,192,261,183,290,0.84,71,69,107
OceanDNA-b282,778,38.2,0.0,9.2e-14,6.7e-11,150,245,133,230,120,239,0.84,95,97,119
OceanDNA-b37510,372,-1.0,0.0,0.082,67.0,156,189,543,576,530,583,0.84,33,33,53
OceanDNA-b11002,150,16.8,0.0,1.6e-07,4.2e-05,153,218,151,218,143,244,0.84,65,67,101
OceanDNA-b26763,786,12.1,0.0,4.1e-06,0.0053,160,186,99,125,82,157,0.84,26,26,75
OceanDNA-b6501,409,9.0,0.0,0.00011,0.018,150,185,238,273,219,281,0.84,35,35,62
OceanDNA-b46823,1322,12.3,0.1,1.1e-05,0.0066,159,204,97,147,87,161,0.84,45,50,74
OceanDNA-b46823,158,12.9,0.1,7.2e-06,0.0043,152,185,238,271,224,278,0.84,33,33,54
OceanDNA-b20922,6387,12.5,0.1,9.7e-06,0.022,137,185,159,207,147,228,0.84,48,48,81
OceanDNA-b38370,238,81.7,0.0,5.4e-27,4.4e-24,52,275,33,266,27,281,0.84,223,233,254
OceanDNA-b22996,905,17.1,0.2,1.3e-07,0.0002,152,187,122,157,33,171,0.84,35,35,138
OceanDNA-b23559,253,2.1,0.0,0.0048,7.8,202,223,239,260,233,273,0.84,21,21,40
OceanDNA-b30031,2225,18.3,0.0,1.1e-07,0.00012,153,179,26,52,9,66,0.84,26,26,57
OceanDNA-b21009,2557,1.3,0.0,0.0085,28.0,48,86,326,365,315,367,0.84,38,39,52
OceanDNA-b13692,196,6.3,0.0,0.00024,0.11,197,228,615,645,605,655,0.84,31,30,50
OceanDNA-b24045,2236,12.3,0.0,1.1e-05,0.0092,158,184,69,95,52,102,0.84,26,26,50
OceanDNA-b47085,317,14.0,0.0,2.2e-06,0.001,152,185,148,181,101,195,0.84,33,33,94
OceanDNA-b47085,104,11.8,0.1,1e-05,0.0047,152,186,271,305,252,312,0.84,34,34,60
OceanDNA-b37246,288,23.7,0.0,1.2e-09,1e-06,153,218,109,176,94,203,0.84,65,67,109
OceanDNA-b31115,69,11.5,0.0,6.4e-06,0.0052,192,233,197,237,180,253,0.84,41,40,73
OceanDNA-b41581,30,20.7,0.0,9.9e-09,5.9e-06,133,186,123,175,112,182,0.84,53,52,70
OceanDNA-b36408,291,3.7,0.0,0.0016,3.5,197,220,280,303,260,317,0.84,23,23,57
OceanDNA-b7917,251,11.7,0.0,5.4e-06,0.0014,138,185,31,76,11,86,0.84,47,45,75
OceanDNA-b9653,726,12.5,0.1,3.1e-06,0.0024,196,268,193,263,184,287,0.84,72,70,103
OceanDNA-b6771,196,5.4,0.0,0.0018,0.42,160,181,127,148,118,158,0.84,21,21,40
OceanDNA-b26646,3259,12.3,0.0,1.1e-05,0.013,153,221,162,233,104,270,0.84,68,71,166
OceanDNA-b45373,219,25.9,0.0,2.6e-10,1.8e-07,153,218,198,265,183,299,0.84,65,67,116
OceanDNA-b30783,1420,14.6,0.0,7.2e-07,0.001,138,198,93,147,77,155,0.84,60,54,78
OceanDNA-b22997,745,13.0,0.0,6.7e-06,0.0023,147,182,140,176,127,207,0.84,35,36,80
OceanDNA-b31685,2065,0.7,0.1,0.024,28.0,152,186,181,217,161,251,0.84,34,36,90
OceanDNA-b33108,794,0.7,0.0,0.012,16.0,152,182,100,130,92,143,0.84,30,30,51
OceanDNA-b8399,69,21.4,0.0,6e-09,1.5e-06,142,189,130,178,123,185,0.84,47,48,62
OceanDNA-b22380,1283,32.1,0.0,1e-11,5.2e-09,153,217,216,284,204,291,0.84,64,68,87
OceanDNA-a1153,65,13.0,0.0,2.3e-06,0.00035,185,264,221,298,214,303,0.84,79,77,89
OceanDNA-b22383,363,12.7,0.0,1.1e-05,0.0093,146,188,139,182,130,192,0.84,42,43,62
OceanDNA-b26825,261,15.0,0.1,5.6e-07,0.00058,197,270,201,272,191,280,0.84,73,71,89
OceanDNA-b34611,71,22.3,0.0,3.4e-09,4.3e-06,197,264,613,682,600,688,0.84,67,69,88
OceanDNA-b22478,1038,-0.2,0.0,0.069,54.0,106,123,76,93,65,97,0.84,17,17,32
OceanDNA-b13086,1080,12.3,0.0,3.8e-06,0.0091,145,204,223,280,219,293,0.84,59,57,74
OceanDNA-b26845,3023,-3.1,0.0,0.37,580.0,163,177,4,18,3,21,0.84,14,14,18
OceanDNA-b23417,1401,11.4,0.0,2.1e-05,0.02,80,173,191,284,128,314,0.84,93,93,186
OceanDNA-b27586,1040,12.1,0.1,4.2e-06,0.0084,161,184,183,206,169,218,0.84,23,23,49
OceanDNA-b28203,1009,12.9,0.1,2.4e-06,0.0069,153,181,132,160,95,167,0.84,28,28,72
OceanDNA-b16140,405,6.0,0.0,0.00063,0.29,87,122,269,304,250,325,0.84,35,35,75
OceanDNA-b20627,234,16.1,0.0,2.5e-07,8e-05,139,192,224,277,202,299,0.84,53,53,97
OceanDNA-b5520,32,143.5,0.0,3.9e-46,1.8e-43,54,282,35,278,25,290,0.84,228,243,265
OceanDNA-b27448,73,24.2,0.1,8.6e-10,2.3e-07,191,264,310,385,297,389,0.84,73,75,92
OceanDNA-b46819,1594,13.8,0.0,1.3e-06,0.0046,148,188,244,286,225,343,0.84,40,42,118
OceanDNA-b26761,515,16.9,0.0,1.4e-07,0.00012,140,185,128,174,121,182,0.84,45,46,61
OceanDNA-b4594,24,13.6,0.0,2.9e-06,0.0007,194,268,185,257,178,277,0.84,74,72,99
OceanDNA-b34671,566,38.4,0.3,4.2e-14,3.2e-11,71,173,157,273,147,287,0.84,102,116,140
OceanDNA-b44,2537,1.1,0.0,0.029,72.0,153,180,84,111,73,119,0.84,27,27,46
OceanDNA-b46684,393,11.6,0.0,1.2e-05,0.0044,153,185,135,167,119,201,0.84,32,32,82
OceanDNA-b35796,702,-0.6,0.0,0.031,32.0,197,217,253,273,246,277,0.84,20,20,31
OceanDNA-b44,1285,12.3,0.0,1.1e-05,0.027,198,265,632,701,627,704,0.84,67,69,77
OceanDNA-b22654,701,16.7,0.1,8.5e-07,0.00021,149,178,248,277,239,286,0.84,29,29,47
OceanDNA-b12541,171,138.2,0.0,1.6e-44,5.3e-42,53,282,39,283,26,297,0.84,229,244,271
OceanDNA-b22895,678,12.1,0.0,8.3e-06,0.0066,150,190,337,376,323,392,0.84,40,39,69
OceanDNA-b32215,652,11.1,0.0,8.4e-06,0.019,197,262,620,687,607,693,0.84,65,67,86
OceanDNA-b10199,1,13.3,0.0,1.8e-06,0.00068,143,183,73,113,67,128,0.84,40,40,61
OceanDNA-b30085,540,10.5,0.0,3.8e-05,0.028,161,197,129,169,74,185,0.84,36,40,111
OceanDNA-b7450,995,2.4,0.0,0.0075,4.9,250,282,368,400,357,414,0.84,32,32,57
OceanDNA-b27549,1961,8.1,0.3,0.00014,0.15,161,197,107,147,98,152,0.84,36,40,54
OceanDNA-b23556,470,-1.6,0.0,0.13,140.0,196,230,314,348,310,351,0.84,34,34,41
OceanDNA-b24608,76,3.5,0.0,0.0017,0.93,82,120,51,89,42,99,0.84,38,38,57
OceanDNA-b30085,1262,-2.0,0.1,0.25,180.0,165,186,203,224,201,259,0.84,21,21,58
OceanDNA-b44480,233,18.4,0.0,5e-08,1.7e-05,153,185,171,203,150,212,0.84,32,32,62
OceanDNA-b44,4810,11.5,0.0,1.9e-05,0.047,197,263,613,681,593,684,0.84,66,68,91
OceanDNA-b23819,1194,19.9,0.0,3.6e-08,3.1e-05,141,184,133,178,128,245,0.84,43,45,117
OceanDNA-b7194,370,20.9,0.2,3.6e-08,7.6e-06,159,249,132,223,127,259,0.84,90,91,132
OceanDNA-b30221,614,15.8,0.0,6.4e-07,0.0007,154,177,173,196,160,236,0.84,23,23,76
OceanDNA-b15777,892,12.7,0.0,8.5e-06,0.0049,197,243,199,243,183,247,0.84,46,44,64
OceanDNA-b3425,223,12.0,0.0,9e-06,0.0035,150,186,251,287,239,305,0.84,36,36,66
OceanDNA-b30622,11,16.0,0.0,2.7e-07,0.00017,154,181,146,173,128,196,0.84,27,27,68
OceanDNA-b31076,1192,7.4,0.0,0.00034,0.33,150,188,264,302,252,314,0.84,38,38,62
OceanDNA-b22177,281,10.1,0.0,1.7e-05,0.015,147,196,501,550,488,570,0.84,49,49,82
OceanDNA-b30938,2151,23.4,1.2,4.4e-09,3.7e-06,88,181,98,198,12,201,0.84,93,100,189
OceanDNA-b23289,1196,11.0,0.1,9.4e-06,0.017,138,217,156,232,144,253,0.84,79,76,109
OceanDNA-b22504,1657,32.5,0.0,7.5e-12,7.2e-09,154,247,230,327,218,335,0.84,93,97,117
OceanDNA-b37895,345,12.2,0.1,7.7e-06,0.003,157,195,90,129,73,207,0.84,38,39,134
OceanDNA-b12871,421,4.1,0.1,0.0011,0.5,75,121,133,182,120,210,0.84,46,49,90
OceanDNA-b20290,149,13.6,0.0,1.5e-06,0.00071,153,197,597,645,592,651,0.84,44,48,59
OceanDNA-b18463,143,14.8,0.0,6.4e-07,0.0002,134,186,109,155,34,191,0.84,52,46,157
OceanDNA-b26604,235,18.1,0.1,6.1e-08,3.1e-05,149,183,142,176,126,210,0.84,34,34,84
OceanDNA-b36770,733,11.9,0.0,5e-06,0.0054,144,187,116,159,108,180,0.84,43,43,72
OceanDNA-b16138,515,14.5,0.0,7.7e-07,0.0006,85,145,271,325,260,397,0.84,60,54,137
OceanDNA-b46296,2016,14.5,0.0,7.6e-07,0.0021,152,184,205,237,188,253,0.84,32,32,65
OceanDNA-b37447,293,3.8,0.0,0.0028,1.0,196,235,265,303,245,321,0.84,39,38,76
OceanDNA-b4882,38,115.4,0.1,1.5e-37,3.5e-35,53,273,36,268,26,291,0.84,220,232,265
OceanDNA-b22840,1018,13.9,0.0,3.5e-06,0.0049,146,180,227,261,212,268,0.84,34,34,56
OceanDNA-b6300,45,0.8,0.0,0.012,6.4,193,214,206,227,202,241,0.84,21,21,39
OceanDNA-b26683,368,8.4,0.0,5.4e-05,0.15,148,182,135,169,102,192,0.84,34,34,90
OceanDNA-b3608,2049,12.1,0.0,4.1e-06,0.0086,183,265,230,309,218,311,0.84,82,79,93
OceanDNA-b41358,795,79.7,0.0,4.4e-26,1.3e-23,43,245,36,241,6,271,0.84,202,205,265
OceanDNA-b32,392,11.5,0.0,1.3e-05,0.004,150,188,226,264,207,280,0.84,38,38,73
OceanDNA-b23817,324,6.0,0.0,0.00062,0.48,183,213,220,249,171,277,0.84,30,29,106
OceanDNA-b36411,1726,4.0,0.0,0.0037,2.5,197,220,249,272,226,286,0.84,23,23,60
OceanDNA-b37960,533,4.5,0.0,0.0025,0.48,152,180,170,199,150,213,0.84,28,29,63
OceanDNA-b21017,221,12.2,0.1,7.9e-06,0.0095,161,192,53,84,33,99,0.84,31,31,66
OceanDNA-b15651,514,18.3,0.0,5.6e-08,3e-05,107,186,205,290,185,326,0.84,79,85,141
OceanDNA-b19913,237,14.8,0.0,6.5e-07,0.00022,150,200,134,184,109,217,0.84,50,50,108
OceanDNA-b29510,1942,9.8,0.1,6.4e-05,0.053,196,266,150,218,141,220,0.84,70,68,79
OceanDNA-b40618,151,16.4,0.0,8.3e-07,0.00012,154,181,150,177,132,189,0.84,27,27,57
OceanDNA-b23561,1571,10.6,0.1,1.2e-05,0.027,153,180,224,251,208,284,0.84,27,27,76
OceanDNA-b26605,363,17.5,0.1,9.5e-08,5.2e-05,149,183,142,176,126,210,0.84,34,34,84
OceanDNA-b20094,183,13.7,0.0,4.1e-06,0.00052,152,197,263,312,256,320,0.84,45,49,64
OceanDNA-b46829,980,-0.9,0.0,0.039,74.0,179,199,363,384,357,388,0.84,20,21,31
OceanDNA-b46222,1352,9.1,0.1,7e-05,0.056,197,263,204,267,194,271,0.84,66,63,77
OceanDNA-b45789,15,10.9,0.0,2e-05,0.0055,155,191,97,133,25,142,0.84,36,36,117
OceanDNA-b18473,63,-0.1,0.0,0.022,10.0,85,118,217,250,211,258,0.84,33,33,47
OceanDNA-b3624,700,1.7,0.0,0.0061,4.9,145,189,139,184,131,190,0.84,44,45,59
OceanDNA-b34805,485,12.4,0.0,3.3e-06,0.0019,197,265,623,693,585,697,0.84,68,70,112
OceanDNA-b22965,2749,8.7,0.0,0.00013,0.19,12,114,107,209,97,231,0.84,102,102,134
OceanDNA-b45194,1708,2.7,0.1,0.0031,7.0,157,176,90,109,78,118,0.84,19,19,40
OceanDNA-b30427,1668,18.0,0.0,1.4e-07,0.00014,153,179,200,226,184,259,0.84,26,26,75
OceanDNA-b3681,100,6.8,0.0,0.00017,0.26,161,188,122,149,52,164,0.84,27,27,112
OceanDNA-b41307,1384,9.4,0.0,2.9e-05,0.12,177,218,206,245,192,257,0.84,41,39,65
OceanDNA-b41011,471,11.4,0.0,1.4e-05,0.017,191,263,238,309,227,315,0.84,72,71,88
OceanDNA-b46206,314,11.9,0.0,4.9e-06,0.0058,159,187,109,137,87,142,0.84,28,28,55
OceanDNA-b45554,234,6.0,0.0,0.00029,0.18,196,261,208,270,195,273,0.84,65,62,78
OceanDNA-b35883,168,21.5,0.0,5.6e-09,2e-06,154,181,151,178,133,200,0.84,27,27,67
OceanDNA-b30044,1624,31.1,0.0,6.9e-12,1.1e-08,84,181,29,132,22,137,0.84,97,103,115
OceanDNA-b22138,112,10.9,0.0,9.6e-06,0.0057,150,195,121,167,106,187,0.84,45,46,81
OceanDNA-b19697,279,-1.4,0.0,0.054,18.0,86,120,202,236,195,245,0.84,34,34,50
OceanDNA-b34854,147,12.5,0.0,3.2e-06,0.0019,197,264,611,680,576,682,0.84,67,69,106
OceanDNA-b32786,1051,20.0,0.1,4.8e-08,2.6e-05,88,196,46,157,21,164,0.84,108,111,143
OceanDNA-b40669,87,2.1,0.0,0.009,2.9,161,184,146,169,132,181,0.84,23,23,49
OceanDNA-b4256,145,15.0,0.0,5.5e-07,0.00014,198,266,228,298,218,298,0.84,68,70,80
OceanDNA-b23508,519,2.2,0.0,0.0045,6.8,161,189,95,122,71,134,0.84,28,27,63
OceanDNA-b37349,143,0.7,0.0,0.013,8.4,90,121,142,173,133,178,0.84,31,31,45
OceanDNA-b22324,2449,10.6,0.0,3.6e-05,0.049,145,189,284,330,265,345,0.84,44,46,80
OceanDNA-b46766,1240,20.4,0.0,2.4e-08,2.1e-05,149,189,136,177,119,212,0.84,40,41,93
OceanDNA-b4494,680,4.2,0.0,0.0021,1.2,192,255,219,281,213,288,0.84,63,62,75
OceanDNA-b33100,1988,10.3,0.0,1.5e-05,0.035,154,182,146,174,132,182,0.84,28,28,50
OceanDNA-b10236,240,15.5,0.0,3.8e-07,0.0001,198,264,65,133,43,134,0.84,66,68,91
OceanDNA-b23966,184,6.1,0.1,0.00028,0.62,153,185,177,209,168,224,0.84,32,32,56
OceanDNA-b4197,39,24.5,0.0,6.9e-10,4.4e-07,153,196,225,269,214,303,0.84,43,44,89
OceanDNA-b1333,585,8.7,0.0,0.00014,0.072,144,188,85,129,67,141,0.84,44,44,74
OceanDNA-b40237,535,15.9,0.0,2.9e-07,0.00022,154,181,148,175,130,193,0.84,27,27,63
OceanDNA-b35886,286,2.6,0.0,0.0034,1.4,196,217,217,238,204,264,0.84,21,21,60
OceanDNA-b15518,387,10.4,0.0,2.9e-05,0.0092,151,197,103,149,74,154,0.84,46,46,80
OceanDNA-b29209,436,0.7,0.0,0.013,7.2,197,218,313,334,299,355,0.84,21,21,56
OceanDNA-b20951,936,15.4,0.0,8.6e-07,0.0011,181,245,245,311,235,323,0.84,64,66,88
OceanDNA-b20056,332,13.4,0.0,3.3e-06,0.00064,152,197,596,645,591,653,0.84,45,49,62
OceanDNA-b9390,184,8.1,0.0,6.7e-05,0.021,198,264,609,677,599,679,0.84,66,68,80
OceanDNA-b29385,2659,25.1,0.1,4.5e-10,1.5e-06,83,175,338,434,333,446,0.84,92,96,113
OceanDNA-b20893,1271,11.4,0.0,6.6e-06,0.039,178,245,320,389,314,396,0.84,67,69,82
OceanDNA-b22207,45,12.4,0.0,3.5e-06,0.0044,154,191,375,413,360,419,0.84,37,38,59
OceanDNA-b5513,155,153.8,0.0,2.9e-49,1.3e-46,54,282,33,276,14,287,0.84,228,243,273
OceanDNA-b3624,700,7.0,0.0,0.00015,0.12,192,226,230,264,215,278,0.84,34,34,63
OceanDNA-b46834,1327,40.0,0.1,1.4e-14,1.9e-11,153,244,118,212,108,223,0.84,91,94,115
OceanDNA-b7208,478,-0.3,0.0,0.025,17.0,154,185,95,126,86,138,0.84,31,31,52
OceanDNA-b29542,14,17.5,0.0,1.9e-07,0.00021,153,185,138,170,122,214,0.84,32,32,92
OceanDNA-b34288,969,15.6,0.0,7e-07,0.00044,197,265,619,689,599,697,0.84,68,70,98
OceanDNA-b20923,4877,10.1,0.1,3.4e-05,0.1,159,187,172,200,141,216,0.84,28,28,75
OceanDNA-b22212,22,12.6,0.2,2.9e-06,0.0025,149,191,199,241,189,300,0.84,42,42,111
OceanDNA-b47087,581,15.1,0.0,1.5e-06,0.0014,145,185,68,108,59,125,0.84,40,40,66
OceanDNA-b46917,568,11.8,0.1,1e-05,0.0086,151,186,246,281,225,288,0.84,35,35,63
OceanDNA-b22610,773,7.5,0.0,0.00011,0.11,198,264,206,274,201,275,0.84,66,68,74
OceanDNA-b15167,1879,7.7,0.1,0.00019,0.19,152,180,92,120,40,129,0.84,28,28,89
OceanDNA-b38376,2262,10.9,0.0,4.9e-05,0.025,141,182,104,148,97,159,0.84,41,44,62
OceanDNA-b35812,173,7.9,0.0,8e-05,0.14,149,183,114,149,68,156,0.84,34,35,88
OceanDNA-b40235,671,17.2,0.0,1.2e-07,8.8e-05,154,181,150,177,131,195,0.84,27,27,64
OceanDNA-b35823,451,12.8,0.0,7.6e-06,0.011,146,180,139,173,129,185,0.84,34,34,56
OceanDNA-b11187,24,26.2,0.0,2.1e-10,1e-07,152,227,147,223,131,244,0.84,75,76,113
OceanDNA-b44496,119,19.9,0.0,1.8e-08,6.5e-06,139,185,123,171,117,179,0.84,46,48,62
OceanDNA-b24240,502,10.7,0.0,1.1e-05,0.013,130,184,122,173,113,183,0.84,54,51,70
OceanDNA-b23271,540,13.7,0.0,2.8e-06,0.0035,105,176,88,159,78,178,0.84,71,71,100
OceanDNA-b46557,381,8.6,0.0,9.8e-05,0.023,156,199,128,171,75,176,0.83,43,43,101
OceanDNA-b41002,133,38.1,0.0,5.2e-14,1.5e-10,103,272,100,270,6,289,0.83,169,170,283
OceanDNA-b17579,139,20.8,0.0,9.7e-09,3e-05,145,191,161,209,150,222,0.83,46,48,72
OceanDNA-b22415,436,11.7,0.0,5.6e-06,0.015,157,181,234,258,210,273,0.83,24,24,63
OceanDNA-b31519,410,9.5,0.0,2.6e-05,0.017,194,247,576,629,565,643,0.83,53,53,78
OceanDNA-b22022,855,10.9,0.0,1.9e-05,0.032,153,189,524,560,494,570,0.83,36,36,76
OceanDNA-b17032,419,13.2,0.0,2e-06,0.0026,87,188,37,139,30,158,0.83,101,102,128
OceanDNA-b22917,1949,15.6,0.0,1.4e-06,0.001,108,170,172,238,165,247,0.83,62,66,82
OceanDNA-b32108,133,26.1,0.1,4.4e-10,5.7e-07,136,230,132,225,23,240,0.83,94,93,217
OceanDNA-b9653,726,3.5,0.2,0.0018,1.3,161,198,113,154,62,170,0.83,37,41,108
OceanDNA-b26683,368,-0.2,0.2,0.024,68.0,11,49,7,45,3,56,0.83,38,38,53
OceanDNA-b41301,4206,16.0,0.0,7.9e-07,0.0013,186,246,231,289,215,300,0.83,60,58,85
OceanDNA-b17735,2830,12.9,0.0,2.3e-06,0.0073,143,191,161,209,145,222,0.83,48,48,77
OceanDNA-b32152,3251,13.1,0.0,4.2e-06,0.0073,154,180,233,259,215,271,0.83,26,26,56
OceanDNA-b13692,196,5.0,0.0,0.00062,0.29,154,189,537,572,521,588,0.83,35,35,67
OceanDNA-b28545,234,21.1,0.0,7.5e-09,1.5e-05,140,180,124,166,121,185,0.83,40,42,64
OceanDNA-b44390,51,16.6,0.0,5.4e-07,0.00013,188,261,300,373,294,377,0.83,73,73,83
OceanDNA-b1719,179,17.1,0.1,2.6e-07,0.00038,192,267,292,365,285,383,0.83,75,73,98
OceanDNA-b22174,57,10.5,0.0,1.3e-05,0.0078,147,194,514,561,498,568,0.83,47,47,70
OceanDNA-b937,2162,10.3,0.0,1.5e-05,0.033,181,249,192,257,179,265,0.83,68,65,86
OceanDNA-b25045,394,-1.3,0.0,0.051,45.0,193,219,267,293,261,310,0.83,26,26,49
OceanDNA-b45584,658,15.1,0.0,1e-06,0.00068,139,193,111,165,100,177,0.83,54,54,77
OceanDNA-b20148,305,9.3,0.0,3.1e-05,0.012,129,191,218,282,210,294,0.83,62,64,84
OceanDNA-b9767,735,-2.2,0.0,0.093,97.0,251,277,382,408,378,420,0.83,26,26,42
OceanDNA-b10408,194,25.9,0.0,2.6e-10,8e-08,142,197,193,247,188,268,0.83,55,54,80
OceanDNA-b44633,3550,4.3,0.0,0.001,3.6,196,229,241,274,219,294,0.83,33,33,75
OceanDNA-b20349,336,45.2,0.1,3.5e-16,1.5e-13,69,179,71,187,53,204,0.83,110,116,151
OceanDNA-b3641,425,-2.1,0.0,0.18,46.0,203,230,16,46,9,49,0.83,27,30,40
OceanDNA-b45634,653,9.9,0.0,4.1e-05,0.015,198,262,98,159,87,163,0.83,64,61,76
OceanDNA-b37742,52,26.4,0.0,1.8e-10,1.5e-07,140,184,104,151,97,162,0.83,44,47,65
OceanDNA-b22823,1208,-1.6,0.0,0.064,270.0,92,109,267,285,248,289,0.83,17,18,41
OceanDNA-b19757,13,11.1,0.0,8.4e-06,0.0041,76,126,83,134,58,151,0.83,50,51,93
OceanDNA-b6561,429,12.5,0.0,9.6e-06,0.0043,159,190,172,204,159,214,0.83,31,32,55
OceanDNA-b38093,297,13.1,0.0,2.1e-06,0.0019,197,264,142,211,134,218,0.83,67,69,84
OceanDNA-b24863,113,12.5,0.0,3.1e-06,0.00083,156,246,104,198,76,207,0.83,90,94,131
OceanDNA-b30168,407,11.4,0.0,1.4e-05,0.011,52,110,245,307,227,310,0.83,58,62,83
OceanDNA-b16135,213,14.9,0.0,1.2e-06,0.00056,135,181,329,377,318,384,0.83,46,48,66
OceanDNA-b45271,95,11.5,0.0,1.3e-05,0.0032,162,194,111,145,104,151,0.83,32,34,47
OceanDNA-b28583,702,12.2,0.0,4e-06,0.0038,152,180,119,147,71,162,0.83,28,28,91
OceanDNA-b21043,56,12.5,0.1,9.7e-06,0.0057,151,185,92,126,66,133,0.83,34,34,67
OceanDNA-b12532,131,132.7,0.0,7.6e-43,2.3e-40,53,282,51,295,41,309,0.83,229,244,268
OceanDNA-b46646,996,14.3,0.1,9.1e-07,0.0031,153,183,252,282,238,299,0.83,30,30,61
OceanDNA-b47035,211,10.2,0.0,4.6e-05,0.0097,151,186,252,287,237,294,0.83,35,35,57
OceanDNA-b22528,305,11.0,0.0,9.1e-06,0.0075,200,247,145,192,127,201,0.83,47,47,74
OceanDNA-b32055,868,13.0,0.0,2.3e-06,0.0046,151,186,190,225,156,240,0.83,35,35,84
OceanDNA-b26776,1836,5.0,0.0,0.0012,1.5,155,187,137,169,119,183,0.83,32,32,64
OceanDNA-b37839,408,20.5,0.0,1.2e-08,1.1e-05,151,181,173,203,152,226,0.83,30,30,74
OceanDNA-b13830,31,6.2,0.0,0.00053,0.067,152,188,171,207,156,221,0.83,36,36,65
OceanDNA-b45790,316,9.8,0.0,2e-05,0.0083,195,261,214,277,209,281,0.83,66,63,72
OceanDNA-b22481,2461,16.9,0.4,1.5e-07,0.0005,122,193,158,232,149,240,0.83,71,74,91
OceanDNA-b36577,1192,12.5,0.0,6.6e-06,0.0063,182,221,228,267,206,288,0.83,39,39,82
OceanDNA-b28501,49,15.0,0.0,5.4e-07,0.00024,154,182,147,175,130,191,0.83,28,28,61
OceanDNA-b18639,160,10.4,0.0,2.8e-05,0.0056,139,192,225,280,213,290,0.83,53,55,77
OceanDNA-b30681,143,5.1,0.1,0.00058,0.39,191,264,184,255,157,278,0.83,73,71,121
OceanDNA-b40254,458,12.6,0.1,6e-06,0.002,152,187,169,204,119,219,0.83,35,35,100
OceanDNA-b37349,143,14.1,0.0,1e-06,0.00067,127,191,210,276,205,285,0.83,64,66,80
OceanDNA-b17084,288,10.2,0.0,3.1e-05,0.017,198,237,213,251,199,263,0.83,39,38,64
OceanDNA-b20105,218,33.1,0.0,1.7e-12,7.4e-10,156,243,162,260,71,269,0.83,87,98,198
OceanDNA-b14324,393,10.3,0.0,1.4e-05,0.0074,192,215,227,250,209,264,0.83,23,23,55
OceanDNA-b17083,134,12.5,0.0,3.1e-06,0.003,69,189,21,146,10,151,0.83,120,125,141
OceanDNA-b1510,849,12.5,0.0,3.2e-06,0.0033,126,189,90,149,81,159,0.83,63,59,78
OceanDNA-b23725,806,9.8,0.0,6.3e-05,0.046,161,186,117,142,110,162,0.83,25,25,52
OceanDNA-b22460,1842,-1.1,0.0,0.09,160.0,137,191,87,140,81,154,0.83,54,53,73
OceanDNA-b15518,206,11.6,0.0,1.2e-05,0.0038,152,197,22,67,2,76,0.83,45,45,74
OceanDNA-b36441,2119,0.2,0.0,0.034,48.0,150,175,128,153,113,160,0.83,25,25,47
OceanDNA-b9390,184,1.4,0.0,0.0076,2.3,150,189,526,565,480,576,0.83,39,39,96
OceanDNA-b45222,860,-1.3,0.0,0.05,130.0,159,206,528,576,516,578,0.83,47,48,62
OceanDNA-b40920,956,8.1,0.0,0.00013,0.084,160,187,88,115,82,125,0.83,27,27,43
OceanDNA-b4053,568,10.9,0.0,2.9e-05,0.0069,145,181,115,151,102,174,0.83,36,36,72
OceanDNA-b3337,1561,14.3,0.0,1.8e-06,0.0032,153,189,27,64,8,82,0.83,36,37,74
OceanDNA-b10045,116,10.2,0.0,1.6e-05,0.0069,198,264,615,683,604,685,0.83,66,68,81
OceanDNA-b2796,1858,12.9,0.0,4.9e-06,0.005,158,187,214,243,188,270,0.83,29,29,82
OceanDNA-b37058,112,17.5,0.0,9.2e-08,5.8e-05,130,192,261,325,253,349,0.83,62,64,96
OceanDNA-b27110,284,11.3,0.0,7.3e-06,0.0022,132,175,99,147,41,197,0.83,43,48,156
OceanDNA-b37666,564,17.4,0.0,9.9e-08,7.2e-05,154,180,150,176,130,199,0.83,26,26,69
OceanDNA-b23364,1970,2.1,0.0,0.0093,11.0,172,223,298,350,290,359,0.83,51,52,69
OceanDNA-b31056,401,7.1,0.0,0.00028,0.44,161,198,144,185,120,208,0.83,37,41,88
OceanDNA-b21507,90,3.3,0.0,0.002,0.35,59,82,289,311,274,316,0.83,23,22,42
OceanDNA-b46656,646,14.6,0.1,2.2e-06,0.0025,138,189,224,269,216,278,0.83,51,45,62
OceanDNA-b20726,68,41.5,0.0,4.5e-15,7.5e-13,74,189,81,205,58,211,0.83,115,124,153
OceanDNA-b19689,47,26.8,0.0,1.4e-10,5.5e-08,149,243,124,220,113,231,0.83,94,96,118
OceanDNA-b41349,858,77.4,0.0,1.1e-25,6.5e-23,43,245,36,241,5,271,0.83,202,205,266
OceanDNA-b41687,150,13.0,0.0,2.2e-06,0.00049,199,254,293,348,285,356,0.83,55,55,71
OceanDNA-b2928,1170,0.1,0.0,0.018,22.0,200,224,292,315,279,323,0.83,24,23,44
OceanDNA-b7191,212,10.9,0.0,9.9e-06,0.0043,134,178,102,145,87,156,0.83,44,43,69
OceanDNA-b13250,3720,3.7,0.0,0.016,6.4,158,182,133,157,122,165,0.83,24,24,43
OceanDNA-b32582,919,13.3,0.0,1.8e-06,0.0035,160,187,124,151,98,162,0.83,27,27,64
OceanDNA-b40457,1543,-0.8,0.0,0.036,55.0,158,185,157,184,148,192,0.83,27,27,44
OceanDNA-b1733,3583,17.5,0.1,9.8e-08,0.00035,109,226,136,252,118,268,0.83,117,116,150
OceanDNA-b41152,1030,2.6,0.0,0.0066,7.4,195,218,208,231,182,249,0.83,23,23,67
OceanDNA-b21009,2557,9.3,0.1,2.9e-05,0.095,131,176,655,704,648,717,0.83,45,49,69
OceanDNA-b22891,1048,5.1,0.0,0.00057,1.5,144,170,190,216,157,224,0.83,26,26,67
OceanDNA-b34895,715,8.7,0.0,4.5e-05,0.039,158,187,71,101,58,107,0.83,29,30,49
OceanDNA-b3912,1974,10.1,0.0,5e-05,0.033,134,178,199,237,192,246,0.83,44,38,54
OceanDNA-b1345,2514,5.2,0.0,0.00053,1.5,194,231,224,260,206,280,0.83,37,36,74
OceanDNA-b22830,763,17.4,0.0,2.1e-07,0.00048,154,190,165,202,118,232,0.83,36,37,114
OceanDNA-b30085,540,1.2,0.0,0.026,19.0,203,266,216,277,187,279,0.83,63,61,92
OceanDNA-b41044,1573,12.2,0.3,8.1e-06,0.0074,186,264,179,255,157,256,0.83,78,76,99
OceanDNA-b27549,1961,6.2,0.0,0.00053,0.57,197,264,188,253,180,256,0.83,67,65,76
OceanDNA-b22533,692,41.0,0.0,6.5e-15,8.8e-12,153,245,158,254,147,263,0.83,92,96,116
OceanDNA-b26917,1112,7.5,0.0,0.00021,0.16,161,187,121,147,61,182,0.83,26,26,121
OceanDNA-b41655,231,21.8,0.0,4.8e-09,1.1e-06,88,175,70,161,38,182,0.83,87,91,144
OceanDNA-b40624,141,18.6,0.0,8.7e-08,4.3e-05,154,181,143,170,122,188,0.83,27,27,66
OceanDNA-b30724,1252,11.7,0.0,5.7e-06,0.0097,165,228,239,304,214,317,0.83,63,65,103
OceanDNA-b10080,169,14.0,0.1,2.2e-06,0.0011,145,191,76,123,70,132,0.83,46,47,62
OceanDNA-b10080,169,0.6,0.0,0.026,13.0,195,215,205,225,194,252,0.83,20,20,58
OceanDNA-b44378,1157,17.9,0.0,7e-08,9.1e-05,188,262,328,402,317,406,0.83,74,74,89
OceanDNA-b26737,1207,11.2,0.0,1.6e-05,0.019,156,180,153,177,135,195,0.83,24,24,60
OceanDNA-b27110,284,-3.6,0.0,0.25,77.0,76,89,218,231,213,234,0.83,13,13,21
OceanDNA-b10034,204,-1.4,0.0,0.11,25.0,192,214,211,233,208,244,0.83,22,22,36
OceanDNA-b33525,417,4.1,0.0,0.0012,4.4,194,249,281,333,271,347,0.83,55,52,76
OceanDNA-b26935,170,14.5,0.1,8e-07,0.00021,197,262,329,396,315,401,0.83,65,67,86
OceanDNA-b16127,558,13.4,0.0,3.4e-06,0.0011,151,185,166,200,148,219,0.83,34,34,71
OceanDNA-b16139,377,4.8,0.0,0.0014,0.56,195,223,430,459,421,492,0.83,28,29,71
OceanDNA-b46702,865,24.0,0.0,2e-09,1.8e-06,154,245,235,328,226,335,0.83,91,93,109
OceanDNA-b36415,378,4.1,0.0,0.0024,1.8,197,221,245,269,204,283,0.83,24,24,79
OceanDNA-b12521,140,131.9,0.0,1.4e-42,3.5e-40,55,282,44,286,34,300,0.83,227,242,266
OceanDNA-b37412,308,13.3,0.0,3.7e-06,0.0012,146,180,121,155,97,171,0.83,34,34,74
OceanDNA-b41544,516,4.0,0.0,0.0024,1.3,91,118,68,95,52,104,0.83,27,27,52
OceanDNA-b24965,1753,2.2,0.0,0.0089,8.7,195,218,278,301,236,322,0.83,23,23,86
OceanDNA-b16011,182,10.0,0.1,1.9e-05,0.017,136,185,137,187,66,197,0.83,49,50,131
OceanDNA-b38872,355,7.9,0.0,7.9e-05,0.052,196,267,185,254,175,285,0.83,71,69,110
OceanDNA-b32143,845,14.0,0.0,1.1e-06,0.0022,155,187,213,245,198,275,0.83,32,32,77
OceanDNA-b47071,444,14.1,0.0,2.1e-06,0.00078,146,186,201,241,175,245,0.83,40,40,70
OceanDNA-b11434,237,11.1,0.0,8.7e-06,0.004,142,182,79,119,72,136,0.83,40,40,64
OceanDNA-b34924,232,9.9,0.0,4e-05,0.02,179,247,272,345,266,356,0.83,68,73,90
OceanDNA-b22817,1889,11.2,0.0,1.6e-05,0.033,154,189,135,171,93,209,0.83,35,36,116
OceanDNA-b17743,2586,11.9,0.0,1.5e-05,0.019,142,192,160,210,151,222,0.83,50,50,71
OceanDNA-b33515,675,11.1,0.0,8.6e-06,0.013,151,196,263,309,259,315,0.83,45,46,56
OceanDNA-b23372,2389,10.2,0.0,3.2e-05,0.038,154,186,175,207,163,221,0.83,32,32,58
OceanDNA-b10967,76,12.2,0.0,3.9e-06,0.0014,151,217,148,216,133,241,0.83,66,68,108
OceanDNA-b36415,957,12.3,0.0,7.1e-06,0.0055,127,192,139,204,132,210,0.83,65,65,78
OceanDNA-b32076,1774,16.1,0.0,2.6e-07,0.00082,154,185,162,193,139,201,0.83,31,31,62
OceanDNA-b2513,1391,3.1,0.0,0.0048,3.5,42,77,88,123,71,142,0.83,35,35,71
OceanDNA-b22449,284,14.9,0.0,1.1e-06,0.0009,107,183,144,221,134,240,0.83,76,77,106
OceanDNA-b13482,93,10.3,0.0,1.4e-05,0.0037,146,197,129,182,120,189,0.83,51,53,69
OceanDNA-b32385,103,8.2,0.0,6.4e-05,0.021,183,217,180,215,168,227,0.83,34,35,59
OceanDNA-b32385,103,0.5,0.0,0.015,4.7,161,184,84,107,60,116,0.83,23,23,56
OceanDNA-b13250,797,46.5,0.1,1.4e-15,5.6e-13,109,230,106,226,102,238,0.83,121,120,136
OceanDNA-b1353,1053,-0.1,0.1,0.067,87.0,138,180,37,79,22,93,0.83,42,42,71
OceanDNA-b25087,664,14.2,0.0,9.4e-07,0.00072,74,187,33,151,21,156,0.83,113,118,135
OceanDNA-b27491,217,15.1,0.0,5.1e-07,0.00014,143,203,215,268,184,277,0.83,60,53,93
OceanDNA-b13256,1175,13.3,0.0,1.2e-05,0.0035,146,185,127,165,91,192,0.83,39,38,101
OceanDNA-b44694,1736,12.0,0.0,4.6e-06,0.018,159,180,148,169,126,218,0.83,21,21,92
OceanDNA-b34564,654,12.6,0.0,3e-06,0.0022,140,192,119,172,111,175,0.83,52,53,64
OceanDNA-b11963,1108,41.6,0.4,4.4e-15,8.4e-12,84,243,125,289,114,299,0.83,159,164,185
OceanDNA-b2837,2702,10.9,0.1,9.6e-06,0.03,160,187,72,99,47,104,0.83,27,27,57
OceanDNA-b22827,1232,11.7,0.0,1.1e-05,0.028,152,180,222,250,207,257,0.83,28,28,50
OceanDNA-b14467,90,17.0,0.1,1.4e-07,3.4e-05,109,181,113,184,103,196,0.83,72,71,93
OceanDNA-b26770,298,12.2,0.0,4e-06,0.0058,180,245,710,780,698,785,0.83,65,70,87
OceanDNA-b23093,2393,14.7,0.0,2.1e-06,0.0042,153,233,268,351,207,364,0.83,80,83,157
OceanDNA-b45818,1209,14.4,0.1,4.2e-06,0.0013,92,169,78,155,52,167,0.83,77,77,115
OceanDNA-b2517,40,12.5,0.3,3.1e-06,0.0058,93,183,106,194,101,202,0.83,90,88,101
OceanDNA-b18400,31,12.3,0.0,3.8e-06,0.0015,161,207,98,144,49,150,0.83,46,46,101
OceanDNA-b13204,619,13.7,0.0,1.3e-06,0.0011,140,185,154,199,151,208,0.83,45,45,57
OceanDNA-b32047,264,25.6,0.1,1e-09,1.2e-06,129,202,122,194,57,225,0.83,73,72,168
OceanDNA-b41242,2283,11.8,0.1,5.3e-06,0.018,104,182,58,139,55,142,0.83,78,81,87
OceanDNA-b32786,574,-3.7,0.0,0.81,430.0,94,121,66,93,60,95,0.83,27,27,35
OceanDNA-b10020,371,7.9,0.0,0.00025,0.041,198,264,614,682,595,684,0.83,66,68,89
OceanDNA-b22461,3942,18.9,0.0,1.1e-07,0.00016,153,189,180,217,156,246,0.83,36,37,90
OceanDNA-b18344,110,22.3,0.0,3.3e-09,6.1e-07,151,188,152,190,134,224,0.83,37,38,90
OceanDNA-b38845,39,11.2,0.0,7.9e-06,0.0034,160,185,161,186,133,200,0.83,25,25,67
OceanDNA-b23415,1001,11.1,0.0,8.4e-06,0.018,155,187,209,241,199,250,0.83,32,32,51
OceanDNA-b26387,1475,11.3,0.0,1.4e-05,0.011,52,115,290,357,285,360,0.83,63,67,75
OceanDNA-b35886,286,6.6,0.0,0.0002,0.083,157,187,101,131,88,146,0.83,30,30,58
OceanDNA-b22239,1889,11.1,0.2,8.3e-06,0.018,153,187,156,190,121,198,0.83,34,34,77
OceanDNA-b26769,766,8.1,0.1,0.00014,0.14,196,217,244,265,238,277,0.83,21,21,39
OceanDNA-b10294,774,11.4,0.0,1.4e-05,0.0059,198,265,196,261,188,270,0.83,67,65,82
OceanDNA-b3419,139,-1.7,0.0,0.067,90.0,125,144,209,228,205,246,0.83,19,19,41
OceanDNA-b7477,141,10.7,0.0,2.3e-05,0.0073,229,266,101,139,72,168,0.83,37,38,96
OceanDNA-b46513,159,11.3,0.0,1.5e-05,0.0043,150,193,559,602,543,610,0.83,43,43,67
OceanDNA-a1153,65,2.1,0.0,0.0048,0.75,88,117,66,95,43,102,0.83,29,29,59
OceanDNA-b46722,616,14.4,0.0,2.5e-06,0.0014,153,189,165,202,154,240,0.83,36,37,86
OceanDNA-b9760,691,21.5,0.0,5.9e-09,5.2e-06,75,211,94,241,80,260,0.83,136,147,180
OceanDNA-b20559,114,2.6,0.1,0.0034,1.0,82,121,137,176,126,186,0.83,39,39,60
OceanDNA-b24024,284,7.5,0.0,0.0001,0.3,196,250,610,663,603,681,0.83,54,53,78
OceanDNA-b23055,698,13.8,0.0,2.6e-06,0.00096,135,195,37,95,32,120,0.83,60,58,88
OceanDNA-b38369,741,10.7,0.0,3.3e-05,0.02,109,179,69,135,53,145,0.83,70,66,92
OceanDNA-b34662,91,9.4,0.0,2.7e-05,0.024,89,174,89,171,78,185,0.83,85,82,107
OceanDNA-b38376,1555,77.2,0.2,3e-25,1.5e-22,73,245,67,244,58,289,0.83,172,177,231
OceanDNA-b34551,807,12.6,0.0,9.1e-06,0.0027,140,192,121,174,113,177,0.83,52,53,64
OceanDNA-b20958,2954,11.0,0.0,9.1e-06,0.064,146,175,165,194,149,201,0.83,29,29,52
OceanDNA-b5433,327,146.3,0.0,5.6e-47,2.5e-44,53,282,35,279,23,290,0.83,229,244,267
OceanDNA-b34551,215,13.2,0.0,5.7e-06,0.0017,198,268,617,689,609,694,0.83,70,72,85
OceanDNA-b27525,414,7.7,0.1,0.00037,0.25,151,181,118,148,103,208,0.83,30,30,105
OceanDNA-b23524,154,13.3,0.0,5.4e-06,0.0025,150,190,83,123,69,139,0.83,40,40,70
OceanDNA-b33308,960,12.9,0.0,4.9e-06,0.008,154,184,160,190,144,199,0.83,30,30,55
OceanDNA-b36166,1695,20.1,0.0,1.6e-08,3.5e-05,151,186,138,173,111,178,0.83,35,35,67
OceanDNA-b34275,576,11.9,0.0,9.7e-06,0.0044,142,184,494,538,454,552,0.83,42,44,98
OceanDNA-b23399,1369,12.5,0.4,3.1e-06,0.0073,149,184,131,165,114,223,0.83,35,34,109
OceanDNA-b13091,1267,16.3,0.0,2.2e-07,0.0006,153,215,177,241,165,252,0.83,62,64,87
OceanDNA-b10019,206,6.3,0.0,0.00024,0.12,198,264,615,683,596,684,0.83,66,68,88
OceanDNA-b16224,1390,8.0,0.0,7.4e-05,0.11,84,139,255,304,225,316,0.83,55,49,91
OceanDNA-b46298,1400,-1.9,0.0,0.076,360.0,106,122,251,267,241,273,0.83,16,16,32
OceanDNA-b1749,43,3.3,0.0,0.002,3.8,195,218,211,234,206,268,0.83,23,23,62
OceanDNA-b20922,5902,11.9,0.0,1.5e-05,0.034,142,203,447,509,430,512,0.83,61,62,82
OceanDNA-b2811,1320,1.6,0.0,0.0064,9.7,192,216,343,367,326,376,0.83,24,24,50
OceanDNA-b30217,1058,5.5,0.0,0.00044,1.0,175,246,266,342,254,348,0.83,71,76,94
OceanDNA-b20894,3731,3.1,0.0,0.0046,9.9,160,189,118,148,103,160,0.83,29,30,57
OceanDNA-b3605,1028,6.4,0.0,0.00046,0.45,147,180,136,169,118,181,0.83,33,33,63
OceanDNA-b44515,264,11.1,0.0,8.2e-06,0.0024,151,189,110,148,96,186,0.83,38,38,90
OceanDNA-b20894,1026,5.7,0.0,0.00074,1.6,195,228,250,283,229,291,0.83,33,33,62
OceanDNA-b7494,551,15.5,0.0,3.8e-07,0.00045,94,180,19,101,13,109,0.83,86,82,96
OceanDNA-b34544,56,14.9,0.0,1.2e-06,0.00043,159,186,130,157,89,165,0.83,27,27,76
OceanDNA-b36158,1500,19.9,0.0,3.5e-08,3.3e-05,151,186,163,198,136,203,0.83,35,35,67
OceanDNA-b31120,158,12.9,0.0,7.1e-06,0.0026,110,183,119,193,98,223,0.83,73,74,125
OceanDNA-b31526,1023,14.3,0.0,2.7e-06,0.00092,197,264,51,120,24,121,0.83,67,69,97
OceanDNA-b26298,393,0.8,0.0,0.012,7.5,198,218,276,296,263,315,0.83,20,20,52
OceanDNA-b33096,702,16.2,0.0,7e-07,0.0003,153,181,162,190,142,211,0.83,28,28,69
OceanDNA-b24219,68,-1.8,0.0,0.073,86.0,252,284,282,314,275,320,0.83,32,32,45
OceanDNA-b19701,335,18.9,0.0,1.1e-07,1.5e-05,146,191,22,67,2,88,0.83,45,45,86
OceanDNA-b23634,1508,13.3,0.3,5.4e-06,0.0045,151,186,276,311,256,321,0.83,35,35,65
OceanDNA-a840,382,5.8,0.0,0.00035,0.14,152,185,237,270,218,276,0.83,33,33,58
OceanDNA-b36406,164,12.5,0.0,3.3e-06,0.0035,138,177,159,195,152,212,0.83,39,36,60
OceanDNA-b33290,1244,12.2,0.0,4e-06,0.011,155,180,18,43,6,62,0.83,25,25,56
OceanDNA-b26794,727,11.8,0.0,5e-06,0.012,140,188,80,128,71,138,0.83,48,48,67
OceanDNA-b15137,529,1.5,0.0,0.022,15.0,192,228,181,215,173,241,0.83,36,34,68
OceanDNA-b31170,1207,7.0,0.0,0.00015,0.19,150,177,76,103,34,119,0.83,27,27,85
OceanDNA-b22905,549,14.4,0.0,2.6e-06,0.0024,108,170,188,254,181,264,0.83,62,66,83
OceanDNA-b37510,398,2.4,0.1,0.0076,6.2,199,228,154,183,149,203,0.83,29,29,54
OceanDNA-b33419,741,13.9,0.0,1.2e-06,0.0019,155,182,142,170,116,184,0.83,27,28,68
OceanDNA-b22498,2720,0.5,0.0,0.029,46.0,105,122,168,185,157,189,0.83,17,17,32
OceanDNA-b38518,99,18.8,0.0,4e-08,3.7e-05,148,186,137,175,118,190,0.83,38,38,72
OceanDNA-b12699,83,3.7,0.0,0.0015,0.61,198,232,197,229,179,249,0.83,34,32,70
OceanDNA-b13300,331,0.9,0.0,0.011,17.0,195,227,259,290,246,303,0.83,32,31,57
OceanDNA-b17424,1206,8.7,0.0,8.9e-05,0.079,155,176,214,235,197,242,0.83,21,21,45
OceanDNA-b33315,39,33.6,0.0,1.1e-12,4.9e-09,102,211,131,250,91,300,0.83,109,119,209
OceanDNA-b22615,4797,10.4,0.0,4.3e-05,0.084,153,188,160,196,139,215,0.83,35,36,76
OceanDNA-b41340,879,3.8,0.0,0.0043,2.1,197,218,227,248,219,271,0.83,21,21,52
OceanDNA-b3610,1589,11.4,0.0,7e-06,0.023,84,176,96,187,73,204,0.83,92,91,131
OceanDNA-b23643,1966,-3.2,0.0,0.38,480.0,109,120,32,43,29,45,0.83,11,11,16
OceanDNA-b3676,275,5.7,0.0,0.00037,1.1,161,197,135,175,116,199,0.83,36,40,83
OceanDNA-b22943,3679,12.3,0.0,3.7e-06,0.014,135,180,220,265,195,277,0.83,45,45,82
OceanDNA-b44359,339,6.5,0.0,0.00021,0.25,59,122,63,125,50,148,0.83,63,62,98
OceanDNA-b45437,549,2.8,0.0,0.0029,3.6,105,123,30,48,18,52,0.83,18,18,34
OceanDNA-b43678,719,14.0,0.0,1.1e-06,0.0011,149,191,77,119,50,138,0.83,42,42,88
OceanDNA-b22840,3818,-2.5,0.0,0.35,490.0,212,240,21,49,19,64,0.83,28,28,45
OceanDNA-b6558,462,10.5,0.0,2.5e-05,0.013,153,185,405,437,389,444,0.83,32,32,55
OceanDNA-b22840,3818,7.9,0.1,0.00024,0.33,152,186,199,232,188,240,0.83,34,33,52
OceanDNA-b28718,16,14.7,0.0,6.6e-07,0.00033,153,176,148,171,132,188,0.83,23,23,56
OceanDNA-b37856,208,4.3,0.0,0.001,0.83,56,121,65,129,44,141,0.83,65,64,97
OceanDNA-b4116,368,2.2,0.0,0.0043,2.8,153,180,135,162,123,171,0.83,27,27,48
OceanDNA-b4655,669,10.0,0.0,1.8e-05,0.013,149,189,87,127,60,137,0.83,40,40,77
OceanDNA-b37856,208,6.2,0.0,0.00027,0.22,154,190,183,221,164,237,0.83,36,38,73
OceanDNA-b357,456,22.7,0.1,2.5e-09,1.4e-06,87,190,56,166,27,173,0.83,103,110,146
OceanDNA-b7352,307,13.1,0.0,2.2e-06,0.00072,135,187,114,164,72,172,0.83,52,50,100
OceanDNA-b23165,145,26.9,0.0,1.3e-10,4.1e-07,147,245,214,308,198,316,0.83,98,94,118
OceanDNA-b20495,104,57.0,0.2,9e-20,1.9e-17,69,190,86,212,56,224,0.83,121,126,168
OceanDNA-b3695,832,2.4,0.0,0.0074,6.6,148,179,158,189,145,198,0.83,31,31,53
OceanDNA-b23101,3276,34.2,0.3,7.8e-13,2.6e-09,86,225,177,318,153,324,0.83,139,141,171
OceanDNA-b10371,327,-1.2,0.0,0.047,17.0,157,189,225,257,218,267,0.83,32,32,49
OceanDNA-b22450,341,14.9,0.3,1.2e-06,0.00081,77,175,532,632,528,661,0.83,98,100,133
OceanDNA-b32753,11,10.4,0.0,1.4e-05,0.0065,151,196,214,259,198,274,0.83,45,45,76
OceanDNA-b41998,118,23.8,0.0,1.1e-09,1.9e-07,86,176,69,164,56,192,0.83,90,95,136
OceanDNA-b30021,940,11.4,0.2,6.7e-06,0.012,193,266,204,275,198,277,0.83,73,71,79
OceanDNA-b22922,367,12.5,0.0,6.4e-06,0.0053,153,187,226,259,214,281,0.83,34,33,67
OceanDNA-b12537,160,12.2,0.0,4e-06,0.00097,153,185,35,67,25,78,0.83,32,32,53
OceanDNA-b11625,571,13.7,0.0,1.3e-06,0.0021,136,189,251,305,216,317,0.83,53,54,101
OceanDNA-b20511,29,7.1,0.0,0.00014,0.039,78,121,112,157,88,169,0.83,43,45,81
OceanDNA-b46728,1637,25.1,0.0,1.8e-09,7.6e-07,154,245,197,290,182,299,0.83,91,93,117
OceanDNA-b32709,1359,11.0,0.0,1.8e-05,0.015,134,184,220,264,150,275,0.83,50,44,125
OceanDNA-b35168,500,10.4,0.1,1.4e-05,0.0074,199,266,191,256,178,274,0.82,67,65,96
OceanDNA-b30134,407,9.5,0.2,2.6e-05,0.059,151,185,118,152,88,166,0.82,34,34,78
OceanDNA-b22112,1138,137.2,0.0,3.3e-44,7.5e-41,28,276,47,302,19,317,0.82,248,255,298
OceanDNA-b16227,638,21.2,0.0,2.2e-08,7.7e-06,136,186,139,183,106,228,0.82,50,44,122
OceanDNA-b58,793,-0.0,0.0,0.02,26.0,179,215,301,337,293,351,0.82,36,36,58
OceanDNA-b23817,324,14.7,0.0,1.4e-06,0.0011,150,196,104,151,85,161,0.82,46,47,76
OceanDNA-b20788,524,9.9,0.0,1.9e-05,0.013,141,193,337,389,323,398,0.82,52,52,75
OceanDNA-b22099,382,20.3,0.0,1.3e-08,2.7e-05,153,211,181,241,165,252,0.82,58,60,87
OceanDNA-b20963,4201,16.2,0.5,4.7e-07,0.0016,75,180,223,338,220,351,0.82,105,115,131
OceanDNA-b23394,910,0.8,0.1,0.023,29.0,53,105,295,347,249,356,0.82,52,52,107
OceanDNA-b44435,1547,15.4,0.0,8.3e-07,0.0011,154,184,148,178,122,185,0.82,30,30,63
OceanDNA-b46405,1208,12.0,0.0,4.4e-06,0.0086,144,193,585,632,572,639,0.82,49,47,67
OceanDNA-b46303,3235,23.8,0.0,1.1e-09,4e-06,150,188,176,215,166,237,0.82,38,39,71
OceanDNA-b28262,307,2.2,0.0,0.0044,2.2,160,177,86,103,71,130,0.82,17,17,59
OceanDNA-b3983,883,6.9,0.0,0.00047,0.16,153,181,150,178,133,187,0.82,28,28,54
OceanDNA-a2154,360,12.3,0.0,3.7e-06,0.0015,143,178,107,142,73,158,0.82,35,35,85
OceanDNA-b40225,275,8.2,0.0,6.6e-05,0.026,164,197,182,216,166,222,0.82,33,34,56
OceanDNA-b46594,693,-3.8,0.0,0.3,460.0,40,58,602,620,597,623,0.82,18,18,26
OceanDNA-b15551,1054,1.7,0.0,0.012,13.0,28,73,60,105,36,122,0.82,45,45,86
OceanDNA-b29386,848,17.1,0.0,2.6e-07,0.00025,153,180,476,503,459,525,0.82,27,27,66
OceanDNA-b22398,2836,11.1,0.0,1.7e-05,0.025,153,184,249,280,232,281,0.82,31,31,49
OceanDNA-b3635,2176,12.7,0.0,5.4e-06,0.0071,158,188,143,174,124,186,0.82,30,31,62
OceanDNA-b3653,294,10.8,0.0,4.2e-05,0.024,157,217,40,99,21,119,0.82,60,59,98
OceanDNA-b6769,267,11.3,0.0,7.3e-06,0.0031,186,216,278,308,270,356,0.82,30,30,86
OceanDNA-b10728,419,8.8,0.1,4.3e-05,0.03,201,265,214,276,204,283,0.82,64,62,79
OceanDNA-b30174,1996,6.9,0.0,0.00016,0.34,161,198,206,247,151,262,0.82,37,41,111
OceanDNA-b3605,1028,3.8,0.0,0.0028,2.8,197,243,276,318,256,331,0.82,46,42,75
OceanDNA-b45220,1971,18.2,0.0,5.7e-08,0.00022,128,190,91,147,82,166,0.82,62,56,84
OceanDNA-b23519,427,7.8,0.1,8.4e-05,0.13,161,185,122,146,36,169,0.82,24,24,133
OceanDNA-b45587,130,3.3,0.0,0.002,1.8,195,261,192,255,185,260,0.82,66,63,75
OceanDNA-b22250,1856,8.3,0.0,0.00012,0.19,150,177,146,173,127,185,0.82,27,27,58
OceanDNA-b4488,407,9.9,0.0,4e-05,0.053,194,246,208,259,197,270,0.82,52,51,73
OceanDNA-b27289,163,16.4,0.0,2.1e-07,4.8e-05,150,188,96,132,76,144,0.82,38,36,68
OceanDNA-b10067,117,9.2,0.0,3.2e-05,0.015,198,264,615,683,597,685,0.82,66,68,88
OceanDNA-b41358,957,9.9,0.1,8e-05,0.024,159,185,87,113,10,127,0.82,26,26,117
OceanDNA-b30206,2000,4.9,0.1,0.0013,1.5,161,198,131,172,125,183,0.82,37,41,58
OceanDNA-b16220,635,6.7,0.1,0.00038,0.23,143,173,196,226,186,326,0.82,30,30,140
OceanDNA-b45823,1602,21.1,0.0,1.6e-08,1.4e-05,149,188,426,466,392,472,0.82,39,40,80
OceanDNA-b506,59,13.0,0.0,6.7e-06,0.0043,148,190,131,173,121,181,0.82,42,42,60
OceanDNA-b24117,2173,2.3,0.0,0.0082,11.0,158,180,88,110,79,122,0.82,22,22,43
OceanDNA-b44440,19,12.3,0.0,7.3e-06,0.0088,57,93,57,96,27,100,0.82,36,39,73
OceanDNA-b19805,352,11.2,0.0,7.7e-06,0.003,137,195,147,203,140,209,0.82,58,56,69
OceanDNA-b20988,1849,12.1,0.0,8.1e-06,0.0079,89,185,284,386,249,464,0.82,96,102,215
OceanDNA-b32883,871,22.7,0.0,2.4e-09,4e-06,141,181,133,175,129,193,0.82,40,42,64
OceanDNA-b22840,3847,-1.7,0.0,0.2,290.0,105,122,175,192,165,194,0.82,17,17,29
OceanDNA-b2586,2370,-3.1,0.0,0.18,450.0,183,215,316,348,307,353,0.82,32,32,46
OceanDNA-b211,630,3.0,0.1,0.0048,2.2,197,228,305,336,300,345,0.82,31,31,45
OceanDNA-b30021,940,10.4,0.2,1.4e-05,0.025,161,198,127,168,70,189,0.82,37,41,119
OceanDNA-b2514,271,10.9,0.0,9.8e-06,0.0071,149,180,26,57,14,87,0.82,31,31,73
OceanDNA-b37833,607,18.6,0.0,8.6e-08,4.4e-05,153,180,148,175,126,223,0.82,27,27,97
OceanDNA-b9644,567,12.9,0.0,2.4e-06,0.0019,152,191,595,635,544,646,0.82,39,40,102
OceanDNA-b6750,317,16.6,0.0,5.4e-07,0.00013,84,189,158,265,153,292,0.82,105,107,139
OceanDNA-b20894,3731,10.1,0.1,3.4e-05,0.073,197,254,245,299,232,306,0.82,57,54,74
OceanDNA-b260,485,1.0,0.0,0.03,32.0,151,185,166,200,133,211,0.82,34,34,78
OceanDNA-b34384,466,10.5,0.0,3.9e-05,0.011,159,180,145,166,122,177,0.82,21,21,55
OceanDNA-b35111,5,14.0,0.0,1.1e-06,0.00059,141,182,125,167,112,209,0.82,41,42,97
OceanDNA-b23996,682,-3.8,0.0,0.57,330.0,134,160,373,399,368,402,0.82,26,26,34
OceanDNA-b40473,241,13.2,0.0,5.6e-06,0.002,143,189,108,156,97,181,0.82,46,48,84
OceanDNA-b8078,199,16.2,0.0,2.3e-07,4.9e-05,148,187,164,204,145,232,0.82,39,40,87
OceanDNA-b22226,977,29.3,0.0,4.9e-11,4.2e-08,152,222,162,233,149,260,0.82,70,71,111
OceanDNA-b22226,1447,10.3,0.0,2.9e-05,0.025,152,185,173,206,158,303,0.82,33,33,145
OceanDNA-b20944,992,0.5,0.0,0.014,25.0,197,216,208,227,199,237,0.82,19,19,38
OceanDNA-b46741,194,37.4,0.0,1.7e-13,1.5e-10,153,244,147,241,137,253,0.82,91,94,116
OceanDNA-b15480,240,1.6,0.0,0.013,3.4,158,183,148,174,137,180,0.82,25,26,43
OceanDNA-b2515,845,10.9,0.1,9.8e-06,0.018,160,181,296,317,265,320,0.82,21,21,55
OceanDNA-b20510,60,5.6,0.0,0.00039,0.13,78,121,114,159,90,171,0.82,43,45,81
OceanDNA-b19769,209,28.5,0.0,8.6e-11,2e-08,153,240,137,225,125,248,0.82,87,88,123
OceanDNA-b27525,414,5.5,0.0,0.0017,1.2,198,230,250,282,230,307,0.82,32,32,77
OceanDNA-b36587,1116,5.4,0.0,0.00047,0.83,196,221,278,303,247,316,0.82,25,25,69
OceanDNA-b19690,88,3.9,0.0,0.0026,0.58,88,122,203,237,191,256,0.82,34,34,65
OceanDNA-b20404,296,13.8,0.0,1.3e-06,0.00055,154,194,248,288,223,311,0.82,40,40,88
OceanDNA-b20993,2777,13.2,0.0,2e-06,0.0068,212,273,301,360,269,367,0.82,61,59,98
OceanDNA-b1738,344,0.1,0.0,0.057,69.0,154,187,169,202,151,213,0.82,33,33,62
OceanDNA-b45351,1188,34.8,0.0,5e-13,6.4e-10,151,245,156,253,140,259,0.82,94,97,119
OceanDNA-b22817,460,-0.8,0.0,0.072,150.0,105,122,172,189,157,192,0.82,17,17,35
OceanDNA-b30970,2355,5.2,0.0,0.00054,1.3,229,265,220,257,191,279,0.82,36,37,88
OceanDNA-b16212,559,11.4,0.0,6.8e-06,0.0077,157,185,160,188,130,197,0.82,28,28,67
OceanDNA-b40250,557,14.6,0.0,1.4e-06,0.00051,180,245,283,353,278,357,0.82,65,70,79
OceanDNA-b22220,1,29.1,0.0,5.4e-11,4.7e-08,153,227,83,158,68,181,0.82,74,75,113
OceanDNA-b37527,1378,13.6,0.2,3e-06,0.0035,105,176,83,156,60,168,0.82,71,73,108
OceanDNA-b45647,130,6.2,0.2,0.00026,0.16,156,190,96,130,20,142,0.82,34,34,122
OceanDNA-b260,485,10.1,0.1,5.2e-05,0.057,57,120,45,110,25,114,0.82,63,65,89
OceanDNA-b20595,175,49.8,0.1,1.4e-17,3.7e-15,69,190,91,217,70,225,0.82,121,126,155
OceanDNA-b24609,149,4.8,0.0,0.00069,0.48,189,242,228,278,212,282,0.82,53,50,70
OceanDNA-b46939,472,9.1,0.0,3.5e-05,0.046,157,197,112,152,87,160,0.82,40,40,73
OceanDNA-b46558,138,16.0,0.0,8e-07,0.00017,139,191,39,91,28,109,0.82,52,52,81
OceanDNA-b23984,1143,11.5,0.0,1.3e-05,0.011,105,188,58,140,39,171,0.82,83,82,132
OceanDNA-b36079,214,13.7,0.0,1.3e-06,0.0034,97,161,178,241,168,248,0.82,64,63,80
OceanDNA-b4491,128,15.1,0.0,1e-06,0.00036,142,190,123,172,82,181,0.82,48,49,99
OceanDNA-b11306,47,19.0,0.0,3.3e-08,9.1e-06,151,225,145,220,123,240,0.82,74,75,117
OceanDNA-b34767,147,24.0,0.0,2e-09,9.1e-07,152,189,209,247,192,285,0.82,37,38,93
OceanDNA-b27549,938,17.2,0.1,2.3e-07,0.00025,153,179,340,366,323,379,0.82,26,26,56
OceanDNA-b34263,107,-1.5,0.0,0.12,38.0,197,217,595,615,591,640,0.82,20,20,49
OceanDNA-b30874,184,13.5,0.0,3.3e-06,0.0038,139,180,137,179,127,193,0.82,41,42,66
OceanDNA-b17719,2192,-1.5,0.0,0.06,250.0,195,217,262,284,249,310,0.82,22,22,61
OceanDNA-b37442,373,17.1,0.0,2.6e-07,0.00013,127,191,207,273,202,281,0.82,64,66,79
OceanDNA-b33195,96,13.3,0.0,1.9e-06,0.0013,161,193,117,153,87,167,0.82,32,36,80
OceanDNA-b18118,196,20.1,0.0,1.5e-08,3.1e-06,151,209,55,117,30,125,0.82,58,62,95
OceanDNA-b9096,35,41.6,0.0,8.5e-15,1.5e-12,82,176,131,236,98,246,0.82,94,105,148
OceanDNA-b9096,342,9.2,0.0,6.6e-05,0.011,197,264,286,355,272,358,0.82,67,69,86
OceanDNA-b3129,147,10.2,0.0,1.6e-05,0.0058,150,196,208,255,194,264,0.82,46,47,70
OceanDNA-b2722,200,6.7,0.0,0.00019,0.11,202,264,195,255,187,263,0.82,62,60,76
OceanDNA-b15167,1945,-2.2,0.0,0.19,190.0,198,215,247,265,239,281,0.82,17,18,42
OceanDNA-b37976,273,18.8,0.0,3.7e-08,6.6e-05,139,181,140,184,130,200,0.82,42,44,70
OceanDNA-b32793,1396,6.6,0.0,0.0002,0.67,198,218,209,229,199,256,0.82,20,20,57
OceanDNA-b41320,366,6.8,0.0,0.00017,0.11,161,198,134,175,56,188,0.82,37,41,132
OceanDNA-b41320,366,8.9,0.2,3.8e-05,0.024,193,268,211,284,205,287,0.82,75,73,82
OceanDNA-b20744,16,71.5,0.1,3.4e-24,9.1e-22,53,282,78,334,69,346,0.82,229,256,277
OceanDNA-b43826,61,8.6,0.6,5e-05,0.081,144,183,75,117,34,132,0.82,39,42,98
OceanDNA-b23850,7,5.7,0.0,0.0012,0.57,231,266,229,266,202,271,0.82,35,37,69
OceanDNA-b46558,197,10.9,0.0,2.9e-05,0.006,151,185,136,170,123,175,0.82,34,34,52
OceanDNA-b36411,1312,13.8,0.0,3.8e-06,0.0025,139,180,123,165,111,179,0.82,41,42,68
OceanDNA-b29510,997,32.1,0.3,1.1e-11,8.7e-09,80,180,57,164,41,182,0.82,100,107,141
OceanDNA-b10305,433,13.7,0.0,1.4e-06,0.0006,198,264,343,411,322,412,0.82,66,68,90
OceanDNA-b34299,1271,11.4,0.0,2.7e-05,0.014,105,189,192,276,179,292,0.82,84,84,113
OceanDNA-b34299,271,17.4,0.0,4e-07,0.0002,139,180,124,167,114,179,0.82,41,43,65
OceanDNA-b37060,975,-0.4,0.0,0.028,28.0,198,222,264,287,258,309,0.82,24,23,51
OceanDNA-b17572,742,5.7,0.0,0.00038,0.36,158,190,9,41,2,49,0.82,32,32,47
OceanDNA-b4290,7,14.9,0.0,5.9e-07,0.00014,198,256,116,174,104,186,0.82,58,58,82
OceanDNA-b47081,476,18.1,0.0,1.2e-07,3.5e-05,149,193,250,294,236,305,0.82,44,44,69
OceanDNA-b22946,3695,13.3,0.0,1.8e-06,0.0084,137,179,222,264,210,277,0.82,42,42,67
OceanDNA-b44464,77,17.4,0.0,1e-07,3.8e-05,154,185,140,171,109,184,0.82,31,31,75
OceanDNA-b13269,232,8.2,0.0,6.6e-05,0.064,159,185,198,224,186,229,0.82,26,26,43
OceanDNA-b31685,148,10.9,0.0,2e-05,0.023,130,187,97,153,74,171,0.82,57,56,97
OceanDNA-b40607,496,136.3,0.0,6.2e-44,3.7e-41,62,278,114,346,53,357,0.82,216,232,304
OceanDNA-b1863,352,11.9,0.0,4.8e-06,0.0022,85,175,62,157,32,167,0.82,90,95,135
OceanDNA-b41014,1220,3.2,0.0,0.0063,4.5,195,227,208,239,182,256,0.82,32,31,74
OceanDNA-b15892,186,19.8,0.0,1.9e-08,5.8e-06,105,188,67,149,59,162,0.82,83,82,103
OceanDNA-b23145,1394,-0.4,0.0,0.056,58.0,249,281,269,301,258,306,0.82,32,32,48
OceanDNA-b4256,145,0.4,0.0,0.016,4.1,154,189,149,184,140,194,0.82,35,35,54
OceanDNA-b24935,1054,15.6,0.1,3.6e-07,0.00092,125,192,109,181,90,199,0.82,67,72,109
OceanDNA-b23003,1321,16.7,0.6,8.4e-07,0.00042,27,71,61,108,37,152,0.82,44,47,115
OceanDNA-b35278,403,13.6,0.0,3e-06,0.0012,197,253,589,645,584,653,0.82,56,56,69
OceanDNA-b22074,381,12.1,0.0,4.3e-06,0.0071,40,84,13,58,6,82,0.82,44,45,76
OceanDNA-b13057,271,12.7,0.0,2.7e-06,0.0024,157,181,148,172,136,184,0.82,24,24,48
OceanDNA-b6295,384,12.2,0.0,8e-06,0.0019,198,266,465,535,455,535,0.82,68,70,80
OceanDNA-b29530,932,12.5,0.2,3.1e-06,0.01,152,190,104,143,99,163,0.82,38,39,64
OceanDNA-b24879,657,6.6,0.0,0.00041,0.38,180,218,239,277,232,297,0.82,38,38,65
OceanDNA-b35250,67,14.1,0.0,1e-06,0.00069,197,253,583,639,577,647,0.82,56,56,70
OceanDNA-b27542,1053,12.7,0.0,8.3e-06,0.0061,153,177,146,170,125,185,0.82,24,24,60
OceanDNA-b40947,105,9.3,0.1,6.1e-05,0.024,107,174,135,198,130,214,0.82,67,63,84
OceanDNA-b27523,751,-1.5,0.0,0.11,75.0,196,215,294,313,280,325,0.82,19,19,45
OceanDNA-b41853,159,10.0,0.0,1.9e-05,0.0036,154,215,115,178,107,215,0.82,61,63,108
OceanDNA-b11394,526,12.9,0.0,2.4e-06,0.0016,144,187,76,119,65,132,0.82,43,43,67
OceanDNA-b23088,3754,18.3,0.0,5.5e-08,0.00022,107,194,176,269,167,277,0.82,87,93,110
OceanDNA-b16140,391,0.7,0.0,0.024,11.0,86,121,120,155,112,160,0.82,35,35,48
OceanDNA-b11244,330,17.8,0.0,7.8e-08,2.6e-05,153,196,203,247,191,317,0.82,43,44,126
OceanDNA-a1742,512,13.7,0.0,1.4e-06,0.0014,158,194,41,76,26,83,0.82,36,35,57
OceanDNA-b31304,96,13.6,0.0,1.5e-06,0.0017,149,185,75,111,39,120,0.82,36,36,81
OceanDNA-b22654,724,20.0,0.0,8.5e-08,2.1e-05,153,216,62,127,14,155,0.82,63,65,141
OceanDNA-b22378,1422,12.9,0.0,4.8e-06,0.005,151,189,231,268,220,292,0.82,38,37,72
OceanDNA-b16280,24,18.9,0.0,3.6e-08,9.7e-06,190,251,395,456,372,469,0.82,61,61,97
OceanDNA-b34789,327,16.4,0.0,2e-07,0.00015,138,185,134,182,122,200,0.82,47,48,78
OceanDNA-b5161,252,-0.6,0.0,0.031,8.7,193,216,210,233,204,248,0.82,23,23,44
OceanDNA-b3887,273,17.8,0.0,7.8e-08,6.6e-05,153,215,178,243,153,271,0.82,62,65,118
OceanDNA-b40947,105,2.5,0.0,0.0072,2.9,195,238,296,340,287,347,0.82,43,44,60
OceanDNA-b2829,365,-0.8,0.0,0.11,110.0,197,227,143,173,129,182,0.82,30,30,53
OceanDNA-b24678,261,13.2,0.0,2e-06,0.0019,154,185,145,176,126,189,0.82,31,31,63
OceanDNA-b32856,565,0.9,0.0,0.011,8.2,155,180,72,97,55,106,0.82,25,25,51
OceanDNA-b17743,1373,12.6,0.0,8.9e-06,0.011,153,187,500,534,492,555,0.82,34,34,63
OceanDNA-b3313,1278,17.7,0.3,8.4e-08,0.00025,64,185,96,208,72,214,0.82,121,112,142
OceanDNA-b31464,1668,7.7,0.0,8.9e-05,0.17,161,195,111,149,85,173,0.82,34,38,88
OceanDNA-b4498,474,13.2,0.0,6e-06,0.002,156,188,140,173,128,187,0.82,32,33,59
OceanDNA-b32851,680,19.3,0.3,2.7e-08,2.1e-05,99,189,37,122,14,131,0.82,90,85,117
OceanDNA-b33325,189,12.2,0.1,3.9e-06,0.0063,160,180,147,167,123,179,0.82,20,20,56
OceanDNA-b22905,1224,9.8,0.0,6.3e-05,0.058,150,182,237,269,225,276,0.82,32,32,51
OceanDNA-b27598,443,2.7,0.0,0.006,6.0,148,188,157,198,128,220,0.82,40,41,92
OceanDNA-b17054,10,14.6,0.0,7.1e-07,0.00021,89,131,136,182,128,190,0.82,42,46,62
OceanDNA-b39181,167,14.7,0.0,6.7e-07,0.0003,140,182,135,179,125,190,0.82,42,44,65
OceanDNA-b40617,14,17.1,0.0,2.6e-07,5.4e-05,153,181,146,174,127,192,0.82,28,28,65
OceanDNA-b23556,470,14.7,0.1,1.3e-06,0.0015,159,185,192,218,174,232,0.82,26,26,58
OceanDNA-b36897,631,14.1,0.0,1.1e-06,0.0013,155,184,140,169,124,180,0.82,29,29,56
OceanDNA-b43426,332,11.5,0.0,6.6e-06,0.0026,143,185,94,139,47,157,0.82,42,45,110
OceanDNA-b22858,2614,-1.0,0.0,0.08,140.0,105,122,175,192,164,195,0.82,17,17,31
OceanDNA-b6300,45,9.1,0.0,3.4e-05,0.019,134,182,98,144,22,156,0.82,48,46,134
OceanDNA-b46185,337,6.9,0.0,0.00016,0.26,102,121,172,191,161,194,0.82,19,19,33
OceanDNA-b12085,434,49.5,0.0,1.7e-17,7.9e-15,109,244,86,226,44,243,0.82,135,140,199
OceanDNA-b47035,404,12.1,0.0,1.3e-05,0.0027,153,188,215,251,191,281,0.82,35,36,90
OceanDNA-b33512,2615,13.7,0.1,1.3e-06,0.0054,154,183,164,193,148,206,0.82,29,29,58
OceanDNA-b34918,448,10.4,0.0,4.1e-05,0.014,179,253,313,392,305,442,0.82,74,79,137
OceanDNA-b15286,254,11.7,0.0,1.1e-05,0.0015,151,187,110,146,97,152,0.82,36,36,55
OceanDNA-b38177,705,9.8,0.0,2e-05,0.059,198,265,636,705,625,708,0.82,67,69,83
OceanDNA-b30085,1277,15.3,0.0,1.3e-06,0.00097,154,176,162,184,144,200,0.82,22,22,56
OceanDNA-b23043,1917,12.9,0.2,7e-06,0.009,152,187,66,101,44,104,0.82,35,35,60
OceanDNA-b29,914,15.1,0.0,2.1e-06,0.0026,153,190,113,150,73,187,0.82,37,37,114
OceanDNA-b15108,1673,13.0,0.0,2.2e-06,0.0037,137,198,300,356,291,411,0.82,61,56,120
OceanDNA-b33328,1067,9.1,0.0,7.1e-05,0.041,146,174,21,49,3,73,0.82,28,28,70
OceanDNA-b32141,2161,9.1,0.0,6.8e-05,0.1,157,185,159,187,122,197,0.82,28,28,75
OceanDNA-b14174,315,10.5,0.0,1.3e-05,0.0053,153,212,110,172,87,201,0.82,59,62,114
OceanDNA-b29492,231,3.5,0.0,0.0018,3.2,195,220,193,218,185,256,0.82,25,25,71
OceanDNA-b60,1272,13.9,0.1,1.2e-06,0.0015,77,184,39,146,27,153,0.82,107,107,126
OceanDNA-b3594,247,44.0,0.0,7.8e-16,8.3e-13,86,244,122,286,101,297,0.82,158,164,196
OceanDNA-b5207,24,15.0,0.0,5.7e-07,0.00018,143,181,107,143,22,154,0.82,38,36,132
OceanDNA-b46185,337,1.6,0.0,0.0068,11.0,153,185,261,293,248,304,0.82,32,32,56
OceanDNA-b36648,147,11.4,0.0,6.8e-06,0.0039,196,254,581,639,572,651,0.82,58,58,79
OceanDNA-b37855,698,16.8,0.0,1.5e-07,0.00011,195,262,326,393,320,396,0.82,67,67,76
OceanDNA-b36533,1907,10.0,0.0,1.8e-05,0.044,159,185,173,199,151,208,0.82,26,26,57
OceanDNA-b20708,83,9.4,0.0,2.7e-05,0.0059,140,191,243,300,236,323,0.82,51,57,87
OceanDNA-b11316,235,12.5,0.0,6.4e-06,0.0011,151,232,170,251,147,279,0.82,81,81,132
OceanDNA-b31995,2721,12.0,0.0,4.6e-06,0.015,106,184,126,207,100,213,0.82,78,81,113
OceanDNA-b23634,108,5.5,0.0,0.0013,1.1,150,179,129,158,116,171,0.82,29,29,55
OceanDNA-b26571,659,16.7,0.0,3.4e-07,0.00014,75,187,34,151,25,156,0.82,112,117,131
OceanDNA-b22114,761,11.1,0.1,8.2e-06,0.021,147,185,59,97,47,111,0.82,38,38,64
OceanDNA-b36405,186,14.6,0.0,7.2e-07,0.00031,158,185,144,171,121,209,0.82,27,27,88
OceanDNA-b10045,116,3.8,0.0,0.0014,0.64,152,189,534,571,517,582,0.82,37,37,65
OceanDNA-b46534,918,17.1,0.0,1.2e-07,0.00018,138,185,123,168,113,182,0.82,47,45,69
OceanDNA-b22613,197,10.4,0.0,1.4e-05,0.047,143,185,272,314,264,331,0.82,42,42,67
OceanDNA-b36771,228,4.8,0.0,0.00071,0.79,90,121,137,168,124,188,0.82,31,31,64
OceanDNA-b39196,629,17.0,0.0,1.4e-07,0.0001,140,181,141,184,136,199,0.82,41,43,63
OceanDNA-b11387,576,2.8,0.0,0.0056,1.7,86,121,186,221,176,228,0.82,35,35,52
OceanDNA-b22383,761,11.5,0.0,2.6e-05,0.022,135,176,241,276,231,287,0.82,41,35,56
OceanDNA-b21364,347,4.5,0.1,0.00088,0.62,143,178,112,147,96,166,0.82,35,35,70
OceanDNA-b40755,73,4.7,0.0,0.00076,0.49,194,224,286,318,270,325,0.82,30,32,55
OceanDNA-b36456,1321,5.9,0.0,0.00033,0.72,195,220,275,300,236,313,0.82,25,25,77
OceanDNA-b7018,34,3.8,0.0,0.0014,0.56,152,189,529,566,516,577,0.82,37,37,61
OceanDNA-b30483,397,11.0,0.2,9.1e-06,0.022,159,199,109,153,57,187,0.82,40,44,130
OceanDNA-b22842,3424,14.5,0.0,1.5e-06,0.0035,151,211,550,615,509,624,0.82,60,65,115
OceanDNA-b10398,161,9.9,0.0,2e-05,0.005,197,264,166,235,159,237,0.82,67,69,78
OceanDNA-b22842,1272,3.7,0.1,0.0031,7.1,197,219,377,399,367,413,0.82,22,22,46
OceanDNA-b310,562,15.2,0.1,9.9e-07,0.00072,152,186,142,176,123,208,0.82,34,34,85
OceanDNA-b23455,677,10.4,0.0,1.4e-05,0.033,149,180,166,198,155,214,0.82,31,32,59
OceanDNA-b35112,242,14.4,0.0,1.7e-06,0.0009,153,191,203,242,186,269,0.82,38,39,83
OceanDNA-b4489,579,12.4,0.0,3.4e-06,0.0021,156,185,63,92,43,99,0.82,29,29,56
OceanDNA-b34630,460,12.7,0.0,5.5e-06,0.0026,139,181,170,213,157,225,0.82,42,43,68
OceanDNA-b40755,73,3.6,0.0,0.0017,1.1,146,175,158,187,148,195,0.82,29,29,47
OceanDNA-b21018,732,7.8,0.0,8.5e-05,0.29,157,181,144,168,108,177,0.82,24,24,69
OceanDNA-b46641,1672,-0.3,0.0,0.025,49.0,199,224,181,206,177,228,0.82,25,25,51
OceanDNA-b4297,78,8.6,0.0,5e-05,0.014,198,264,600,668,593,670,0.82,66,68,77
OceanDNA-b4249,812,12.6,0.0,2.9e-06,0.0041,193,265,199,269,190,274,0.82,72,70,84
OceanDNA-b6781,378,14.8,0.0,6.4e-07,0.00033,187,219,268,300,262,341,0.82,32,32,79
OceanDNA-b24040,1710,8.4,0.0,5.6e-05,0.099,174,245,59,135,54,142,0.82,71,76,88
OceanDNA-b23038,420,12.2,0.0,3.9e-06,0.0093,136,193,556,611,551,618,0.82,57,55,67
OceanDNA-b44359,339,4.8,0.1,0.00069,0.85,152,180,176,205,156,212,0.82,28,29,56
OceanDNA-b1522,444,2.5,0.1,0.011,3.7,146,188,135,177,131,186,0.82,42,42,55
OceanDNA-b7010,63,3.9,0.0,0.0027,0.56,152,189,529,566,516,577,0.82,37,37,61
OceanDNA-b4027,527,22.5,0.0,2.8e-09,2.3e-06,102,212,133,253,99,289,0.82,110,120,190
OceanDNA-b23379,895,12.8,0.0,5.3e-06,0.006,151,188,328,366,313,375,0.82,37,38,62
OceanDNA-b259,1119,18.3,0.1,5.4e-08,7.7e-05,70,211,85,237,73,247,0.82,141,152,174
OceanDNA-b16117,600,6.9,0.0,0.00032,0.12,187,228,217,257,205,281,0.82,41,40,76
OceanDNA-b26781,497,7.7,0.1,0.00018,0.15,187,229,277,321,255,326,0.82,42,44,71
OceanDNA-b3242,329,4.4,0.0,0.00093,0.77,196,245,253,302,243,313,0.82,49,49,70
OceanDNA-b29389,999,2.7,0.0,0.0032,7.3,154,179,174,199,159,212,0.82,25,25,53
OceanDNA-b32721,2142,14.6,0.0,1.4e-06,0.0016,155,203,1,49,1,95,0.82,48,48,94
OceanDNA-b39756,146,-1.6,0.0,0.19,26.0,88,118,186,216,178,223,0.82,30,30,45
OceanDNA-b15188,166,10.9,0.0,9.6e-06,0.0021,148,182,86,119,76,127,0.82,34,33,51
OceanDNA-b46252,1757,16.1,0.0,1.1e-06,0.0006,148,187,164,204,148,209,0.82,39,40,61
OceanDNA-b6759,143,12.0,0.0,8.9e-06,0.0032,132,189,127,178,91,186,0.82,57,51,95
OceanDNA-b30640,764,-3.1,0.0,0.55,230.0,187,215,58,85,57,90,0.82,28,27,33
OceanDNA-b23143,876,30.0,0.0,3e-11,4e-08,145,244,231,326,209,335,0.82,99,95,126
OceanDNA-b8217,164,12.3,0.0,3.6e-06,0.00088,135,186,109,158,102,170,0.82,51,49,68
OceanDNA-b46252,556,3.4,0.0,0.0075,4.3,101,118,173,190,148,207,0.82,17,17,59
OceanDNA-b46252,556,10.6,0.0,4.8e-05,0.027,150,190,238,278,222,291,0.82,40,40,69
OceanDNA-b22872,1278,11.7,0.0,1.1e-05,0.017,153,187,263,296,250,317,0.82,34,33,67
OceanDNA-b29389,999,8.2,0.0,6.3e-05,0.14,167,229,268,332,249,353,0.82,62,64,104
OceanDNA-b23655,661,5.3,0.0,0.001,0.94,149,180,135,166,107,176,0.82,31,31,69
OceanDNA-b25052,124,1.1,0.0,0.018,9.4,195,215,204,224,178,242,0.82,20,20,64
OceanDNA-b3980,783,16.6,0.0,3.6e-07,0.00022,147,184,55,92,31,102,0.82,37,37,71
OceanDNA-b15902,887,10.8,0.1,1e-05,0.011,153,186,92,125,60,133,0.82,33,33,73
OceanDNA-b36402,186,13.0,0.1,2.2e-06,0.0015,153,188,163,200,150,210,0.82,35,37,60
OceanDNA-b45059,186,2.0,0.0,0.0049,3.2,181,214,176,211,163,240,0.82,33,35,77
OceanDNA-b6771,803,15.4,0.0,1.7e-06,0.00039,152,232,125,209,118,227,0.82,80,84,109
OceanDNA-b30162,1755,11.2,0.1,7.7e-06,0.019,144,184,80,120,60,128,0.82,40,40,68
OceanDNA-b13299,1029,13.1,0.0,4.2e-06,0.0023,138,185,211,252,188,260,0.82,47,41,72
OceanDNA-b31504,233,12.5,0.0,3.1e-06,0.0014,195,245,245,293,223,314,0.82,50,48,91
OceanDNA-b14149,56,-1.3,0.0,0.051,24.0,162,178,199,215,194,218,0.82,16,16,24
OceanDNA-b8783,80,-2.3,0.0,0.11,19.0,79,104,22,47,19,56,0.81,25,25,37
OceanDNA-b3684,19,10.2,0.0,1.5e-05,0.019,174,229,195,250,191,281,0.81,55,55,90
OceanDNA-b45796,2024,23.1,0.0,1.9e-09,4.3e-06,152,220,154,223,140,251,0.81,68,69,111
OceanDNA-b24095,2665,10.7,0.1,1.1e-05,0.043,153,184,142,173,120,189,0.81,31,31,69
OceanDNA-b42626,228,1.5,0.0,0.0069,1.7,152,180,83,111,69,121,0.81,28,28,52
OceanDNA-b30238,288,4.6,0.1,0.0008,1.6,200,264,201,263,190,268,0.81,64,62,78
OceanDNA-b22397,559,14.7,0.0,2.7e-06,0.0018,150,182,259,293,240,301,0.81,32,34,61
OceanDNA-b34918,94,9.9,0.0,5.7e-05,0.02,124,184,51,112,45,133,0.81,60,61,88
OceanDNA-b46581,1131,11.7,0.0,1.1e-05,0.0088,132,179,235,276,227,284,0.81,47,41,57
OceanDNA-b7184,483,22.7,0.0,4.8e-09,1.2e-06,95,212,110,237,55,274,0.81,117,127,219
OceanDNA-b37747,985,18.1,0.0,6.2e-08,6.2e-05,140,184,134,181,128,196,0.81,44,47,68
OceanDNA-b33192,357,15.6,0.0,7.2e-07,0.00016,124,192,110,172,27,178,0.81,68,62,151
OceanDNA-b22377,1876,23.3,0.0,3.2e-09,3.6e-06,152,214,195,259,173,270,0.81,62,64,97
OceanDNA-b38572,538,17.9,0.0,7.1e-08,4e-05,77,188,27,142,19,154,0.81,111,115,135
OceanDNA-b28040,422,4.2,0.1,0.0011,0.69,153,187,135,170,120,191,0.81,34,35,71
OceanDNA-b11842,884,44.5,0.1,5.8e-16,7.1e-13,94,243,89,242,80,255,0.81,149,153,175
OceanDNA-b6750,437,13.8,0.0,3.9e-06,0.00095,197,268,134,203,123,243,0.81,71,69,120
OceanDNA-b31981,881,15.4,0.0,8.1e-07,0.00095,162,214,141,196,135,244,0.81,52,55,109
OceanDNA-b23819,1158,11.0,0.1,1.9e-05,0.016,147,189,118,159,99,205,0.81,42,41,106
OceanDNA-b1820,904,17.7,0.2,1.6e-07,0.00018,80,187,19,126,3,143,0.81,107,107,140
OceanDNA-b7194,460,8.7,0.0,0.00018,0.038,194,255,212,270,200,291,0.81,61,58,91
OceanDNA-b44662,1421,22.1,1.1,7.5e-09,1e-05,90,181,583,680,579,690,0.81,91,97,111
OceanDNA-b22253,489,10.0,0.0,1.9e-05,0.032,145,183,31,70,23,82,0.81,38,39,59
OceanDNA-b45059,186,10.5,0.0,1.3e-05,0.0087,90,189,34,131,28,147,0.81,99,97,119
OceanDNA-b23043,2176,11.0,0.1,2.7e-05,0.035,10,122,58,173,51,191,0.81,112,115,140
OceanDNA-b34299,818,5.6,0.0,0.0016,0.79,153,188,141,177,96,191,0.81,35,36,95
OceanDNA-b19701,291,-2.9,0.0,0.47,64.0,87,118,223,254,218,259,0.81,31,31,41
OceanDNA-b10305,433,3.5,0.0,0.0017,0.75,152,189,262,299,243,310,0.81,37,37,67
OceanDNA-b12280,47,33.6,0.0,1.2e-12,4.8e-10,159,241,146,232,117,246,0.81,82,86,129
OceanDNA-b20962,1837,18.8,0.8,3.9e-08,0.0002,91,180,398,494,373,500,0.81,89,96,127
OceanDNA-b20991,1080,13.8,0.0,3.9e-06,0.0025,153,243,254,354,234,368,0.81,90,100,134
OceanDNA-b3564,323,11.8,0.0,1e-05,0.0029,161,193,108,141,103,158,0.81,32,33,55
OceanDNA-b30031,2048,3.8,0.0,0.0029,3.2,156,181,65,90,51,129,0.81,25,25,78
OceanDNA-b28098,354,19.8,0.0,1.8e-08,2.9e-05,141,180,125,166,121,179,0.81,39,41,58
OceanDNA-b28166,2674,11.9,0.0,4.8e-06,0.013,166,232,229,297,215,321,0.81,66,68,106
OceanDNA-b20988,1339,11.8,0.0,1.1e-05,0.01,138,182,630,674,624,678,0.81,44,44,54
OceanDNA-b19130,5,8.2,0.0,0.00013,0.028,85,122,205,242,197,262,0.81,37,37,65
OceanDNA-b2829,55,-1.4,0.0,0.16,170.0,149,171,93,115,81,137,0.81,22,22,56
OceanDNA-b260,485,-3.1,0.0,0.54,600.0,197,211,271,285,252,289,0.81,14,14,37
OceanDNA-b10371,327,10.6,0.1,1.2e-05,0.0046,198,263,301,368,292,369,0.81,65,67,77
OceanDNA-b2854,2986,11.2,0.0,2.3e-05,0.027,155,186,112,143,63,171,0.81,31,31,108
OceanDNA-b33104,283,12.6,0.0,2.9e-06,0.0095,77,176,75,180,65,187,0.81,99,105,122
OceanDNA-b11388,59,11.2,0.0,8e-06,0.0048,144,184,83,123,75,133,0.81,40,40,58
OceanDNA-b20979,1809,29.8,0.0,1.7e-11,4.3e-08,71,185,209,324,193,371,0.81,114,115,178
OceanDNA-b22926,1352,1.5,0.0,0.014,32.0,201,264,280,343,275,347,0.81,63,63,72
OceanDNA-b260,690,11.8,0.1,1.6e-05,0.017,96,177,192,271,179,290,0.81,81,79,111
OceanDNA-b46222,1352,11.6,0.0,1.2e-05,0.0095,160,197,126,163,113,168,0.81,37,37,55
OceanDNA-b19130,353,19.5,0.0,4.8e-08,1.1e-05,141,188,118,164,87,197,0.81,47,46,110
OceanDNA-b6259,3,22.0,0.0,4.1e-09,5.3e-06,86,188,147,252,141,258,0.81,102,105,117
OceanDNA-b3681,100,8.3,0.0,6e-05,0.089,201,265,207,269,193,275,0.81,64,62,82
OceanDNA-b20922,2978,6.5,0.0,0.00063,1.5,221,267,214,259,188,263,0.81,46,45,75
OceanDNA-b27598,1848,11.2,0.0,1.6e-05,0.016,50,107,18,72,4,93,0.81,57,54,89
OceanDNA-b45862,19,11.1,0.0,8.5e-06,0.0023,96,174,83,159,39,203,0.81,78,76,164
OceanDNA-b22850,2445,16.2,0.0,4.7e-07,0.00066,150,181,323,354,303,373,0.81,31,31,70
OceanDNA-b22256,248,19.7,0.0,2.1e-08,4e-05,152,187,152,188,131,260,0.81,35,36,129
OceanDNA-b36862,909,-0.0,0.0,0.042,24.0,197,238,147,188,120,207,0.81,41,41,87
OceanDNA-b46972,580,15.5,0.0,7.6e-07,0.00029,154,189,234,270,218,303,0.81,35,36,85
OceanDNA-b17731,783,6.5,0.0,0.00022,0.73,152,176,136,160,114,166,0.81,24,24,52
OceanDNA-b27525,1050,9.2,0.0,0.00013,0.085,174,245,335,411,323,423,0.81,71,76,100
OceanDNA-b10097,427,11.5,0.0,6.3e-06,0.0057,81,173,55,150,28,160,0.81,92,95,132
OceanDNA-b30,835,10.0,0.1,3.5e-05,0.065,146,180,188,222,161,231,0.81,34,34,70
OceanDNA-b38376,703,5.4,0.0,0.0022,1.1,149,187,144,182,114,191,0.81,38,38,77
OceanDNA-b23175,3987,14.5,0.0,1.6e-06,0.0057,89,191,103,199,92,207,0.81,102,96,115
OceanDNA-b36402,186,-3.0,0.1,0.17,120.0,167,181,19,33,16,40,0.81,14,14,24
OceanDNA-b12512,193,32.0,0.0,3.6e-12,1.1e-09,159,244,152,240,129,254,0.81,85,88,125
OceanDNA-b20902,2959,1.6,0.0,0.0067,28.0,168,203,36,71,13,87,0.81,35,35,74
OceanDNA-b7211,963,11.3,0.0,7.4e-06,0.0073,154,212,171,234,156,266,0.81,58,63,110
OceanDNA-b34187,445,13.4,0.2,1.7e-06,0.00075,64,135,38,111,27,192,0.81,71,73,165
OceanDNA-b23005,190,41.8,0.1,3.8e-15,1.3e-11,47,243,195,410,190,415,0.81,196,215,225
OceanDNA-b27522,1516,9.3,0.0,3e-05,0.058,136,181,28,70,5,79,0.81,45,42,74
OceanDNA-b17743,2586,-2.7,0.0,0.39,500.0,222,234,279,291,269,296,0.81,12,12,27
OceanDNA-b41267,1339,-2.3,0.0,0.1,310.0,195,214,273,292,239,299,0.81,19,19,60
OceanDNA-b6424,614,66.4,0.0,3.7e-22,7.6e-20,49,159,39,154,6,155,0.81,110,115,149
OceanDNA-b6424,505,0.0,0.0,0.06,12.0,189,215,163,189,148,202,0.81,26,26,54
OceanDNA-b40641,953,148.3,0.1,5.5e-47,1.8e-44,59,286,106,348,45,354,0.81,227,242,309
OceanDNA-b35035,642,10.9,0.0,2e-05,0.0077,145,181,67,103,41,120,0.81,36,36,79
OceanDNA-b18642,124,27.2,0.0,1.1e-10,3.8e-08,151,186,130,166,95,192,0.81,35,36,97
OceanDNA-b45663,568,8.9,0.0,7.8e-05,0.034,196,261,184,246,179,250,0.81,65,62,71
OceanDNA-b24073,156,4.0,0.0,0.0012,1.1,28,72,29,73,2,87,0.81,44,44,85
OceanDNA-b37356,779,6.3,0.0,0.00025,0.44,192,235,283,325,264,337,0.81,43,42,73
OceanDNA-b40474,364,12.3,0.0,7.5e-06,0.0037,143,189,108,156,96,183,0.81,46,48,87
OceanDNA-b19769,45,0.4,0.0,0.03,7.1,88,120,205,237,197,257,0.81,32,32,60
OceanDNA-b3717,1233,25.9,0.0,2.6e-10,3.6e-07,152,245,141,237,121,255,0.81,93,96,134
OceanDNA-b34949,338,-0.5,0.0,0.086,28.0,159,188,123,151,97,158,0.81,29,28,61
OceanDNA-b9761,970,18.4,0.0,4.9e-08,5.2e-05,75,211,94,241,77,262,0.81,136,147,185
OceanDNA-b39756,146,10.0,0.0,5.6e-05,0.0078,131,173,293,336,281,371,0.81,42,43,90
OceanDNA-b4494,996,26.9,0.0,2.5e-10,1.5e-07,103,193,146,242,135,251,0.81,90,96,116
OceanDNA-b29506,1769,21.2,0.7,7e-09,2.3e-05,94,180,102,192,90,198,0.81,86,90,108
OceanDNA-b3956,990,8.6,0.0,4.8e-05,0.05,198,267,192,259,182,265,0.81,69,67,83
OceanDNA-b25052,818,10.1,0.0,3.5e-05,0.018,194,250,333,387,327,403,0.81,56,54,76
OceanDNA-b40444,469,17.4,0.0,4.1e-07,0.00019,140,183,128,172,122,182,0.81,43,44,60
OceanDNA-b26769,728,11.7,0.0,1.1e-05,0.011,102,211,130,249,45,255,0.81,109,119,210
OceanDNA-b1435,542,-0.3,0.0,0.073,20.0,198,229,256,286,250,292,0.81,31,30,42
OceanDNA-b20944,992,11.9,0.0,4.9e-06,0.0086,147,183,90,126,77,148,0.81,36,36,71
OceanDNA-b13990,392,10.8,0.0,1e-05,0.0047,97,176,157,242,115,255,0.81,79,85,140
OceanDNA-b496,923,6.0,0.0,0.00061,0.79,194,226,232,263,225,280,0.81,32,31,55
OceanDNA-b496,1153,11.6,0.0,1.2e-05,0.015,150,185,86,122,74,128,0.81,35,36,54
OceanDNA-b3643,751,-1.4,0.0,0.053,46.0,190,218,201,229,192,242,0.81,28,28,50
OceanDNA-b26781,497,6.7,0.1,0.00037,0.32,156,185,162,191,149,201,0.81,29,29,52
OceanDNA-b22862,2207,12.5,0.1,3.1e-06,0.011,153,214,174,237,163,266,0.81,61,63,103
OceanDNA-b42293,157,10.4,0.0,1.4e-05,0.0028,153,222,96,168,83,185,0.81,69,72,102
OceanDNA-b29503,212,18.0,0.0,1.3e-07,0.00026,153,179,145,171,127,207,0.81,26,26,80
OceanDNA-b7010,63,8.0,0.0,0.00014,0.03,198,264,610,678,589,679,0.81,66,68,90
OceanDNA-b34949,622,15.7,0.0,9.9e-07,0.00032,140,182,130,173,123,191,0.81,42,43,68
OceanDNA-b30149,3169,11.4,0.8,7e-06,0.024,141,180,263,302,241,308,0.81,39,39,67
OceanDNA-b9977,293,14.9,0.0,5.9e-07,0.00022,102,211,123,242,107,250,0.81,109,119,143
OceanDNA-b45813,470,18.2,0.0,5.7e-08,6.4e-05,152,192,206,246,170,256,0.81,40,40,86
OceanDNA-b3695,832,20.4,0.0,2.4e-08,2.2e-05,192,247,283,336,272,354,0.81,55,53,82
OceanDNA-b62,258,12.2,0.0,3.9e-06,0.0018,157,185,178,206,162,211,0.81,28,28,49
OceanDNA-b16222,285,5.4,0.0,0.00046,0.77,197,245,243,288,228,306,0.81,48,45,78
OceanDNA-b31326,125,17.9,0.0,7.2e-08,1.6e-05,165,254,6,99,2,106,0.81,89,93,104
OceanDNA-b8277,70,12.2,0.0,4e-06,0.00081,160,233,121,196,109,212,0.81,73,75,103
OceanDNA-b11234,311,29.3,0.0,2.4e-11,1.1e-08,151,228,143,221,110,239,0.81,77,78,129
OceanDNA-b45233,797,-2.2,0.0,0.19,140.0,199,223,244,267,228,287,0.81,24,23,59
OceanDNA-b27615,747,11.5,0.1,6.4e-06,0.026,142,176,23,56,10,71,0.81,34,33,61
OceanDNA-b16229,52,37.9,0.0,1.8e-13,7.8e-11,77,177,248,367,188,376,0.81,100,119,188
OceanDNA-b46725,44,26.6,0.0,3.3e-10,3.5e-07,154,245,251,344,241,353,0.81,91,93,112
OceanDNA-b36755,104,7.2,0.0,0.00027,0.5,147,178,79,113,70,125,0.81,31,34,55
OceanDNA-b3865,332,18.4,0.0,5e-08,1.7e-05,154,233,146,230,123,245,0.81,79,84,122
OceanDNA-b26639,931,9.3,0.0,2.9e-05,0.04,147,181,82,118,70,154,0.81,34,36,84
OceanDNA-b46829,980,10.1,0.0,1.7e-05,0.033,96,169,527,598,473,605,0.81,73,71,132
OceanDNA-b40853,487,146.2,0.0,6e-47,4.6e-44,68,278,68,294,3,305,0.81,210,226,302
OceanDNA-b36934,678,31.3,0.1,6.1e-12,6.1e-09,84,172,190,289,168,303,0.81,88,99,135
OceanDNA-b44612,1129,1.9,0.1,0.0054,14.0,152,176,500,524,443,539,0.81,24,24,96
OceanDNA-b23643,888,15.2,0.0,9.8e-07,0.0012,140,193,106,159,85,169,0.81,53,53,84
OceanDNA-b36730,1280,16.3,0.0,4.4e-07,0.00072,154,194,609,653,601,661,0.81,40,44,60
OceanDNA-b46733,84,14.9,0.0,6.1e-07,0.0011,154,190,136,173,123,234,0.81,36,37,111
OceanDNA-b46224,424,10.4,0.0,2.8e-05,0.015,153,195,258,301,242,306,0.81,42,43,64
OceanDNA-b17731,783,1.9,0.0,0.0054,18.0,180,217,256,293,250,322,0.81,37,37,72
OceanDNA-b30641,995,8.9,0.2,7.7e-05,0.041,200,266,232,296,221,299,0.81,66,64,78
OceanDNA-b41358,206,7.2,0.0,0.00053,0.16,193,218,325,350,313,382,0.81,25,25,69
OceanDNA-b3654,348,9.5,0.0,2.6e-05,0.033,175,247,280,358,268,380,0.81,72,78,112
OceanDNA-b34879,249,13.1,0.0,2e-06,0.0019,139,178,132,172,126,187,0.81,39,40,61
OceanDNA-b23148,1734,14.2,0.0,2e-06,0.0026,142,188,158,204,149,219,0.81,46,46,70
OceanDNA-b19607,22,25.6,0.0,3.1e-10,9.7e-08,153,236,138,222,128,238,0.81,83,84,110
OceanDNA-b23312,2294,-1.0,0.0,0.041,110.0,68,83,77,92,65,110,0.81,15,15,45
OceanDNA-b32147,483,10.5,0.0,1.3e-05,0.035,140,185,160,203,144,211,0.81,45,43,67
OceanDNA-b15450,1537,0.8,0.1,0.024,25.0,158,177,109,128,86,140,0.81,19,19,54
OceanDNA-b9797,260,7.2,0.0,0.00013,0.064,192,220,212,240,199,259,0.81,28,28,60
OceanDNA-b22517,2947,36.1,0.0,4.2e-13,6.9e-10,153,249,189,289,176,294,0.81,96,100,118
OceanDNA-b9784,894,11.0,0.0,2.7e-05,0.011,192,237,7,49,1,82,0.81,45,42,81
OceanDNA-b19825,42,29.9,0.0,1.6e-11,7.8e-09,153,223,156,228,140,248,0.81,70,72,108
OceanDNA-b45014,133,-0.7,0.0,0.034,24.0,196,219,221,244,215,282,0.81,23,23,67
OceanDNA-b37298,671,12.7,0.0,5.4e-06,0.0026,197,245,241,287,214,306,0.81,48,46,92
OceanDNA-b44,2537,9.5,0.0,7.5e-05,0.19,195,228,201,233,193,263,0.81,33,32,70
OceanDNA-b4060,640,15.6,0.0,7e-07,0.00028,156,190,154,189,110,199,0.81,34,35,89
OceanDNA-b13256,114,38.3,0.0,3.2e-13,8.9e-11,49,226,97,276,63,296,0.81,177,179,233
OceanDNA-b6569,486,10.1,0.0,3.5e-05,0.015,196,265,189,256,159,266,0.81,69,67,107
OceanDNA-b22249,621,2.6,0.0,0.0033,10.0,191,232,264,303,245,325,0.81,41,39,80
OceanDNA-b6569,149,11.4,0.0,1.3e-05,0.0059,198,265,668,737,659,741,0.81,67,69,82
OceanDNA-b22250,1856,0.2,0.0,0.034,54.0,200,245,266,313,261,320,0.81,45,47,59
OceanDNA-b39392,712,23.7,0.0,1.2e-09,1e-06,153,180,141,168,115,193,0.81,27,27,78
OceanDNA-b23287,922,10.4,1.0,1.4e-05,0.035,149,187,209,250,204,254,0.81,38,41,50
OceanDNA-b22314,123,10.7,0.0,1.1e-05,0.052,150,182,104,136,90,149,0.81,32,32,59
OceanDNA-b9171,380,20.1,0.0,1.6e-08,6.5e-06,158,197,114,154,95,159,0.81,39,40,64
OceanDNA-b20703,336,2.5,0.0,0.0034,1.3,86,121,141,176,134,183,0.81,35,35,49
OceanDNA-b45612,488,2.9,0.0,0.0027,1.4,198,218,266,286,239,319,0.81,20,20,80
OceanDNA-b7699,41,20.3,0.0,1.3e-08,4.2e-06,150,215,135,203,115,221,0.81,65,68,106
OceanDNA-b16039,280,10.1,0.0,1.7e-05,0.021,76,118,274,317,203,340,0.81,42,43,137
OceanDNA-b30216,630,3.9,0.1,0.0013,2.7,199,264,403,466,391,471,0.81,65,63,80
OceanDNA-b35160,65,12.6,0.0,2.9e-06,0.0019,154,184,164,194,145,217,0.81,30,30,72
OceanDNA-b23484,982,5.5,0.0,0.00085,0.74,183,247,225,285,217,305,0.81,64,60,88
OceanDNA-b14324,393,-2.2,0.0,0.093,47.0,154,189,118,153,112,163,0.81,35,35,51
OceanDNA-b22378,991,2.5,0.0,0.0069,7.1,201,264,245,308,230,314,0.81,63,63,84
OceanDNA-b3337,2399,9.8,0.0,4.1e-05,0.073,86,122,187,224,177,239,0.81,36,37,62
OceanDNA-b17082,426,5.5,0.0,0.00043,0.7,198,247,232,277,222,289,0.81,49,45,67
OceanDNA-b17082,426,3.9,0.0,0.0013,2.2,160,189,100,130,93,169,0.81,29,30,76
OceanDNA-b30852,157,11.0,0.0,1.8e-05,0.018,139,184,98,141,51,165,0.81,45,43,114
OceanDNA-b3337,2399,1.9,0.0,0.011,20.0,157,174,326,343,293,365,0.81,17,17,72
OceanDNA-b22893,2192,1.8,0.1,0.017,13.0,38,81,139,182,112,190,0.81,43,43,78
OceanDNA-b35935,1408,6.9,0.0,0.00016,0.43,196,245,214,259,191,268,0.81,49,45,77
OceanDNA-b15551,1054,14.2,0.0,1.9e-06,0.002,125,196,131,195,124,203,0.81,71,64,79
OceanDNA-b3969,389,23.1,0.0,1.9e-09,1.6e-06,78,212,94,238,71,253,0.81,134,144,182
OceanDNA-b23331,1418,14.5,0.1,7.6e-07,0.0014,104,215,102,216,52,251,0.81,111,114,199
OceanDNA-b21004,811,4.3,0.0,0.0031,2.0,194,219,155,180,125,203,0.81,25,25,78
OceanDNA-b10261,75,9.5,0.0,2.6e-05,0.0088,135,183,106,152,98,165,0.81,48,46,67
OceanDNA-b15465,164,-2.3,0.0,0.31,110.0,159,177,146,164,127,167,0.81,18,18,40
OceanDNA-b37345,482,14.4,0.0,2.5e-06,0.0012,197,245,264,310,238,331,0.81,48,46,93
OceanDNA-b3656,205,12.5,0.0,3.1e-06,0.0017,133,181,116,163,100,176,0.81,48,47,76
OceanDNA-b35378,46,7.9,0.0,8e-05,0.13,187,265,180,256,158,261,0.81,78,76,103
OceanDNA-b36751,297,12.5,0.0,3.2e-06,0.002,156,179,164,187,144,198,0.81,23,23,54
OceanDNA-b24591,1677,13.1,0.0,2.1e-06,0.0059,154,181,149,176,126,191,0.81,27,27,65
OceanDNA-b3982,297,14.6,0.0,2.2e-06,0.00044,199,265,190,254,177,271,0.81,66,64,94
OceanDNA-b10059,343,15.0,0.0,5.3e-07,0.00025,198,266,121,191,96,195,0.81,68,70,99
OceanDNA-b34300,355,10.8,0.0,1e-05,0.0091,123,186,78,133,40,184,0.81,63,55,144
OceanDNA-b23909,1854,12.5,0.0,3.1e-06,0.006,194,229,273,307,266,332,0.81,35,34,66
OceanDNA-b26421,1129,10.8,0.1,1.1e-05,0.017,80,184,81,191,75,210,0.81,104,110,135
OceanDNA-b31542,1510,-1.8,0.0,0.071,120.0,150,175,99,124,88,129,0.81,25,25,41
OceanDNA-b5274,115,-1.5,0.0,0.06,40.0,256,285,685,714,672,720,0.81,29,29,48
OceanDNA-b32865,275,4.6,0.0,0.00084,0.43,200,265,201,264,187,267,0.81,65,63,80
OceanDNA-b36071,1758,14.1,0.0,2.1e-06,0.0022,139,181,138,181,127,191,0.81,42,43,64
OceanDNA-b10059,343,5.1,0.0,0.00057,0.26,152,190,40,78,24,89,0.81,38,38,65
OceanDNA-b20819,318,14.8,0.0,1.3e-06,0.00044,145,187,133,176,108,201,0.81,42,43,93
OceanDNA-b24798,1913,14.0,0.0,1.1e-06,0.0035,136,180,133,177,112,190,0.81,44,44,78
OceanDNA-b37264,824,10.7,0.0,1.1e-05,0.014,155,181,159,185,126,193,0.81,26,26,67
OceanDNA-b11418,498,9.0,0.0,3.6e-05,0.02,198,267,191,258,184,271,0.81,69,67,87
OceanDNA-b10700,95,12.6,0.0,3e-06,0.00087,151,199,126,174,115,191,0.81,48,48,76
OceanDNA-b27563,76,11.0,0.0,9e-06,0.014,193,249,166,218,149,227,0.81,56,52,78
OceanDNA-b46505,99,12.8,0.0,5.1e-06,0.0055,153,186,264,298,249,309,0.81,33,34,60
OceanDNA-b32200,2047,7.1,0.0,0.00014,0.33,150,188,109,150,94,155,0.81,38,41,61
OceanDNA-b26776,660,15.8,0.0,6.2e-07,0.00073,153,198,30,76,20,92,0.81,45,46,72
OceanDNA-b40249,8,24.7,0.0,6.2e-10,4.4e-07,140,183,135,180,128,200,0.81,43,45,72
OceanDNA-b41386,175,11.4,0.0,6.9e-06,0.0047,145,187,103,148,92,175,0.81,42,45,83
OceanDNA-b23120,1596,17.3,0.0,1.1e-07,0.00021,149,262,113,241,35,244,0.81,113,128,209
OceanDNA-b40410,137,10.5,0.0,1.3e-05,0.0076,111,182,86,155,75,168,0.81,71,69,93
OceanDNA-b41152,1030,8.9,0.1,7.8e-05,0.087,158,193,93,132,73,142,0.81,35,39,69
OceanDNA-b33297,502,12.1,0.1,4.3e-06,0.0077,144,190,421,464,348,504,0.81,46,43,156
OceanDNA-b17056,36,20.1,0.0,1.5e-08,4.1e-06,138,190,125,177,101,192,0.81,52,52,91
OceanDNA-b2877,23,11.2,0.1,7.7e-06,0.024,97,177,268,346,262,357,0.81,80,78,95
OceanDNA-b7018,34,8.0,0.0,7.2e-05,0.028,198,264,610,678,589,679,0.81,66,68,90
OceanDNA-b45854,937,11.1,0.0,2.6e-05,0.018,152,208,519,578,503,592,0.81,56,59,89
OceanDNA-b45854,1983,-0.0,0.0,0.063,44.0,26,61,100,134,86,140,0.81,35,34,54
OceanDNA-b4005,959,7.8,0.0,0.00017,0.096,23,68,46,91,31,114,0.81,45,45,83
OceanDNA-b37960,533,7.8,0.0,0.00026,0.049,58,121,56,118,34,128,0.81,63,62,94
OceanDNA-b16117,600,6.2,0.0,0.00054,0.21,137,180,83,125,67,139,0.81,43,42,72
OceanDNA-b17374,593,16.0,0.0,2.7e-07,0.0005,152,219,226,295,192,323,0.81,67,69,131
OceanDNA-b41046,1303,35.4,0.0,3.4e-13,5e-10,104,268,100,264,3,280,0.81,164,164,277
OceanDNA-b46695,368,20.3,0.0,7.8e-08,2.9e-05,154,244,144,235,133,246,0.81,90,91,113
OceanDNA-b9793,474,12.3,0.0,3.6e-06,0.002,188,254,209,270,189,282,0.81,66,61,93
OceanDNA-b26127,967,18.5,0.0,4.6e-08,5.6e-05,153,181,143,171,119,198,0.81,28,28,79
OceanDNA-b40713,137,11.9,0.0,5e-06,0.004,135,178,252,289,245,298,0.81,43,37,53
OceanDNA-b30225,1942,5.0,0.2,0.0012,1.6,202,264,239,299,226,303,0.81,62,60,77
OceanDNA-a2259,510,11.3,0.0,7.2e-06,0.0061,92,181,102,192,94,201,0.81,89,90,107
OceanDNA-b38157,292,11.7,0.0,1.6e-05,0.0039,198,266,647,717,610,721,0.81,68,70,111
OceanDNA-b423,584,12.9,0.0,2.4e-06,0.0024,192,255,338,399,311,408,0.81,63,61,97
OceanDNA-b1008,2019,18.5,0.1,4.8e-08,0.0001,138,191,62,114,46,150,0.81,53,52,104
OceanDNA-b26893,2035,27.4,0.0,1.9e-10,3.1e-07,86,180,91,192,84,200,0.81,94,101,116
OceanDNA-b42457,240,7.5,0.0,0.00022,0.034,146,180,128,162,118,172,0.81,34,34,54
OceanDNA-b45612,488,6.8,0.0,0.00018,0.088,152,188,164,200,141,229,0.81,36,36,88
OceanDNA-b33558,856,14.3,0.7,9.1e-07,0.00081,127,175,135,180,56,188,0.81,48,45,132
OceanDNA-b34760,599,3.6,0.0,0.0016,0.99,153,180,182,209,165,221,0.81,27,27,56
OceanDNA-b20986,2603,19.3,0.0,2.8e-08,8.7e-05,89,172,162,256,131,268,0.81,83,94,137
OceanDNA-b9684,441,12.5,0.0,6.5e-06,0.0024,159,182,150,173,130,182,0.81,23,23,52
OceanDNA-b19679,279,17.4,0.0,1e-07,3.4e-05,154,235,137,219,124,246,0.81,81,82,122
OceanDNA-b13250,1870,27.0,0.1,1.2e-09,4.9e-07,146,250,166,270,78,282,0.81,104,104,204
OceanDNA-b46557,381,2.2,0.0,0.0084,2.0,198,244,211,254,208,274,0.81,46,43,66
OceanDNA-b6772,644,10.6,0.0,1.2e-05,0.0082,102,188,125,220,108,247,0.81,86,95,139
OceanDNA-b37351,879,2.5,0.0,0.0036,4.6,150,178,152,180,136,198,0.81,28,28,62
OceanDNA-b2668,213,11.9,0.1,1e-05,0.002,20,65,32,77,15,83,0.81,45,45,68
OceanDNA-b33298,1568,8.0,0.0,7.6e-05,0.15,200,269,207,274,200,293,0.81,69,67,93
OceanDNA-b5610,599,15.1,0.0,5.2e-07,0.00042,231,268,10,48,1,58,0.81,37,38,57
OceanDNA-b22407,1618,15.5,0.0,3.8e-07,0.0011,128,186,401,459,374,476,0.81,58,58,102
OceanDNA-b9684,662,-1.8,0.0,0.14,53.0,198,215,208,225,200,240,0.81,17,17,40
OceanDNA-b23169,959,25.8,0.0,5.6e-10,6.4e-07,145,246,207,304,189,315,0.81,101,97,126
OceanDNA-b30174,1996,4.5,0.1,0.00089,1.9,198,264,288,352,278,354,0.81,66,64,76
OceanDNA-b3975,475,18.5,0.0,1.9e-07,4e-05,142,184,140,182,121,194,0.81,42,42,73
OceanDNA-b30086,99,16.7,0.0,1.7e-07,0.00037,153,178,134,159,117,173,0.81,25,25,56
OceanDNA-b35069,865,13.0,0.0,4.4e-06,0.002,144,182,66,104,40,122,0.81,38,38,82
OceanDNA-b32721,1677,2.6,0.0,0.0064,7.4,197,233,324,359,316,376,0.81,36,35,60
OceanDNA-b15136,655,0.4,0.0,0.015,10.0,152,189,535,572,510,584,0.81,37,37,74
OceanDNA-b22801,867,-0.4,0.0,0.054,67.0,101,122,225,246,210,250,0.81,21,21,40
OceanDNA-b39627,78,6.9,0.1,0.00016,0.067,88,183,18,107,11,113,0.81,95,89,102
OceanDNA-b37118,444,18.2,0.2,5.7e-08,4.7e-05,88,173,88,180,58,194,0.81,85,92,136
OceanDNA-b20036,28,15.0,0.0,1.7e-06,0.00022,156,181,140,165,116,174,0.81,25,25,58
OceanDNA-b23549,1297,10.8,0.2,3e-05,0.02,160,185,132,157,108,174,0.81,25,25,66
OceanDNA-b7191,212,-2.0,0.0,0.081,35.0,197,218,214,235,208,240,0.81,21,21,32
OceanDNA-b37023,300,6.9,0.0,0.00033,0.12,145,186,144,185,139,197,0.81,41,41,58
OceanDNA-a3195,798,-3.0,0.0,0.17,190.0,204,229,261,286,255,299,0.81,25,25,44
OceanDNA-b39096,2190,16.9,0.0,1.4e-07,0.00033,106,186,62,153,44,219,0.81,80,91,175
OceanDNA-b46656,816,-3.2,0.0,0.59,660.0,140,168,140,168,138,171,0.81,28,28,33
OceanDNA-b1719,2754,7.1,0.0,0.00028,0.42,192,231,229,267,221,287,0.81,39,38,66
OceanDNA-b22632,979,14.4,0.1,8.2e-07,0.0028,143,191,180,231,170,234,0.81,48,51,64
OceanDNA-b46933,2408,19.4,0.0,5.1e-08,0.0001,149,200,244,296,223,355,0.81,51,52,132
OceanDNA-b22806,629,11.7,0.0,1.6e-05,0.025,149,185,245,282,233,298,0.81,36,37,65
OceanDNA-b22022,2999,21.3,0.0,1.3e-08,2.2e-05,141,212,153,225,135,241,0.81,71,72,106
OceanDNA-b32730,416,-0.4,0.0,0.056,14.0,196,227,316,346,310,366,0.81,31,30,56
OceanDNA-b13585,820,-1.0,0.0,0.2,61.0,202,231,180,208,172,235,0.81,29,28,63
OceanDNA-b3473,428,10.6,0.0,2.3e-05,0.0086,99,184,36,118,26,135,0.81,85,82,109
OceanDNA-b44719,526,8.9,0.0,4.1e-05,0.024,89,184,44,137,34,163,0.81,95,93,129
OceanDNA-b35148,1840,-3.5,0.0,0.46,480.0,198,210,328,340,311,369,0.81,12,12,58
OceanDNA-b3670,106,10.1,0.0,1.7e-05,0.014,145,180,93,128,81,139,0.81,35,35,58
OceanDNA-b22504,1215,10.9,0.1,2.9e-05,0.028,143,184,862,903,853,915,0.81,41,41,62
OceanDNA-b31471,284,10.3,0.1,1.4e-05,0.029,148,189,111,154,100,162,0.81,41,43,62
OceanDNA-b9746,56,-0.8,0.0,0.037,25.0,161,177,149,165,138,178,0.81,16,16,40
OceanDNA-b41030,2010,12.6,0.1,9.1e-06,0.0077,133,185,61,115,38,120,0.81,52,54,82
OceanDNA-b9778,658,13.3,0.0,1.8e-06,0.0024,158,189,155,187,135,219,0.81,31,32,84
OceanDNA-b23401,359,1.4,0.0,0.0075,16.0,198,244,645,691,625,709,0.81,46,46,84
OceanDNA-b41030,800,43.8,0.0,2.8e-15,2.4e-12,102,268,98,264,7,278,0.81,166,166,271
OceanDNA-b32166,2396,0.2,0.0,0.018,50.0,195,219,375,399,368,416,0.81,24,24,48
OceanDNA-b39458,463,32.3,0.2,3e-12,1.6e-09,87,173,146,246,138,254,0.81,86,100,116
OceanDNA-b16674,643,12.1,0.0,4.1e-06,0.0033,136,184,480,529,443,540,0.81,48,49,97
OceanDNA-a4837,44,14.9,0.1,5.7e-07,0.00023,135,170,316,354,310,359,0.81,35,38,49
OceanDNA-b8260,51,11.0,0.0,1.9e-05,0.0025,89,178,23,107,17,118,0.81,89,84,101
OceanDNA-b28238,1788,15.3,0.1,9.1e-07,0.0011,89,175,165,258,161,279,0.81,86,93,118
OceanDNA-b20097,206,-1.9,0.0,0.24,23.0,100,123,185,207,181,212,0.81,23,22,31
OceanDNA-a3737,266,8.1,0.0,7.1e-05,0.02,183,216,157,193,151,204,0.81,33,36,53
OceanDNA-b46693,1129,38.6,0.0,3.6e-14,8.5e-11,153,243,263,356,252,369,0.81,90,93,117
OceanDNA-b36739,316,2.5,0.0,0.0035,2.1,146,182,85,121,79,145,0.81,36,36,66
OceanDNA-b36430,1104,15.7,0.0,3.3e-07,0.0007,97,183,55,144,27,151,0.81,86,89,124
OceanDNA-b44633,3550,5.3,0.0,0.0005,1.8,148,174,109,135,98,190,0.81,26,26,92
OceanDNA-b33283,2262,12.9,0.1,4.8e-06,0.0083,94,177,45,126,31,134,0.81,83,81,103
OceanDNA-b33283,263,16.8,0.0,3.1e-07,0.00053,71,212,104,256,70,283,0.81,141,152,213
OceanDNA-b3641,425,15.3,0.0,8.8e-07,0.00022,154,189,166,201,143,255,0.81,35,35,112
OceanDNA-b42531,121,16.2,0.0,2.3e-07,5.6e-05,153,188,155,190,148,261,0.81,35,35,113
OceanDNA-b16165,665,15.4,0.0,4.2e-07,0.00037,107,202,194,290,170,297,0.81,95,96,127
OceanDNA-b31464,1668,-3.8,0.0,0.29,570.0,40,50,310,320,300,325,0.81,10,10,25
OceanDNA-b44624,60,13.4,0.0,1.7e-06,0.0035,140,181,126,169,113,188,0.81,41,43,75
OceanDNA-b21017,1453,33.7,0.0,2.2e-12,2.6e-09,90,179,111,207,103,216,0.81,89,96,113
OceanDNA-b24719,1459,11.4,0.4,6.7e-06,0.01,40,107,148,218,106,232,0.81,67,70,126
OceanDNA-b3641,44,11.6,0.1,1.2e-05,0.0031,133,183,121,170,57,186,0.81,50,49,129
OceanDNA-b13585,163,14.6,0.0,3.7e-06,0.0011,137,206,153,226,139,234,0.81,69,73,95
OceanDNA-b10034,204,10.5,0.0,2.5e-05,0.0059,134,188,105,157,29,168,0.81,54,52,139
OceanDNA-b23417,1309,16.4,0.1,6.3e-07,0.00061,152,187,580,616,563,619,0.81,35,36,56
OceanDNA-b40467,458,12.2,0.1,7.8e-06,0.0061,92,187,77,169,53,187,0.81,95,92,134
OceanDNA-b32834,306,18.7,0.3,8.3e-08,3.4e-05,99,194,37,127,14,134,0.81,95,90,120
OceanDNA-b23832,1041,16.3,0.0,4.5e-07,0.00039,153,184,143,173,126,189,0.8,31,30,63
OceanDNA-b46894,843,16.7,0.0,3.3e-07,0.00021,93,199,46,151,32,161,0.8,106,105,129
OceanDNA-b29381,649,22.1,0.0,3.7e-09,3.4e-06,91,179,103,198,99,207,0.8,88,95,108
OceanDNA-b4498,638,23.6,0.0,3.9e-09,1.3e-06,84,187,87,199,66,211,0.8,103,112,145
OceanDNA-b17578,527,11.1,0.0,8.3e-06,0.012,136,190,175,230,137,237,0.8,54,55,100
OceanDNA-b6504,238,9.0,0.1,3.8e-05,0.019,175,243,194,259,188,278,0.8,68,65,90
OceanDNA-b6674,21,12.8,0.0,5.1e-06,0.0017,151,188,165,203,149,210,0.8,37,38,61
OceanDNA-b31987,1725,10.7,0.0,1.1e-05,0.024,154,217,348,420,288,448,0.8,63,72,160
OceanDNA-b35076,458,14.4,0.0,1.6e-06,0.00061,141,180,128,168,122,200,0.8,39,40,78
OceanDNA-b41544,1033,12.9,0.0,4.6e-06,0.0026,102,169,79,144,67,163,0.8,67,65,96
OceanDNA-b30869,2097,18.2,0.2,5.9e-08,0.00013,89,178,146,242,130,247,0.8,89,96,117
OceanDNA-b46557,237,15.6,0.0,7.4e-07,0.00018,153,192,143,185,131,202,0.8,39,42,71
OceanDNA-b27522,1516,1.2,0.0,0.0088,17.0,247,276,134,163,122,176,0.8,29,29,54
OceanDNA-b28098,354,-4.2,0.0,0.38,600.0,146,157,239,250,235,254,0.8,11,11,19
OceanDNA-b20981,2855,10.7,0.0,1.1e-05,0.039,138,188,171,219,144,276,0.8,50,48,132
OceanDNA-b5955,63,-3.2,0.0,0.19,76.0,248,274,667,693,662,700,0.8,26,26,38
OceanDNA-a3708,129,10.9,0.0,9.8e-06,0.0032,180,217,366,406,356,420,0.8,37,40,64
OceanDNA-b16227,919,17.7,0.0,2.4e-07,8.5e-05,88,188,52,163,38,181,0.8,100,111,143
OceanDNA-b15469,314,11.0,0.0,9.3e-06,0.0077,185,249,195,262,126,272,0.8,64,67,146
OceanDNA-b16127,236,3.7,0.1,0.0031,0.96,135,182,113,156,103,258,0.8,47,43,155
OceanDNA-b36733,1175,13.3,0.0,3.7e-06,0.0037,103,193,111,210,85,274,0.8,90,99,189
OceanDNA-b2920,1118,10.9,0.2,1e-05,0.02,87,185,131,236,121,247,0.8,98,105,126
OceanDNA-b36891,1423,18.1,0.0,6.2e-08,0.00012,155,177,45,67,28,89,0.8,22,22,61
OceanDNA-b10073,275,11.7,0.0,5.5e-06,0.0034,193,264,206,275,198,293,0.8,71,69,95
OceanDNA-b1738,344,8.5,0.0,0.00016,0.19,189,252,296,354,285,369,0.8,63,58,84
OceanDNA-b24923,2035,14.3,0.1,9.2e-07,0.0023,129,192,109,177,96,197,0.8,63,68,101
OceanDNA-b7431,155,11.5,0.0,6.3e-06,0.0022,159,227,127,198,120,215,0.8,68,71,95
OceanDNA-b20897,2001,10.0,0.0,1.8e-05,0.049,197,256,253,309,239,321,0.8,59,56,82
OceanDNA-b4002,353,10.5,0.0,2.6e-05,0.017,108,179,575,652,452,673,0.8,71,77,221
OceanDNA-b26845,827,12.5,0.1,6.5e-06,0.01,102,175,142,216,123,224,0.8,73,74,101
OceanDNA-b24879,1546,12.7,0.0,5.6e-06,0.0052,146,179,111,144,94,228,0.8,33,33,134
OceanDNA-b42676,46,20.4,0.0,1.2e-08,2.6e-06,87,176,59,153,29,171,0.8,89,94,142
OceanDNA-b32913,49,26.7,0.1,3.1e-10,2.9e-07,104,181,142,227,127,232,0.8,77,85,105
OceanDNA-b45220,1971,2.7,0.0,0.003,12.0,195,220,236,261,217,286,0.8,25,25,69
OceanDNA-b40444,1625,12.2,0.0,1.6e-05,0.0074,76,168,81,174,75,183,0.8,92,93,108
OceanDNA-b23261,218,8.0,0.1,0.00015,0.17,220,268,228,275,207,293,0.8,48,47,86
OceanDNA-b31504,233,-2.8,0.0,0.14,64.0,158,187,137,166,133,171,0.8,29,29,38
OceanDNA-b15889,227,21.0,0.0,8.2e-09,2.4e-06,153,215,123,194,101,220,0.8,62,71,119
OceanDNA-b46229,394,10.4,0.0,2.8e-05,0.02,153,195,258,301,244,306,0.8,42,43,62
OceanDNA-b38157,181,7.2,0.0,0.0004,0.095,151,189,159,199,141,215,0.8,38,40,74
OceanDNA-b35232,255,14.0,0.0,1.1e-06,0.00075,107,177,35,112,16,141,0.8,70,77,125
OceanDNA-b22983,11,16.6,1.6,1.8e-07,0.00026,54,171,314,434,309,441,0.8,117,120,132
OceanDNA-b23907,61,9.9,0.0,4e-05,0.039,197,249,612,664,604,681,0.8,52,52,77
OceanDNA-b20157,86,17.9,0.0,7.3e-08,2.8e-05,152,241,128,219,111,224,0.8,89,91,113
OceanDNA-b24879,657,4.9,0.1,0.0014,1.3,150,184,125,159,116,166,0.8,34,34,50
OceanDNA-b46252,1934,14.0,0.0,4.4e-06,0.0025,152,185,231,265,213,276,0.8,33,34,63
OceanDNA-b45832,975,14.4,0.0,8.1e-07,0.00097,53,174,78,207,29,219,0.8,121,129,190
OceanDNA-b24024,284,1.6,0.0,0.0066,19.0,154,178,540,564,534,590,0.8,24,24,56
OceanDNA-b13264,157,6.6,0.0,0.00039,0.3,89,187,74,168,55,172,0.8,98,94,117
OceanDNA-b35946,297,15.9,0.0,2.8e-07,0.00013,140,180,125,166,112,180,0.8,40,41,68
OceanDNA-b46253,472,11.1,0.1,8.7e-06,0.013,155,198,96,139,22,142,0.8,43,43,120
OceanDNA-b13269,232,1.4,0.0,0.0075,7.3,193,243,316,365,310,371,0.8,50,49,61
OceanDNA-b22394,92,30.7,0.1,1.8e-11,1.8e-08,153,244,210,303,196,309,0.8,91,93,113
OceanDNA-b36862,966,20.6,0.0,2.1e-08,1.2e-05,153,187,176,210,149,280,0.8,34,34,131
OceanDNA-b22394,801,16.6,0.0,3.6e-07,0.00035,148,188,127,168,114,173,0.8,40,41,59
OceanDNA-b22393,660,-3.6,0.0,0.5,400.0,106,122,136,152,126,153,0.8,16,16,27
OceanDNA-b23122,4081,6.0,0.0,0.00059,1.3,161,196,118,157,66,163,0.8,35,39,97
OceanDNA-b3464,97,9.0,0.0,3.8e-05,0.033,138,209,271,343,257,366,0.8,71,72,109
OceanDNA-b1132,1605,10.6,0.0,1.2e-05,0.019,149,195,442,492,392,498,0.8,46,50,106
OceanDNA-b16046,1508,13.6,0.1,1.5e-06,0.0043,77,189,54,170,40,177,0.8,112,116,137
OceanDNA-b5580,188,43.4,0.1,2.4e-15,5.8e-13,157,245,147,238,45,249,0.8,88,91,204
OceanDNA-b7645,100,13.1,0.0,2.1e-06,0.00038,138,187,157,208,148,239,0.8,49,51,91
OceanDNA-b40548,381,13.0,0.0,4.6e-06,0.0026,139,189,159,205,122,226,0.8,50,46,104
OceanDNA-b46181,281,14.5,0.0,8e-07,0.00064,96,181,83,168,70,182,0.8,85,85,112
OceanDNA-b44,4810,1.5,0.0,0.021,52.0,151,189,532,570,518,579,0.8,38,38,61
OceanDNA-b10366,399,0.7,0.0,0.025,20.0,159,175,150,166,132,193,0.8,16,16,61
OceanDNA-b12096,376,14.9,0.0,5.7e-07,0.00043,194,267,187,258,179,283,0.8,73,71,104
OceanDNA-b46518,919,12.6,0.0,2.9e-06,0.0069,143,185,136,172,122,207,0.8,42,36,85
OceanDNA-b46505,115,16.2,0.0,4.7e-07,0.00051,138,218,138,218,129,227,0.8,80,80,98
OceanDNA-b24091,193,-0.9,0.0,0.075,37.0,192,216,295,319,273,344,0.8,24,24,71
OceanDNA-b32148,502,9.8,0.1,2.2e-05,0.04,97,186,36,127,28,133,0.8,89,91,105
OceanDNA-b6509,444,12.6,0.0,3e-06,0.0031,159,190,196,228,181,239,0.8,31,32,58
OceanDNA-b26901,3435,7.7,0.0,9.1e-05,0.34,195,268,219,290,211,295,0.8,73,71,84
OceanDNA-b8602,166,13.3,0.0,1.8e-06,0.0003,160,230,8,80,4,101,0.8,70,72,97
OceanDNA-b16229,53,-0.3,0.0,0.075,33.0,134,166,694,729,680,732,0.8,32,35,52
OceanDNA-b9096,342,4.5,0.0,0.0018,0.31,143,189,203,243,156,255,0.8,46,40,99
OceanDNA-b20491,67,13.8,0.0,2.5e-06,0.00042,145,192,233,280,204,337,0.8,47,47,133
OceanDNA-b34894,620,13.0,0.2,2.3e-06,0.002,165,218,2,54,1,91,0.8,53,52,90
OceanDNA-b3473,428,-2.5,0.0,0.24,87.0,195,223,206,234,195,248,0.8,28,28,53
OceanDNA-b6211,233,15.9,0.0,2.8e-07,0.00011,135,185,108,155,98,169,0.8,50,47,71
OceanDNA-b24623,456,7.9,0.0,8.2e-05,0.052,195,266,185,254,176,264,0.8,71,69,88
OceanDNA-b17611,2958,12.2,0.0,1.2e-05,0.013,151,191,111,152,92,161,0.8,40,41,69
OceanDNA-b23819,1158,1.1,0.0,0.019,16.0,198,244,254,298,228,315,0.8,46,44,87
OceanDNA-b23149,1687,14.1,0.0,2.1e-06,0.0018,141,188,130,176,125,209,0.8,47,46,84
OceanDNA-b26837,1569,-3.7,0.0,0.28,830.0,193,212,186,205,178,214,0.8,19,19,36
OceanDNA-b23149,1072,10.3,0.0,3e-05,0.027,147,179,78,110,66,119,0.8,32,32,53
OceanDNA-b40228,134,20.2,0.2,1.5e-08,9.4e-06,89,176,75,167,32,172,0.8,87,92,140
OceanDNA-b34923,521,15.1,0.0,5.3e-07,0.0004,197,249,220,272,198,290,0.8,52,52,92
OceanDNA-b28564,1477,8.0,0.0,7.2e-05,0.2,179,230,232,284,218,300,0.8,51,52,82
OceanDNA-b33288,263,14.9,0.0,1.2e-06,0.0017,81,187,50,161,44,190,0.8,106,111,146
OceanDNA-b28564,1477,5.0,0.0,0.0006,1.6,154,188,123,158,112,171,0.8,34,35,59
OceanDNA-b30724,1252,-4.1,0.0,0.35,600.0,161,169,147,155,141,162,0.8,8,8,21
OceanDNA-b24725,125,11.9,0.0,9.5e-06,0.013,159,185,130,155,89,161,0.8,26,25,72
OceanDNA-b3920,492,-2.8,0.0,0.45,290.0,23,40,242,259,232,263,0.8,17,17,31
OceanDNA-b3372,406,11.2,0.1,1.5e-05,0.025,147,220,260,335,249,344,0.8,73,75,95
OceanDNA-b9187,286,15.0,0.0,5.4e-07,0.00018,152,188,140,179,131,189,0.8,36,39,58
OceanDNA-b30157,926,4.7,0.0,0.00074,1.6,196,266,203,271,193,273,0.8,70,68,80
OceanDNA-a2501,135,10.4,0.0,1.4e-05,0.0059,140,178,101,139,69,155,0.8,38,38,86
OceanDNA-b26433,1379,17.7,0.0,8.1e-08,0.00013,89,178,56,149,49,165,0.8,89,93,116
OceanDNA-b32156,919,13.6,0.2,3e-06,0.0042,18,84,45,114,31,124,0.8,66,69,93
OceanDNA-b29492,231,5.6,0.0,0.00041,0.74,156,183,80,107,66,148,0.8,27,27,82
OceanDNA-b20976,3532,3.9,0.0,0.0026,8.1,197,236,239,277,228,292,0.8,39,38,64
OceanDNA-b13198,39,9.4,0.0,2.8e-05,0.014,191,266,183,256,158,278,0.8,75,73,120
OceanDNA-b29498,644,14.3,0.0,9e-07,0.0019,153,176,162,185,144,200,0.8,23,23,56
OceanDNA-b512,233,15.3,0.0,8.9e-07,0.00074,148,186,88,127,35,131,0.8,38,39,96
OceanDNA-b13261,8,10.8,0.0,2.1e-05,0.013,77,122,11,59,6,134,0.8,45,48,128
OceanDNA-b46222,883,11.9,0.0,9.6e-06,0.0078,141,187,214,261,196,303,0.8,46,47,107
OceanDNA-b6756,268,15.0,0.0,5.4e-07,0.00029,158,197,147,187,124,214,0.8,39,40,90
OceanDNA-b30226,1919,20.7,0.1,1e-08,2.5e-05,87,181,71,173,45,213,0.8,94,102,168
OceanDNA-b3315,305,22.4,0.4,6.1e-09,1.1e-05,74,186,437,561,416,572,0.8,112,124,156
OceanDNA-b23519,427,-3.9,0.1,0.32,490.0,73,90,302,319,296,323,0.8,17,17,27
OceanDNA-b31526,385,16.9,0.0,4.2e-07,0.00014,197,255,308,366,292,378,0.8,58,58,86
OceanDNA-b38976,861,16.6,0.1,1.8e-07,0.00022,59,188,34,174,5,209,0.8,129,140,204
OceanDNA-b45857,2941,1.3,0.0,0.016,32.0,153,174,128,149,79,166,0.8,21,21,87
OceanDNA-b23996,682,9.3,0.0,5.9e-05,0.034,197,249,613,665,603,684,0.8,52,52,81
OceanDNA-b43839,38,10.4,0.0,2.8e-05,0.025,188,261,207,276,186,280,0.8,73,69,94
OceanDNA-b4058,514,18.5,0.0,9.3e-08,3.3e-05,102,212,118,238,86,245,0.8,110,120,159
OceanDNA-b39489,22,0.7,0.0,0.012,8.7,148,189,572,613,559,620,0.8,41,41,61
OceanDNA-b34735,604,11.3,0.1,1.5e-05,0.0049,62,185,73,194,66,202,0.8,123,121,136
OceanDNA-b9724,486,11.1,0.2,8.3e-06,0.0041,175,243,197,262,191,279,0.8,68,65,88
OceanDNA-b17610,131,5.4,0.0,0.00091,1.7,148,180,131,163,119,172,0.8,32,32,53
OceanDNA-b20967,119,20.3,0.0,1.4e-08,2e-05,196,246,302,351,284,362,0.8,50,49,78
OceanDNA-b3627,388,18.1,0.0,6.4e-08,4.6e-05,148,218,133,205,122,236,0.8,70,72,114
OceanDNA-b44,1285,0.1,0.0,0.056,140.0,151,189,550,588,537,598,0.8,38,38,61
OceanDNA-b4491,657,37.0,0.0,2.2e-13,7.8e-11,85,176,140,241,134,247,0.8,91,101,113
OceanDNA-b15979,900,13.5,0.1,3.1e-06,0.0016,148,185,72,109,6,122,0.8,37,37,116
OceanDNA-b3564,200,11.2,0.0,1.5e-05,0.0043,140,186,76,121,31,131,0.8,46,45,100
OceanDNA-b21580,140,17.4,0.0,1e-07,3.5e-05,152,193,157,199,101,211,0.8,41,42,110
OceanDNA-b22991,4364,15.3,0.0,1.4e-06,0.0021,195,265,207,275,198,280,0.8,70,68,82
OceanDNA-b31229,252,12.7,0.0,5.6e-06,0.0042,133,204,98,169,19,191,0.8,71,71,172
OceanDNA-b9635,310,7.5,0.1,0.00011,0.051,175,221,197,243,191,257,0.8,46,46,66
OceanDNA-b33194,434,6.1,0.0,0.00028,0.29,151,178,200,227,186,243,0.8,27,27,57
OceanDNA-b23293,1110,8.6,0.0,4.9e-05,0.07,196,263,235,298,213,301,0.8,67,63,88
OceanDNA-b30215,1666,12.4,0.1,6.9e-06,0.0063,86,189,50,159,40,174,0.8,103,109,134
OceanDNA-b20340,342,12.9,0.0,2.3e-06,0.00097,141,175,154,188,137,201,0.8,34,34,64
OceanDNA-b6569,149,-4.1,0.0,0.72,310.0,158,189,593,624,590,630,0.8,31,31,40
OceanDNA-b46255,1416,10.3,0.1,4.5e-05,0.049,152,199,98,145,24,151,0.8,47,47,127
OceanDNA-b12351,370,36.5,0.0,1.6e-13,6.6e-11,158,243,142,230,107,243,0.8,85,88,136
OceanDNA-b7448,59,7.2,0.0,0.00026,0.086,197,265,191,257,182,278,0.8,68,66,96
OceanDNA-b3658,730,11.0,0.0,1.9e-05,0.013,153,182,81,110,71,124,0.8,29,29,53
OceanDNA-b32822,420,10.3,0.0,3e-05,0.0096,152,197,112,158,98,164,0.8,45,46,66
OceanDNA-b33303,944,19.2,0.0,2.9e-08,0.00012,142,184,141,185,124,201,0.8,42,44,77
OceanDNA-b3673,1776,6.4,0.0,0.00023,0.54,203,265,125,185,74,189,0.8,62,60,115
OceanDNA-b34714,596,10.4,0.0,1.4e-05,0.0091,61,185,62,184,53,191,0.8,124,122,138
OceanDNA-b22800,1598,11.5,0.0,1.3e-05,0.011,134,180,243,289,223,301,0.8,46,46,78
OceanDNA-b22800,299,7.5,0.0,0.00022,0.18,159,184,193,218,180,229,0.8,25,25,49
OceanDNA-b24005,575,1.2,0.0,0.009,16.0,140,189,492,541,486,556,0.8,49,49,70
OceanDNA-b22890,202,0.2,0.0,0.054,38.0,195,243,257,308,246,324,0.8,48,51,78
OceanDNA-b17318,2277,12.2,0.0,7.7e-06,0.0093,106,211,134,249,111,261,0.8,105,115,150
OceanDNA-b30346,1949,6.9,0.1,0.00016,0.35,166,230,202,268,196,290,0.8,64,66,94
OceanDNA-b34384,115,15.3,0.0,1.3e-06,0.00037,159,187,130,158,47,165,0.8,28,28,118
OceanDNA-b16147,423,-1.8,0.0,0.21,48.0,193,230,406,443,386,456,0.8,37,37,70
OceanDNA-b34384,302,13.9,0.0,3.5e-06,0.00097,150,182,79,111,16,159,0.8,32,32,143
OceanDNA-b35935,1408,5.6,0.1,0.0004,1.1,157,180,104,127,96,141,0.8,23,23,45
OceanDNA-b35493,143,15.4,0.0,4.3e-07,9.3e-05,152,215,109,175,79,215,0.8,63,66,136
OceanDNA-b46572,231,11.1,0.0,8.4e-06,0.013,135,180,238,277,231,285,0.8,45,39,54
OceanDNA-b28588,364,13.1,0.0,2.1e-06,0.0018,140,176,124,162,120,178,0.8,36,38,58
OceanDNA-b36084,2329,10.5,0.0,1.3e-05,0.034,150,175,305,330,282,336,0.8,25,25,54
OceanDNA-b20995,1937,15.2,0.1,9.3e-07,0.0024,152,212,388,451,359,487,0.8,60,63,128
OceanDNA-b41451,1253,14.8,0.1,1.2e-06,0.00089,138,186,71,119,36,127,0.8,48,48,91
OceanDNA-b30570,249,19.4,0.0,2.5e-08,7.1e-05,140,180,173,215,170,234,0.8,40,42,64
OceanDNA-b13296,356,0.7,0.0,0.012,12.0,179,223,295,339,288,357,0.8,44,44,69
OceanDNA-b30927,17,20.3,0.1,2.7e-08,2.8e-05,89,176,125,219,108,226,0.8,87,94,118
OceanDNA-b40250,557,34.4,0.0,1.4e-12,5e-10,85,171,145,242,138,246,0.8,86,97,108
OceanDNA-b6744,363,11.2,0.0,7.6e-06,0.0047,198,243,228,269,221,283,0.8,45,41,62
OceanDNA-b20172,301,10.7,0.0,1.1e-05,0.0043,129,189,229,291,169,296,0.8,60,62,127
OceanDNA-b12469,78,10.9,0.0,1e-05,0.0039,152,181,230,259,163,278,0.8,29,29,115
OceanDNA-b13203,166,9.0,0.1,3.7e-05,0.038,196,265,192,259,183,268,0.8,69,67,85
OceanDNA-b24146,108,3.5,0.1,0.0017,3.7,156,178,150,172,137,184,0.8,22,22,47
OceanDNA-b32084,461,14.6,0.0,1.5e-06,0.0024,154,181,142,169,125,181,0.8,27,27,56
OceanDNA-b22250,1966,14.9,0.0,1.1e-06,0.0018,152,190,138,177,106,185,0.8,38,39,79
OceanDNA-b30166,781,23.5,0.2,1.5e-09,2.6e-06,136,188,146,196,96,207,0.8,52,50,111
OceanDNA-b29526,542,5.0,0.0,0.00063,1.8,197,230,278,310,272,344,0.8,33,32,72
OceanDNA-b17034,755,12.2,0.0,7.7e-06,0.0035,151,176,189,214,174,236,0.8,25,25,62
OceanDNA-b31685,2065,14.3,0.0,1.8e-06,0.0021,58,121,66,129,16,145,0.8,63,63,129
OceanDNA-b22348,286,42.2,0.0,5.7e-15,3.2e-12,152,256,149,259,137,266,0.8,104,110,129
OceanDNA-b3653,2121,12.0,0.0,1.8e-05,0.01,153,228,301,383,283,396,0.8,75,82,113
OceanDNA-b4346,36,33.3,0.0,2.9e-12,3.6e-10,152,243,144,237,131,245,0.8,91,93,114
OceanDNA-b40631,559,32.1,0.0,3.3e-12,1.9e-09,86,171,136,232,128,236,0.8,85,96,108
OceanDNA-b23817,867,14.1,0.0,2e-06,0.0016,154,184,191,221,172,248,0.8,30,30,76
OceanDNA-b17033,808,19.0,0.0,6.7e-08,5.3e-05,94,173,100,185,86,194,0.8,79,85,108
OceanDNA-b357,456,-3.5,0.0,0.23,130.0,195,218,245,268,233,290,0.8,23,23,57
OceanDNA-b31056,2923,15.7,0.5,6.8e-07,0.001,55,187,112,255,98,268,0.8,132,143,170
OceanDNA-b40889,252,4.4,0.0,0.0019,0.6,165,245,248,324,243,336,0.8,80,76,93
OceanDNA-b6944,24,13.4,0.0,1.7e-06,0.00041,152,229,144,222,131,246,0.8,77,78,115
OceanDNA-b16265,572,8.1,0.0,6.7e-05,0.082,195,247,297,348,289,358,0.8,52,51,69
OceanDNA-b26770,298,29.3,0.1,2.4e-11,3.4e-08,81,174,569,673,566,684,0.8,93,104,118
OceanDNA-b31536,828,12.7,0.1,2.8e-06,0.0073,132,188,226,280,209,309,0.8,56,54,100
OceanDNA-b3921,473,10.8,0.0,1.1e-05,0.0074,139,185,137,176,79,202,0.8,46,39,123
OceanDNA-b27545,1368,6.8,0.1,0.00018,0.38,203,266,195,256,184,258,0.8,63,61,74
OceanDNA-b17030,137,10.6,0.0,1.2e-05,0.0045,191,258,178,242,150,247,0.8,67,64,97
OceanDNA-b23139,2350,-0.9,0.0,0.075,89.0,201,244,243,283,236,292,0.8,43,40,56
OceanDNA-b20923,2810,22.2,0.0,7.3e-09,2.2e-05,146,202,1217,1276,1197,1279,0.8,56,59,82
OceanDNA-b20657,149,8.7,0.0,9.4e-05,0.014,155,192,87,123,24,153,0.8,37,36,129
OceanDNA-b25814,151,20.5,0.0,1.2e-08,2.5e-06,60,212,73,238,56,275,0.8,152,165,219
OceanDNA-b4143,174,25.1,0.0,1.4e-09,7.7e-07,86,189,139,245,132,255,0.8,103,106,123
OceanDNA-b22108,719,18.9,0.0,6.9e-08,7.1e-05,135,191,152,202,118,237,0.8,56,50,119
OceanDNA-b16208,255,14.4,0.1,8.2e-07,0.00091,88,122,289,323,274,399,0.8,34,34,125
OceanDNA-b46309,179,1.3,1.3,0.024,19.0,149,180,114,144,107,149,0.8,31,30,42
OceanDNA-b23003,2097,26.9,0.5,6.5e-10,3.2e-07,71,175,326,436,308,443,0.8,104,110,135
OceanDNA-b30676,105,2.4,0.2,0.0038,6.2,161,197,124,164,108,186,0.8,36,40,78
OceanDNA-b33307,615,10.8,0.0,1.1e-05,0.034,197,267,230,298,221,301,0.8,70,68,80
OceanDNA-b36666,625,-3.6,0.0,0.78,320.0,179,216,258,295,250,308,0.8,37,37,58
OceanDNA-b23918,1793,13.8,0.0,2.5e-06,0.0024,155,185,118,148,82,154,0.8,30,30,72
OceanDNA-b11517,108,13.7,0.0,1.3e-06,0.00065,152,218,172,240,147,281,0.8,66,68,134
OceanDNA-b44744,465,11.4,0.0,6.7e-06,0.0054,89,186,45,140,33,166,0.8,97,95,133
OceanDNA-b3318,1749,-0.4,0.0,0.027,100.0,200,247,543,586,536,597,0.8,47,43,61
OceanDNA-b13575,549,7.4,0.0,0.00011,0.12,193,252,181,238,164,254,0.8,59,57,90
OceanDNA-b16662,303,-2.5,0.0,0.12,120.0,90,118,261,289,251,296,0.8,28,28,45
OceanDNA-b26823,1130,8.1,0.0,7e-05,0.26,178,248,264,339,252,355,0.8,70,75,103
OceanDNA-b25128,258,8.2,0.0,0.00013,0.054,153,187,111,146,94,155,0.8,34,35,61
OceanDNA-b33411,1017,11.5,0.0,1.3e-05,0.0084,194,249,367,418,359,432,0.8,55,51,73
OceanDNA-b38936,280,10.1,0.0,3.5e-05,0.011,81,184,28,128,20,139,0.8,103,100,119
OceanDNA-b27597,1121,16.1,0.0,2.5e-07,0.00043,153,185,160,192,135,206,0.8,32,32,71
OceanDNA-b32084,1484,-0.8,0.0,0.069,110.0,104,118,204,218,194,222,0.8,14,14,28
OceanDNA-b16215,916,15.5,0.3,7.7e-07,0.00046,153,185,54,86,8,97,0.8,32,32,89
OceanDNA-b40473,212,0.5,0.0,0.044,16.0,195,230,302,338,298,352,0.8,35,36,54
OceanDNA-b23522,1260,13.0,0.0,2.2e-06,0.003,160,207,160,207,130,212,0.8,47,47,82
OceanDNA-b2796,1858,1.4,0.0,0.015,15.0,197,218,331,352,323,377,0.8,21,21,54
OceanDNA-b33096,1031,3.2,0.0,0.0066,2.8,152,187,75,110,64,117,0.8,35,35,53
OceanDNA-b40613,167,17.8,0.0,2.3e-07,5.9e-05,154,181,140,167,111,182,0.8,27,27,71
OceanDNA-b32661,1278,19.1,0.0,3.1e-08,7.7e-05,153,182,149,178,130,189,0.8,29,29,59
OceanDNA-b24040,1710,8.7,0.1,4.5e-05,0.079,154,175,7,28,2,44,0.8,21,21,42
OceanDNA-b23976,1658,12.7,0.0,2.8e-06,0.005,105,188,63,145,50,162,0.8,83,82,112
OceanDNA-b31948,631,11.5,0.1,1.3e-05,0.015,131,172,287,327,253,343,0.8,41,40,90
OceanDNA-b17223,1015,11.2,0.1,2.4e-05,0.021,185,243,246,302,182,306,0.8,58,56,124
OceanDNA-b31948,360,-2.4,0.0,0.22,240.0,108,121,943,956,933,962,0.8,13,13,29
OceanDNA-b32139,904,1.4,0.0,0.015,17.0,198,221,249,273,243,280,0.8,23,24,37
OceanDNA-b4473,86,29.1,0.0,5.8e-11,7.9e-09,153,243,152,244,133,251,0.8,90,92,118
OceanDNA-b16139,377,5.0,0.0,0.0012,0.48,130,174,324,366,319,373,0.8,44,42,54
OceanDNA-b32152,821,18.6,0.0,9e-08,0.00015,108,185,155,231,56,241,0.8,77,76,185
OceanDNA-b4290,7,1.9,0.0,0.0055,1.3,153,189,36,72,21,83,0.8,36,36,62
OceanDNA-b24875,603,10.6,0.0,3.6e-05,0.021,194,258,332,394,327,402,0.8,64,62,75
OceanDNA-b4344,7,13.6,0.0,1.5e-06,0.00034,198,265,604,673,596,675,0.8,67,69,79
OceanDNA-b16224,1390,1.5,0.0,0.0073,11.0,194,223,432,462,415,481,0.8,29,30,66
OceanDNA-b22477,939,-2.7,0.0,0.14,240.0,189,210,194,215,175,217,0.8,21,21,42
OceanDNA-b32834,486,11.3,0.0,1.5e-05,0.0061,157,190,178,212,154,222,0.8,33,34,68
OceanDNA-b46625,176,15.2,0.0,1.5e-06,0.00044,140,193,293,346,286,363,0.8,53,53,77
OceanDNA-b39122,1487,16.2,0.1,2.4e-07,0.00056,106,186,82,173,64,210,0.8,80,91,146
OceanDNA-b46625,322,16.4,0.0,6.2e-07,0.00019,149,187,120,159,107,165,0.8,38,39,58
OceanDNA-b4608,125,13.5,0.0,3.2e-06,0.00084,129,188,131,184,119,253,0.8,59,53,134
OceanDNA-b6183,255,7.5,0.0,0.00011,0.062,159,181,116,138,98,148,0.8,22,22,50
OceanDNA-b6183,255,1.6,0.0,0.0066,3.8,192,233,227,268,210,293,0.8,41,41,83
OceanDNA-b29612,2274,-0.1,0.0,0.022,60.0,47,81,30,62,24,73,0.8,34,32,49
OceanDNA-b17396,1318,27.9,0.0,6.4e-11,1.2e-07,152,243,207,302,185,317,0.8,91,95,132
OceanDNA-b6212,8,10.9,0.0,2e-05,0.0081,109,198,558,655,548,683,0.8,89,97,135
OceanDNA-b31716,2338,1.1,0.0,0.0097,24.0,93,134,85,130,70,148,0.8,41,45,78
OceanDNA-b36663,634,18.2,0.0,6e-08,7.7e-05,140,186,136,183,130,201,0.8,46,47,71
OceanDNA-b22324,3930,24.1,0.0,2.8e-09,3.8e-06,59,212,72,238,54,258,0.8,153,166,204
OceanDNA-b30115,454,5.7,0.0,0.00038,0.98,153,185,123,155,109,181,0.8,32,32,72
OceanDNA-b10294,339,21.0,0.0,1.6e-08,6.9e-06,74,192,51,176,35,183,0.8,118,125,148
OceanDNA-b10034,202,28.7,0.0,7.6e-11,1.8e-08,152,229,180,258,167,276,0.8,77,78,109
OceanDNA-b23394,910,13.5,0.1,3.2e-06,0.0039,149,187,823,861,785,882,0.8,38,38,97
OceanDNA-b23015,1474,14.2,0.0,9.7e-07,0.0062,132,184,167,220,160,225,0.8,52,53,65
OceanDNA-b38975,199,46.3,0.3,3.2e-16,3.5e-13,74,270,106,292,45,309,0.8,196,186,264
OceanDNA-b40618,366,13.6,0.0,5.8e-06,0.00087,99,181,33,109,22,120,0.8,82,76,98
OceanDNA-b13250,780,22.9,0.0,2.2e-08,8.9e-06,104,271,216,374,177,388,0.8,167,158,211
OceanDNA-b34612,209,20.9,0.0,9e-09,8.2e-06,108,203,116,208,90,224,0.8,95,92,134
OceanDNA-b16039,280,4.0,0.0,0.0012,1.5,149,177,367,395,346,406,0.8,28,28,60
OceanDNA-b22477,939,12.8,0.3,2.5e-06,0.0042,69,178,14,125,2,138,0.8,109,111,136
OceanDNA-b9767,735,21.2,0.0,7.1e-09,7.5e-06,83,188,173,281,166,287,0.8,105,108,121
OceanDNA-b24103,2439,11.2,0.0,1.5e-05,0.02,152,182,24,56,5,63,0.8,30,32,58
OceanDNA-b47086,2846,4.1,0.0,0.0023,4.8,194,223,225,253,215,287,0.8,29,28,72
OceanDNA-b29385,2659,3.2,0.0,0.0022,7.4,177,245,470,543,453,549,0.8,68,73,96
OceanDNA-b37543,1719,12.2,0.1,3.8e-06,0.0095,76,190,58,176,25,217,0.8,114,118,192
OceanDNA-b16121,452,5.8,0.0,0.00036,0.27,194,220,429,455,401,479,0.8,26,26,78
OceanDNA-b13256,77,15.7,0.0,2.3e-06,0.00064,140,179,134,175,127,187,0.8,39,41,60
OceanDNA-b21048,127,-3.2,0.0,0.38,340.0,248,281,344,377,332,379,0.8,33,33,47
OceanDNA-b23258,83,18.1,0.0,6.2e-08,1.9e-05,142,187,228,272,202,304,0.8,45,44,102
OceanDNA-b33329,1259,15.3,0.0,1.3e-06,0.00069,141,185,127,172,122,180,0.8,44,45,58
OceanDNA-b32197,69,11.7,0.0,5.5e-06,0.011,152,186,146,177,116,193,0.8,34,31,77
OceanDNA-b4344,7,-2.9,0.0,0.15,36.0,154,189,525,560,523,567,0.8,35,35,44
OceanDNA-b22383,2311,10.7,0.2,4.5e-05,0.039,96,175,133,210,124,252,0.8,79,77,128
OceanDNA-b16210,467,3.8,0.0,0.0028,1.6,195,224,482,512,460,534,0.8,29,30,74
OceanDNA-b40086,698,17.4,0.0,1e-07,9.8e-05,154,180,179,205,160,218,0.8,26,26,58
OceanDNA-b10043,168,0.4,0.0,0.015,6.2,193,217,230,254,225,279,0.79,24,24,54
OceanDNA-b32791,286,6.6,0.1,0.0002,0.061,204,265,240,299,232,300,0.79,61,59,68
OceanDNA-b34299,818,3.7,0.1,0.0062,3.1,199,245,210,258,200,277,0.79,46,48,77
OceanDNA-b30938,1427,11.6,0.0,1.8e-05,0.015,191,244,231,282,202,293,0.79,53,51,91
OceanDNA-b32139,30,8.0,0.2,0.00015,0.18,146,187,126,166,64,179,0.79,41,40,115
OceanDNA-b30874,1412,19.3,0.0,5.3e-08,6.2e-05,86,183,65,170,57,186,0.79,97,105,129
OceanDNA-b12674,139,13.8,0.0,1.2e-06,0.00074,107,196,551,647,521,656,0.79,89,96,135
OceanDNA-b21179,205,16.1,0.0,2.6e-07,0.00012,151,260,129,240,73,254,0.79,109,111,181
OceanDNA-b46181,281,-1.6,0.0,0.062,49.0,199,220,228,248,222,267,0.79,21,20,45
OceanDNA-b40634,443,11.1,0.0,1.7e-05,0.0069,109,185,45,117,25,133,0.79,76,72,108
OceanDNA-b3318,1749,8.4,0.0,5.7e-05,0.23,104,181,351,427,336,434,0.79,77,76,98
OceanDNA-b24172,3373,10.7,0.2,1.1e-05,0.041,68,168,93,192,87,208,0.79,100,99,121
OceanDNA-b31170,1207,6.1,0.0,0.00027,0.34,197,269,161,233,152,254,0.79,72,72,102
OceanDNA-a485,127,32.7,0.0,2.2e-12,7.2e-10,75,212,158,303,125,338,0.79,137,145,213
OceanDNA-b10144,58,13.6,0.0,1.5e-06,0.00051,146,183,92,129,67,147,0.79,37,37,80
OceanDNA-b17716,254,22.8,0.0,2.4e-09,3e-06,151,200,196,246,183,275,0.79,49,50,92
OceanDNA-b47087,19,12.2,0.1,1.2e-05,0.011,77,169,144,237,118,251,0.79,92,93,133
OceanDNA-b40442,1416,16.5,0.0,1.9e-07,0.00038,140,181,128,170,121,184,0.79,41,42,63
OceanDNA-b31569,1828,11.7,0.0,5.6e-06,0.016,155,177,450,472,446,491,0.79,22,22,45
OceanDNA-b35376,2203,4.9,0.0,0.00064,1.6,137,181,136,179,95,186,0.79,44,43,91
OceanDNA-b11455,288,5.0,0.0,0.00059,0.46,197,241,384,431,375,449,0.79,44,47,74
OceanDNA-b26737,1759,4.4,0.0,0.0018,2.1,159,185,120,145,53,183,0.79,26,25,130
OceanDNA-b27622,294,15.6,0.1,3.6e-07,0.00028,105,196,85,179,64,201,0.79,91,94,137
OceanDNA-b29,4639,20.2,0.1,5.9e-08,7.5e-05,70,177,41,146,15,228,0.79,107,105,213
OceanDNA-b41014,987,65.7,1.1,6e-22,4.3e-19,6,270,36,305,31,322,0.79,264,269,291
OceanDNA-b23850,7,6.5,0.0,0.00065,0.32,161,185,117,141,99,164,0.79,24,24,65
OceanDNA-b33525,417,8.0,0.0,7.7e-05,0.29,160,182,222,244,167,252,0.79,22,22,85
OceanDNA-b32517,215,11.0,0.0,9.4e-06,0.0028,158,189,151,183,130,202,0.79,31,32,72
OceanDNA-b18150,166,25.8,0.0,2.9e-10,4.8e-08,144,209,235,304,221,317,0.79,65,69,96
OceanDNA-b22382,1397,-2.5,0.0,0.36,470.0,178,193,306,321,297,331,0.79,15,15,34
OceanDNA-b43704,545,6.6,0.0,0.0002,0.22,168,220,126,182,120,210,0.79,52,56,90
OceanDNA-b22283,131,15.2,0.0,4.8e-07,0.00069,152,184,134,166,108,181,0.79,32,32,73
OceanDNA-b37405,679,11.8,0.1,5.1e-06,0.0053,147,180,131,164,104,179,0.79,33,33,75
OceanDNA-b3628,552,1.1,0.0,0.0094,10.0,135,174,45,87,41,100,0.79,39,42,59
OceanDNA-b37709,491,17.3,0.0,1.1e-07,5.7e-05,151,180,148,177,129,178,0.79,29,29,49
OceanDNA-b26143,256,16.9,0.0,1.4e-07,0.00018,152,180,142,170,113,195,0.79,28,28,82
OceanDNA-b23176,6781,20.5,0.0,3.5e-08,8.8e-05,59,211,78,244,62,252,0.79,152,166,190
OceanDNA-b20036,313,21.9,0.0,1.3e-08,1.6e-06,153,225,130,203,116,235,0.79,72,73,119
OceanDNA-b36739,316,8.4,0.1,5.8e-05,0.035,188,238,226,274,216,287,0.79,50,48,71
OceanDNA-b28141,234,11.0,0.0,1.8e-05,0.015,189,231,243,285,215,305,0.79,42,42,90
OceanDNA-b46917,94,14.6,0.0,1.4e-06,0.0012,127,186,105,163,92,179,0.79,59,58,87
OceanDNA-b19297,251,12.7,0.0,2.8e-06,0.00091,139,203,152,220,149,234,0.79,64,68,85
OceanDNA-b28110,1919,-1.1,0.0,0.043,96.0,198,217,428,447,397,461,0.79,19,19,64
OceanDNA-b38586,338,26.6,0.0,1.6e-10,8.6e-08,75,187,41,164,12,232,0.79,112,123,220
OceanDNA-b9746,56,10.1,0.0,1.7e-05,0.011,192,247,221,272,214,285,0.79,55,51,71
OceanDNA-b19821,211,29.6,0.0,2e-11,7.2e-09,141,226,90,177,83,196,0.79,85,87,113
OceanDNA-b30854,1685,18.3,0.0,1.1e-07,0.00013,87,181,87,189,79,201,0.79,94,102,122
OceanDNA-b46205,397,8.6,0.0,4.8e-05,0.074,76,143,97,163,32,177,0.79,67,66,145
OceanDNA-b7639,155,10.4,0.0,1.4e-05,0.0045,138,186,105,151,97,168,0.79,48,46,71
OceanDNA-b23966,184,6.6,0.0,0.0002,0.45,193,245,302,354,287,363,0.79,52,52,76
OceanDNA-b22406,920,11.7,0.0,2.7e-05,0.016,152,187,159,195,141,236,0.79,35,36,95
OceanDNA-b22185,127,141.2,0.0,1.9e-45,4.8e-42,43,281,54,309,16,322,0.79,238,255,306
OceanDNA-b46695,285,11.3,0.0,4.3e-05,0.016,103,169,95,159,64,168,0.79,66,64,104
OceanDNA-b40066,15,13.6,0.0,1.4e-06,0.00038,94,180,29,109,17,137,0.79,86,80,120
OceanDNA-b22616,3382,37.2,0.0,2.9e-13,4.4e-10,153,247,144,240,133,244,0.79,94,96,111
OceanDNA-b20668,73,1.3,0.0,0.017,2.3,79,122,124,167,89,184,0.79,43,43,95
OceanDNA-b22398,1431,15.4,0.0,8.3e-07,0.0012,150,211,579,646,541,678,0.79,61,67,137
OceanDNA-b22616,1116,14.5,0.0,2.4e-06,0.0035,141,182,107,150,75,194,0.79,41,43,119
OceanDNA-b46704,996,17.3,0.0,2.2e-07,0.00022,155,225,134,205,113,240,0.79,70,71,127
OceanDNA-b38932,129,13.9,0.0,1.2e-06,0.0007,147,186,104,143,86,173,0.79,39,39,87
OceanDNA-b37225,637,11.6,0.0,5.8e-06,0.0077,153,192,577,620,564,629,0.79,39,43,65
OceanDNA-b3648,904,12.1,0.0,4.2e-06,0.0042,143,182,78,117,35,132,0.79,39,39,97
OceanDNA-b32143,845,-2.7,0.0,0.14,280.0,151,183,47,79,44,95,0.79,32,32,51
OceanDNA-b6291,245,2.7,0.0,0.0032,1.8,190,220,206,237,201,251,0.79,30,31,50
OceanDNA-b41226,83,40.1,0.0,1.2e-14,2.3e-11,97,272,87,264,4,280,0.79,175,177,276
OceanDNA-b36577,573,10.7,0.0,2.2e-05,0.021,142,179,85,120,75,129,0.79,37,35,54
OceanDNA-b42188,85,14.2,0.0,9.8e-07,0.00029,154,218,126,192,114,234,0.79,64,66,120
OceanDNA-b17766,436,8.1,3.5,6.9e-05,0.32,147,178,33,64,13,72,0.79,31,31,59
OceanDNA-b23453,2034,11.7,0.1,5.6e-06,0.016,117,175,71,135,63,154,0.79,58,64,91
OceanDNA-b40640,1386,19.6,0.0,2.2e-08,3.2e-05,141,180,135,176,130,191,0.79,39,41,61
OceanDNA-b41055,555,60.0,0.7,2.2e-20,2.4e-17,20,269,19,270,3,286,0.79,249,251,283
OceanDNA-b40439,284,14.5,0.0,1.5e-06,0.0015,175,245,265,340,262,346,0.79,70,75,84
OceanDNA-b33192,401,6.8,0.2,0.00033,0.072,230,265,111,148,87,149,0.79,35,37,62
OceanDNA-b31575,576,0.2,0.3,0.035,30.0,159,177,129,147,114,160,0.79,18,18,46
OceanDNA-b10365,545,1.3,0.0,0.017,5.8,182,212,126,156,115,171,0.79,30,30,56
OceanDNA-b45859,2819,0.9,0.0,0.021,39.0,153,175,222,244,174,260,0.79,22,22,86
OceanDNA-b44610,1442,3.9,0.0,0.0013,2.2,197,230,293,325,289,364,0.79,33,32,75
OceanDNA-b32786,393,-3.3,0.0,0.63,340.0,191,213,315,337,311,344,0.79,22,22,33
OceanDNA-b4392,8,20.3,0.1,1.4e-08,4.1e-06,89,176,78,170,58,187,0.79,87,92,129
OceanDNA-b11352,456,8.7,0.0,4.5e-05,0.028,194,264,195,263,185,269,0.79,70,68,84
OceanDNA-b6505,278,5.9,0.0,0.00031,0.26,196,264,184,250,177,261,0.79,68,66,84
OceanDNA-b24739,379,10.7,0.0,1.1e-05,0.0074,154,181,34,61,12,78,0.79,27,27,66
OceanDNA-b6723,230,13.6,0.0,1.5e-06,0.001,102,211,121,239,86,250,0.79,109,118,164
OceanDNA-b34219,1085,14.2,0.1,9.5e-07,0.0024,94,185,195,286,184,300,0.79,91,91,116
OceanDNA-b17623,2903,11.1,0.0,1.7e-05,0.026,135,178,260,297,253,306,0.79,43,37,53
OceanDNA-b23122,375,11.1,0.0,1.7e-05,0.039,105,179,240,312,230,342,0.79,74,72,112
OceanDNA-b22528,305,14.6,0.0,7.2e-07,0.00059,149,179,56,87,38,97,0.79,30,31,59
OceanDNA-b33388,2494,16.2,0.0,1.2e-06,0.0009,105,212,177,294,165,344,0.79,107,117,179
OceanDNA-b20629,17,17.1,0.0,1.2e-07,2.3e-05,139,209,221,295,197,299,0.79,70,74,102
OceanDNA-b38033,431,16.5,0.0,1.9e-07,0.00017,140,180,8,50,5,63,0.79,40,42,58
OceanDNA-b23169,959,-0.8,0.0,0.071,80.0,247,281,327,361,318,365,0.79,34,34,47
OceanDNA-b4442,33,10.4,0.0,1.4e-05,0.003,198,264,608,676,599,678,0.79,66,68,79
OceanDNA-b35156,466,16.8,0.0,1.5e-07,0.00027,140,178,127,166,117,181,0.79,38,39,64
OceanDNA-b47092,365,10.8,0.0,2.1e-05,0.019,139,190,145,196,125,262,0.79,51,51,137
OceanDNA-b3990,715,15.6,0.0,3.5e-07,0.00032,77,212,103,248,84,270,0.79,135,145,186
OceanDNA-b46921,995,20.7,0.0,2e-08,2.3e-05,153,217,153,219,122,248,0.79,64,66,126
OceanDNA-b17764,2398,15.5,0.0,3.9e-07,0.0018,107,178,128,209,115,230,0.79,71,81,115
OceanDNA-b36726,158,19.2,0.0,3e-08,2.4e-05,139,187,129,179,121,195,0.79,48,50,74
OceanDNA-b38575,589,18.7,0.0,4e-08,2.7e-05,77,188,27,142,22,155,0.79,111,115,133
OceanDNA-b13264,157,3.9,0.0,0.0026,2.0,185,245,244,301,233,318,0.79,60,57,85
OceanDNA-b15465,164,15.2,0.0,1.4e-06,0.0005,196,243,204,249,193,252,0.79,47,45,59
OceanDNA-b13084,750,21.9,0.0,9e-09,1.1e-05,102,176,220,299,176,305,0.79,74,79,129
OceanDNA-b30427,1176,3.3,0.0,0.0041,4.3,159,188,135,164,116,201,0.79,29,29,85
OceanDNA-b42824,223,-3.7,0.1,0.28,550.0,201,217,531,547,501,550,0.79,16,16,49
OceanDNA-b15769,769,23.8,0.3,4.6e-09,2e-06,105,212,124,244,20,256,0.79,107,120,236
OceanDNA-b40613,293,5.7,0.0,0.0011,0.29,160,183,91,114,77,128,0.79,23,23,51
OceanDNA-b40613,293,3.9,0.0,0.004,1.0,198,261,221,280,208,282,0.79,63,59,74
OceanDNA-b23834,1426,11.2,0.2,8e-06,0.015,87,175,239,322,210,341,0.79,88,83,131
OceanDNA-b3473,322,18.0,0.0,1.4e-07,5.1e-05,105,182,35,107,15,119,0.79,77,72,104
OceanDNA-b20913,2398,16.9,0.0,2.9e-07,0.0011,149,188,222,262,204,266,0.79,39,40,62
OceanDNA-b2592,854,10.6,0.1,2.4e-05,0.031,134,190,164,217,155,231,0.79,56,53,76
OceanDNA-b27535,1573,6.2,0.1,0.00027,0.63,204,267,231,292,216,307,0.79,63,61,91
OceanDNA-b20565,177,62.8,0.0,1.5e-21,4.2e-19,54,282,56,311,45,322,0.79,228,255,277
OceanDNA-b32730,173,12.6,0.0,5.9e-06,0.0015,150,186,220,257,202,277,0.79,36,37,75
OceanDNA-b40047,199,13.5,0.0,1.6e-06,0.0004,94,180,29,109,16,137,0.79,86,80,121
OceanDNA-b3329,1290,16.6,0.7,1.7e-07,0.00038,88,203,88,201,79,206,0.79,115,113,127
OceanDNA-b23680,180,10.8,0.0,1e-05,0.018,162,187,100,125,93,149,0.79,25,25,56
OceanDNA-b20819,330,3.2,0.0,0.0042,1.4,85,121,136,172,125,193,0.79,36,36,68
OceanDNA-b32609,844,15.5,0.1,3.9e-07,0.00043,57,186,22,160,5,191,0.79,129,138,186
OceanDNA-b24235,159,15.9,0.0,3e-07,0.00011,155,185,148,178,120,189,0.79,30,30,69
OceanDNA-b23379,895,-2.5,0.0,0.24,270.0,198,219,418,439,413,478,0.79,21,21,65
OceanDNA-b22306,1201,-0.3,0.0,0.049,40.0,101,122,180,201,164,205,0.79,21,21,41
OceanDNA-b27416,97,1.0,0.0,0.01,2.7,197,249,304,353,297,368,0.79,52,49,71
OceanDNA-b26917,1026,2.9,0.0,0.0055,4.3,197,260,266,325,260,328,0.79,63,59,68
OceanDNA-b34288,84,17.7,0.0,1.7e-07,0.00011,140,184,136,181,131,199,0.79,44,45,68
OceanDNA-b18640,3,25.1,0.0,9e-10,1.4e-07,151,186,130,166,90,194,0.79,35,36,104
OceanDNA-b3655,309,12.3,0.0,1.1e-05,0.0028,99,171,111,192,101,213,0.79,72,81,112
OceanDNA-b45444,359,7.3,0.0,0.00012,0.065,197,263,94,158,87,162,0.79,66,64,75
OceanDNA-b30483,397,3.6,0.1,0.0016,3.8,201,264,196,257,165,259,0.79,63,61,94
OceanDNA-b16143,250,3.3,0.0,0.0041,1.8,183,245,398,460,379,464,0.79,62,62,85
OceanDNA-b36948,1090,3.4,0.0,0.0019,2.1,89,121,137,169,128,179,0.79,32,32,51
OceanDNA-b45263,1584,1.0,0.0,0.01,27.0,197,227,322,351,311,389,0.79,30,29,78
OceanDNA-b282,312,20.8,0.0,1.8e-08,1.3e-05,165,245,1,83,1,89,0.79,80,82,88
OceanDNA-b36995,376,24.5,0.0,7e-10,5.4e-07,129,193,220,286,214,315,0.79,64,66,101
OceanDNA-b13654,77,2.6,0.0,0.0034,1.9,157,175,94,112,74,138,0.79,18,18,64
OceanDNA-b31012,111,11.5,0.0,6.5e-06,0.0034,97,174,88,163,76,188,0.79,77,75,112
OceanDNA-b7448,64,2.8,0.0,0.0056,1.9,221,269,237,285,231,304,0.79,48,48,73
OceanDNA-b3598,254,8.5,0.0,5.2e-05,0.021,149,195,91,138,76,149,0.79,46,47,73
OceanDNA-b19592,319,25.2,0.1,4.2e-10,1.6e-07,88,178,77,172,64,185,0.79,90,95,121
OceanDNA-b46252,2090,12.0,0.0,1.8e-05,0.01,150,185,175,210,153,224,0.79,35,35,71
OceanDNA-b23273,1319,12.1,0.2,4.3e-06,0.0095,157,187,229,259,206,263,0.79,30,30,57
OceanDNA-b3598,254,-0.0,0.0,0.021,8.3,174,217,198,240,178,254,0.79,43,42,76
OceanDNA-b12668,103,8.5,0.0,5.4e-05,0.024,144,196,97,152,89,158,0.79,52,55,69
OceanDNA-b40444,1787,61.6,0.0,1.4e-20,6.4e-18,100,265,122,286,88,309,0.79,165,164,221
OceanDNA-b16160,304,11.0,0.0,8.9e-06,0.0072,74,185,19,134,6,141,0.79,111,115,135
OceanDNA-b41521,1520,16.2,0.0,2.4e-07,0.00044,153,180,148,175,122,187,0.79,27,27,65
OceanDNA-b23089,2834,-0.4,0.0,0.054,110.0,10,45,14,49,9,68,0.79,35,35,59
OceanDNA-b6288,386,11.9,0.0,9.6e-06,0.0022,132,266,25,160,7,163,0.79,134,135,156
OceanDNA-b40473,146,4.0,0.0,0.0037,1.3,68,110,17,64,4,101,0.79,42,47,97
OceanDNA-b9687,398,-0.1,0.0,0.045,20.0,151,189,539,577,518,585,0.79,38,38,67
OceanDNA-b30013,171,12.4,0.0,3.3e-06,0.0076,97,188,141,241,104,269,0.79,91,100,165
OceanDNA-b6288,38,11.8,0.0,1.1e-05,0.0025,102,209,122,239,88,251,0.79,107,117,163
OceanDNA-b32133,1141,9.9,0.0,1.9e-05,0.048,151,185,390,425,374,432,0.79,34,35,58
OceanDNA-b20977,1358,24.6,0.0,2e-09,2.5e-06,74,184,188,300,164,308,0.79,110,112,144
OceanDNA-b22449,551,17.6,0.0,1.8e-07,0.00014,153,217,85,153,73,160,0.79,64,68,87
OceanDNA-b41214,2347,-2.2,0.0,0.097,370.0,122,149,244,271,217,274,0.79,27,27,57
OceanDNA-b15979,255,-3.3,0.0,0.4,200.0,79,97,83,101,66,110,0.79,18,18,44
OceanDNA-b13229,420,9.8,0.0,4.2e-05,0.014,196,227,226,256,216,264,0.79,31,30,48
OceanDNA-b31076,1340,17.6,0.1,2.7e-07,0.00026,153,213,279,346,255,367,0.79,60,67,112
OceanDNA-b6501,201,-2.5,0.0,0.35,60.0,121,147,271,297,264,301,0.79,26,26,37
OceanDNA-b2563,333,10.8,0.0,1.1e-05,0.0042,156,182,245,271,234,294,0.79,26,26,60
OceanDNA-b3631,550,4.1,0.1,0.0012,1.2,161,196,111,150,96,193,0.79,35,39,97
OceanDNA-b36648,147,2.7,0.0,0.003,1.7,153,185,504,537,489,543,0.79,32,33,54
OceanDNA-b35825,979,18.0,0.0,6.6e-08,6.5e-05,87,196,30,142,14,170,0.79,109,112,156
OceanDNA-b35128,467,12.5,0.0,3.2e-06,0.0032,140,184,137,182,130,191,0.79,44,45,61
OceanDNA-b20922,2978,6.0,0.3,0.00092,2.1,161,194,110,147,86,156,0.79,33,37,70
OceanDNA-b6569,486,7.7,0.0,0.00018,0.081,161,197,109,149,39,154,0.79,36,40,115
OceanDNA-b36890,852,11.6,0.1,6.1e-06,0.0095,89,183,70,164,62,179,0.79,94,94,117
OceanDNA-b1140,552,12.3,0.1,3.7e-06,0.0057,148,188,96,136,84,167,0.79,40,40,83
OceanDNA-b44612,1129,8.8,0.0,4.3e-05,0.11,194,249,584,639,577,654,0.79,55,55,77
OceanDNA-b36666,959,4.1,0.0,0.0034,1.4,147,186,533,574,522,585,0.79,39,41,63
OceanDNA-b43907,173,21.2,0.0,1.4e-08,2.5e-06,141,185,122,168,106,176,0.79,44,46,70
OceanDNA-b45587,130,7.9,0.0,8.2e-05,0.073,149,188,103,144,25,154,0.79,39,41,129
OceanDNA-b114,76,22.4,1.2,3.1e-09,1.4e-06,67,188,261,393,245,399,0.79,121,132,154
OceanDNA-b46638,597,25.1,0.0,8.9e-10,7.2e-07,144,243,166,265,149,281,0.79,99,99,132
OceanDNA-b22187,2507,10.4,0.0,1.4e-05,0.043,131,169,176,211,152,224,0.79,38,35,72
OceanDNA-b1965,72,18.8,0.0,3.9e-08,1.3e-05,75,176,52,158,47,164,0.79,101,106,117
OceanDNA-b466,104,10.5,0.0,3.7e-05,0.036,148,197,84,133,38,142,0.79,49,49,104
OceanDNA-b42263,77,15.2,0.1,4.8e-07,7.3e-05,88,176,77,169,61,176,0.79,88,92,115
OceanDNA-b41587,251,17.3,0.0,2.1e-07,7.1e-05,155,253,220,317,169,332,0.79,98,97,163
OceanDNA-b30082,342,13.8,0.0,2.5e-06,0.0022,153,183,163,193,148,228,0.79,30,30,80
OceanDNA-b13575,549,21.1,0.0,7.8e-09,8.2e-06,91,178,22,106,13,128,0.79,87,84,115
OceanDNA-b38636,415,-2.4,0.0,0.11,57.0,72,98,34,60,22,63,0.79,26,26,41
OceanDNA-b13590,1708,13.8,0.0,5.1e-06,0.0037,127,184,135,193,126,198,0.79,57,58,72
OceanDNA-b30346,1949,8.0,0.1,7.7e-05,0.16,151,188,104,141,82,161,0.79,37,37,79
OceanDNA-b37525,354,33.8,0.1,1e-12,2.3e-09,75,229,82,257,33,268,0.79,154,175,235
OceanDNA-b17564,1318,9.6,0.0,5e-05,0.05,153,206,522,575,504,581,0.79,53,53,77
OceanDNA-b2829,365,10.1,0.0,5e-05,0.052,145,188,63,106,53,118,0.79,43,43,65
OceanDNA-b28261,86,-1.7,0.0,0.065,19.0,157,181,55,79,50,96,0.79,24,24,46
OceanDNA-b38692,169,13.5,0.0,1.6e-06,0.00096,156,185,147,176,117,229,0.79,29,29,112
OceanDNA-b42513,128,6.7,0.0,0.00019,0.047,152,180,126,154,109,164,0.79,28,28,55
OceanDNA-b34275,864,13.6,0.0,2.8e-06,0.0013,158,180,156,178,134,192,0.79,22,22,58
OceanDNA-b37652,816,16.7,0.0,1.6e-07,0.00021,140,180,158,200,149,220,0.79,40,42,71
OceanDNA-a842,222,21.4,0.0,1.2e-08,2.3e-06,104,221,61,187,45,226,0.79,117,126,181
OceanDNA-b7395,173,19.0,0.0,3.4e-08,9.1e-06,151,194,142,186,123,220,0.79,43,44,97
OceanDNA-b17506,254,28.7,0.0,3.7e-11,2.9e-08,154,245,411,505,390,514,0.79,91,94,124
OceanDNA-b22871,3196,16.0,0.0,2.7e-07,0.0011,97,185,82,168,57,199,0.79,88,86,142
OceanDNA-b15480,240,14.0,0.0,2.2e-06,0.00057,195,243,206,252,198,276,0.79,48,46,78
OceanDNA-b31581,1882,7.9,0.0,7.9e-05,0.19,136,171,318,354,281,369,0.79,35,36,88
OceanDNA-b19603,348,8.1,0.0,0.00014,0.028,87,169,42,125,25,138,0.79,82,83,113
OceanDNA-b38353,422,11.4,0.0,1.4e-05,0.016,101,168,141,206,128,224,0.79,67,65,96
OceanDNA-b21040,270,39.6,0.1,5.3e-14,8.2e-11,87,188,18,123,8,136,0.79,101,105,128
OceanDNA-b17763,2384,13.9,0.0,1.2e-06,0.0048,141,183,189,230,154,240,0.79,42,41,86
OceanDNA-b1435,454,4.5,0.0,0.0027,0.75,196,246,235,281,217,297,0.79,50,46,80
OceanDNA-b26769,766,3.5,0.1,0.0036,3.6,159,188,130,159,108,168,0.79,29,29,60
OceanDNA-b40912,147,15.1,0.0,5.1e-07,0.00045,83,171,127,224,108,234,0.79,88,97,126
OceanDNA-b12605,314,11.7,0.0,5.6e-06,0.0036,153,255,159,262,93,275,0.79,102,103,182
OceanDNA-b34859,125,12.6,0.0,5.9e-06,0.0022,146,191,123,169,109,186,0.79,45,46,77
OceanDNA-b34859,257,12.9,0.0,4.9e-06,0.0018,139,183,141,186,128,198,0.79,44,45,70
OceanDNA-b22876,1950,12.0,0.0,9.3e-06,0.017,147,186,162,201,144,219,0.79,39,39,75
OceanDNA-b40444,376,17.9,0.0,2.8e-07,0.00013,178,245,282,354,277,359,0.79,67,72,82
OceanDNA-b22965,160,-1.7,0.0,0.2,300.0,140,161,293,314,265,318,0.79,21,21,53
OceanDNA-b33308,1563,87.4,3.2,9.8e-29,1.6e-25,22,106,64,146,42,146,0.79,84,82,104
OceanDNA-b3424,671,16.3,0.0,2.2e-07,0.00037,154,189,129,164,113,224,0.79,35,35,111
OceanDNA-b30,3126,10.9,0.3,1.9e-05,0.036,141,173,47,82,33,90,0.79,32,35,57
OceanDNA-b16140,405,9.9,0.0,3.8e-05,0.017,235,280,506,553,494,565,0.79,45,47,71
OceanDNA-b15879,188,10.9,0.0,2e-05,0.017,143,217,151,222,133,271,0.79,74,71,138
OceanDNA-b41544,516,6.4,0.1,0.00045,0.25,145,172,143,170,124,177,0.79,27,27,53
OceanDNA-b2809,605,10.1,0.1,1.7e-05,0.034,146,187,130,171,118,176,0.79,41,41,58
OceanDNA-b42307,214,18.3,0.1,5.3e-08,1.2e-05,82,176,62,160,52,171,0.79,94,98,119
OceanDNA-b6447,204,5.9,0.0,0.00033,0.16,202,265,192,253,177,260,0.79,63,61,83
OceanDNA-b42274,30,15.4,0.1,4.2e-07,8.6e-05,85,176,87,182,73,189,0.79,91,95,116
OceanDNA-b1738,1441,10.9,0.1,2.9e-05,0.035,137,191,114,172,88,209,0.79,54,58,121
OceanDNA-b16121,452,-3.2,0.0,0.19,150.0,253,278,509,534,507,543,0.79,25,25,36
OceanDNA-b19612,423,14.6,0.0,1.4e-06,0.00045,126,209,215,303,207,317,0.79,83,88,110
OceanDNA-b19147,356,13.5,0.0,3.1e-06,0.00055,183,216,269,302,256,343,0.79,33,33,87
OceanDNA-b13073,695,10.7,0.0,1.1e-05,0.0099,89,180,183,272,169,287,0.79,91,89,118
OceanDNA-b19690,88,13.8,0.0,2.6e-06,0.00057,127,191,270,338,262,358,0.79,64,68,96
OceanDNA-b32861,681,4.9,0.0,0.0013,0.82,184,229,265,310,242,325,0.79,45,45,83
OceanDNA-b23556,1878,13.0,0.1,4.4e-06,0.0051,152,174,255,277,239,294,0.79,22,22,55
OceanDNA-b43874,51,19.9,0.0,1.8e-08,1.1e-05,139,180,124,167,111,183,0.79,41,43,72
OceanDNA-b28576,324,8.9,0.0,3.8e-05,0.019,193,263,219,287,213,298,0.79,70,68,85
OceanDNA-b16046,1508,-3.1,0.0,0.18,520.0,198,217,263,282,258,297,0.79,19,19,39
OceanDNA-b34662,91,0.3,0.0,0.016,14.0,78,103,11,36,9,51,0.79,25,25,42
OceanDNA-b30676,105,-1.6,0.0,0.064,110.0,123,165,38,79,34,111,0.79,42,41,77
OceanDNA-b34924,841,17.7,0.0,1.7e-07,8.5e-05,156,183,173,200,152,217,0.79,27,27,65
OceanDNA-b19681,171,19.5,0.0,2.4e-08,8.7e-06,152,238,142,229,104,248,0.79,86,87,144
OceanDNA-b3920,1177,15.3,0.0,1.3e-06,0.00084,99,189,129,228,91,273,0.79,90,99,182
OceanDNA-b17690,254,10.3,0.0,1.5e-05,0.029,126,185,108,167,90,181,0.79,59,59,91
OceanDNA-b29589,161,20.9,0.1,1.8e-08,2.9e-05,84,175,130,228,117,233,0.79,91,98,116
OceanDNA-b12396,228,29.9,0.0,1.6e-11,6.2e-09,158,237,145,227,122,247,0.79,79,82,125
OceanDNA-b4346,139,-2.2,0.0,0.2,24.0,154,189,354,389,352,397,0.79,35,35,45
OceanDNA-b23064,375,47.0,0.0,1e-16,1.5e-13,84,244,95,267,66,280,0.79,160,172,214
OceanDNA-b4346,139,13.8,0.0,2.6e-06,0.00032,198,264,433,501,423,504,0.79,66,68,81
OceanDNA-b23367,1754,11.9,0.0,9.5e-06,0.0098,160,182,170,192,148,204,0.79,22,22,56
OceanDNA-b46830,927,25.4,0.0,3.6e-10,7.8e-07,133,218,53,142,8,150,0.79,85,89,142
OceanDNA-b265,134,35.0,0.0,8.8e-13,7.8e-10,150,244,150,247,119,253,0.79,94,97,134
OceanDNA-b47081,449,12.8,0.0,5e-06,0.0015,153,190,196,234,147,273,0.79,37,38,126
OceanDNA-b15137,533,14.8,0.0,2e-06,0.0014,157,224,141,209,118,243,0.79,67,68,125
OceanDNA-b38499,23,29.3,0.1,2.4e-11,2.4e-08,82,172,138,240,122,245,0.79,90,102,123
OceanDNA-b32628,251,10.6,0.0,1.2e-05,0.004,92,183,56,151,51,172,0.79,91,95,121
OceanDNA-b23096,1267,10.2,0.0,1.6e-05,0.054,91,189,148,251,138,262,0.79,98,103,124
OceanDNA-b46310,870,11.0,0.0,9.3e-06,0.015,154,184,1,31,1,79,0.79,30,30,78
OceanDNA-b11387,576,11.4,0.0,1.4e-05,0.0042,145,192,306,353,287,383,0.79,47,47,96
OceanDNA-b45457,349,10.8,0.0,2.1e-05,0.0059,131,174,124,162,99,181,0.79,43,38,82
OceanDNA-b15630,121,16.8,0.1,1.6e-07,7.3e-05,80,188,26,142,16,152,0.79,108,116,136
OceanDNA-b13087,1025,10.0,0.6,1.8e-05,0.032,76,173,159,255,138,262,0.79,97,96,124
OceanDNA-b22127,244,34.3,1.5,7.1e-13,1.2e-09,53,173,247,375,242,382,0.79,120,128,140
OceanDNA-b35246,714,11.2,0.0,7.8e-06,0.0056,102,126,68,92,43,104,0.79,24,24,61
OceanDNA-b17590,334,15.5,0.0,3.9e-07,0.0014,151,222,146,217,122,240,0.79,71,71,118
OceanDNA-b44852,144,22.6,0.0,2.7e-09,1.8e-06,72,188,20,147,4,210,0.79,116,127,206
OceanDNA-b22566,1178,19.6,0.0,4.3e-08,2.6e-05,153,198,151,197,140,253,0.79,45,46,113
OceanDNA-b33329,584,7.1,0.0,0.00043,0.22,142,174,144,176,111,186,0.79,32,32,75
OceanDNA-b45457,346,13.3,0.0,3.5e-06,0.00096,153,189,156,193,138,262,0.79,36,37,124
OceanDNA-b8260,48,10.2,0.0,3.2e-05,0.0043,103,169,146,210,120,222,0.79,66,64,102
OceanDNA-b31692,265,3.7,0.0,0.0015,1.7,195,264,205,272,198,280,0.79,69,67,82
OceanDNA-b44376,357,-3.5,0.0,0.24,130.0,195,213,299,317,296,330,0.79,18,18,34
OceanDNA-b25263,174,1.8,0.0,0.0058,1.4,157,180,124,147,84,178,0.79,23,23,94
OceanDNA-b45442,308,11.7,0.1,1.1e-05,0.0085,151,181,216,246,199,257,0.79,30,30,58
OceanDNA-b46258,827,10.6,0.0,1.2e-05,0.017,59,172,84,203,35,239,0.79,113,119,204
OceanDNA-b46656,816,26.6,0.0,4.7e-10,5.3e-07,153,244,226,319,200,331,0.79,91,93,131
OceanDNA-b19314,92,13.2,0.0,1.9e-06,0.00064,143,171,124,152,85,158,0.79,28,28,73
OceanDNA-b937,2162,0.7,0.0,0.012,27.0,145,180,83,118,63,128,0.79,35,35,65
OceanDNA-b950,1681,13.0,0.1,4.5e-06,0.0048,138,183,83,127,70,164,0.79,45,44,94
OceanDNA-b13570,390,6.1,0.0,0.00083,0.37,191,251,178,236,162,248,0.79,60,58,86
OceanDNA-b26756,121,18.1,0.0,6.1e-08,8.1e-05,147,181,130,166,115,179,0.79,34,36,64
OceanDNA-b23482,159,10.4,0.0,1.4e-05,0.021,159,187,155,183,138,197,0.79,28,28,59
OceanDNA-b29526,542,10.0,0.0,1.9e-05,0.053,145,186,166,208,146,222,0.79,41,42,76
OceanDNA-b37960,390,13.0,0.0,6.9e-06,0.0013,145,191,78,124,70,134,0.78,46,46,64
OceanDNA-b37412,411,13.2,0.0,3.8e-06,0.0012,152,192,110,150,88,195,0.78,40,40,107
OceanDNA-b3385,1277,2.4,0.0,0.0078,13.0,197,226,326,354,315,378,0.78,29,28,63
OceanDNA-b18470,311,19.0,0.0,6.7e-08,1.1e-05,143,189,293,335,264,399,0.78,46,42,135
OceanDNA-a3351,125,18.1,0.0,6.3e-08,2.7e-05,153,199,199,246,181,274,0.78,46,47,93
OceanDNA-b22391,1504,11.8,0.0,1.6e-05,0.0098,138,179,439,480,433,497,0.78,41,41,64
OceanDNA-b27542,1349,7.6,0.0,0.00029,0.21,161,199,119,161,43,173,0.78,38,42,130
OceanDNA-b47105,25,0.3,0.0,0.017,5.2,161,181,138,158,117,167,0.78,20,20,50
OceanDNA-b36729,927,6.3,0.1,0.00025,0.55,85,152,143,209,97,223,0.78,67,66,126
OceanDNA-b30046,1421,8.2,0.0,0.00013,0.2,167,227,274,336,268,360,0.78,60,62,92
OceanDNA-b40471,15,60.9,0.0,5.7e-21,1e-17,92,269,132,308,106,325,0.78,177,176,219
OceanDNA-b2880,2219,12.3,0.0,3.6e-06,0.014,116,180,18,87,7,92,0.78,64,69,85
OceanDNA-b41544,516,-0.8,0.0,0.071,39.0,223,270,247,296,237,319,0.78,47,49,82
OceanDNA-b16140,405,10.0,0.0,3.6e-05,0.017,144,177,346,379,329,404,0.78,33,33,75
OceanDNA-b44721,159,10.4,0.0,1.4e-05,0.007,140,179,123,164,116,178,0.78,39,41,62
OceanDNA-b4022,184,29.4,0.0,4.6e-11,2.8e-08,82,175,136,241,116,246,0.78,93,105,130
OceanDNA-b21737,42,12.6,0.0,2.9e-06,0.00047,83,180,40,141,33,152,0.78,97,101,119
OceanDNA-b21043,1056,22.6,0.0,7.8e-09,4.6e-06,76,193,56,176,8,243,0.78,117,120,235
OceanDNA-b33328,841,4.1,0.0,0.0022,1.3,199,232,278,311,271,348,0.78,33,33,77
OceanDNA-b20900,1297,16.4,0.1,2.1e-07,0.00044,145,178,58,91,6,154,0.78,33,33,148
OceanDNA-b37047,313,26.1,0.1,2.3e-10,1.7e-07,151,192,183,224,156,235,0.78,41,41,79
OceanDNA-b35067,459,10.3,0.0,1.5e-05,0.013,157,185,146,174,119,182,0.78,28,28,63
OceanDNA-b30787,852,13.9,0.1,1.2e-06,0.0012,77,185,28,142,18,148,0.78,108,114,130
OceanDNA-b37076,208,10.0,0.0,1.8e-05,0.02,152,193,246,287,215,297,0.78,41,41,82
OceanDNA-b16133,287,32.7,0.0,6.7e-12,2.5e-09,67,176,226,346,205,359,0.78,109,120,154
OceanDNA-b33328,1067,3.2,0.0,0.0042,2.4,195,236,185,225,181,253,0.78,41,40,72
OceanDNA-b22827,3848,14.1,0.0,2e-06,0.005,154,187,152,186,137,229,0.78,33,34,92
OceanDNA-b16117,541,0.7,0.0,0.025,9.5,196,224,218,246,208,270,0.78,28,28,62
OceanDNA-b22905,478,17.6,0.0,2.7e-07,0.00025,60,212,82,247,65,299,0.78,152,165,234
OceanDNA-b38590,329,14.8,0.0,6.3e-07,0.00043,76,190,29,147,8,181,0.78,114,118,173
OceanDNA-b38975,783,11.1,0.0,1.7e-05,0.019,140,180,137,178,125,191,0.78,40,41,66
OceanDNA-b30624,1496,11.4,0.1,7.1e-06,0.012,41,83,113,153,93,179,0.78,42,40,86
OceanDNA-b30447,350,7.9,0.1,8e-05,0.21,158,230,256,332,240,350,0.78,72,76,110
OceanDNA-b32265,1592,2.6,0.0,0.0032,5.8,195,264,213,283,205,287,0.78,69,70,82
OceanDNA-b15128,974,12.8,0.1,2.5e-06,0.003,74,174,17,121,2,135,0.78,100,104,133
OceanDNA-b17621,378,26.3,0.0,2e-10,2.4e-07,149,215,179,251,156,262,0.78,66,72,106
OceanDNA-b19403,295,14.1,0.0,1e-06,0.00032,128,190,263,329,253,349,0.78,62,66,96
OceanDNA-b41273,1430,10.2,0.2,3.3e-05,0.031,146,187,206,247,181,252,0.78,41,41,71
OceanDNA-b12508,394,12.0,0.0,4.4e-06,0.0031,155,183,89,117,67,133,0.78,28,28,66
OceanDNA-b41340,796,53.4,0.0,3.2e-18,1.5e-15,72,270,51,260,33,275,0.78,198,209,242
OceanDNA-b15515,1821,24.7,0.0,6.3e-10,1.3e-06,106,212,121,240,117,251,0.78,106,119,134
OceanDNA-b22380,743,16.4,0.0,6.3e-07,0.00033,128,185,136,192,125,221,0.78,57,56,96
OceanDNA-b13281,1727,12.6,0.0,6e-06,0.0055,149,185,81,120,64,141,0.78,36,39,77
OceanDNA-b45848,879,15.0,0.0,5.5e-07,0.0011,147,200,184,239,175,249,0.78,53,55,74
OceanDNA-b13250,3119,18.1,0.2,6.3e-07,0.00026,107,189,218,298,173,313,0.78,82,80,140
OceanDNA-b23549,551,11.9,0.0,1.4e-05,0.0093,105,211,195,311,164,318,0.78,106,116,154
OceanDNA-b34551,807,-2.9,0.0,0.48,140.0,198,222,238,262,234,288,0.78,24,24,54
OceanDNA-b25052,124,15.0,0.0,1.1e-06,0.00056,153,217,88,152,49,169,0.78,64,64,120
OceanDNA-b21002,2996,22.2,0.1,1.1e-08,2e-05,84,181,185,295,161,304,0.78,97,110,143
OceanDNA-b42838,244,10.3,0.0,1.5e-05,0.004,158,181,144,167,120,185,0.78,23,23,65
OceanDNA-b3599,614,16.8,0.0,3.1e-07,0.00012,79,187,90,207,83,217,0.78,108,117,134
OceanDNA-b17761,2082,13.3,0.0,1.9e-06,0.0056,129,191,214,278,178,307,0.78,62,64,129
OceanDNA-b5611,820,13.6,0.0,1.5e-06,0.002,137,191,371,427,365,441,0.78,54,56,76
OceanDNA-b15326,263,-2.0,0.0,0.083,24.0,193,225,238,270,225,277,0.78,32,32,52
OceanDNA-b41265,427,9.4,0.0,2.9e-05,0.039,186,228,138,178,123,204,0.78,42,40,81
OceanDNA-b36408,291,12.4,0.0,3.5e-06,0.0078,51,186,43,183,4,190,0.78,135,140,186
OceanDNA-b23944,1715,16.6,0.0,1.8e-07,0.00031,204,271,198,263,181,275,0.78,67,65,94
OceanDNA-b310,105,32.5,0.0,5.2e-12,3.8e-09,149,244,131,228,100,235,0.78,95,97,135
OceanDNA-b19120,158,22.3,0.0,6.7e-09,1.1e-06,148,218,113,185,78,232,0.78,70,72,154
OceanDNA-b147,45,19.1,0.1,3.2e-08,2.8e-05,77,173,90,195,56,201,0.78,96,105,145
OceanDNA-b20674,70,17.0,0.0,1.3e-07,4.1e-05,196,272,240,319,234,337,0.78,76,79,103
OceanDNA-b33192,401,0.2,0.0,0.036,7.7,131,158,79,104,74,110,0.78,27,25,36
OceanDNA-b20036,199,36.3,0.0,5.5e-13,7e-11,72,188,97,222,76,230,0.78,116,125,154
OceanDNA-b41003,1014,44.1,0.2,7.8e-16,2.2e-12,102,268,94,260,9,283,0.78,166,166,274
OceanDNA-b23298,1775,11.8,0.1,5e-06,0.0098,113,185,111,181,95,188,0.78,72,70,93
OceanDNA-b17623,2903,-1.5,0.0,0.12,180.0,58,80,197,219,185,224,0.78,22,22,39
OceanDNA-b16107,394,9.3,0.0,3e-05,0.021,181,246,399,466,390,479,0.78,65,67,89
OceanDNA-b6749,448,18.0,0.0,6.6e-08,4.3e-05,86,189,145,251,137,257,0.78,103,106,120
OceanDNA-b37054,2298,21.9,0.6,8.9e-09,1.4e-05,75,231,82,256,13,270,0.78,156,174,257
OceanDNA-b40635,555,150.1,0.2,3.8e-48,2.3e-45,13,272,21,300,7,315,0.78,259,279,308
OceanDNA-b22759,861,13.5,0.1,3e-06,0.0016,153,199,160,207,143,219,0.78,46,47,76
OceanDNA-b9927,6,1.7,0.0,0.0064,2.3,194,235,212,252,206,270,0.78,41,40,64
OceanDNA-b3626,407,10.1,0.0,1.7e-05,0.021,194,230,227,263,204,293,0.78,36,36,89
OceanDNA-b22391,1632,28.4,0.1,1.3e-10,8.3e-08,153,213,174,238,160,248,0.78,60,64,88
OceanDNA-b30852,1197,21.7,0.0,1e-08,1e-05,85,183,73,179,45,186,0.78,98,106,141
OceanDNA-b22654,53,12.6,0.0,1.5e-05,0.0036,153,216,150,213,129,238,0.78,63,63,109
OceanDNA-b2578,226,11.8,0.0,5e-06,0.002,155,182,244,271,209,289,0.78,27,27,80
OceanDNA-b960,417,36.9,0.1,1.1e-13,2.4e-10,92,247,257,419,247,426,0.78,155,162,179
OceanDNA-b35325,133,5.8,0.0,0.00035,0.19,181,219,192,230,188,262,0.78,38,38,74
OceanDNA-b18171,65,-3.9,0.0,0.32,55.0,107,120,38,51,14,56,0.78,13,13,42
OceanDNA-b18171,65,24.5,0.0,6.8e-10,1.2e-07,143,208,111,180,98,189,0.78,65,69,91
OceanDNA-b20967,119,22.6,0.0,2.6e-09,3.9e-06,88,172,145,238,128,255,0.78,84,93,127
OceanDNA-b13103,184,10.7,0.0,2.2e-05,0.01,153,187,148,182,142,218,0.78,34,34,76
OceanDNA-b40669,443,33.1,0.0,3.4e-12,1.1e-09,153,244,160,258,110,275,0.78,91,98,165
OceanDNA-b29,3604,11.1,0.0,3.4e-05,0.044,135,175,181,222,172,228,0.78,40,41,56
OceanDNA-b26051,249,17.6,0.0,9e-08,3.2e-05,154,180,19,45,2,74,0.78,26,26,72
OceanDNA-b2829,55,15.0,0.0,1.6e-06,0.0017,182,243,210,268,190,284,0.78,61,58,94
OceanDNA-b3547,369,10.9,0.0,9.7e-06,0.0071,156,181,105,130,86,143,0.78,25,25,57
OceanDNA-b44154,508,-2.9,0.0,0.16,83.0,35,53,304,322,295,331,0.78,18,18,36
OceanDNA-b30747,684,19.5,0.1,2.3e-08,3e-05,94,193,42,137,29,169,0.78,99,95,140
OceanDNA-b21004,1385,8.0,0.0,0.00022,0.14,191,245,327,375,319,386,0.78,54,48,67
OceanDNA-b13288,867,4.2,0.1,0.0011,1.1,14,53,9,48,2,73,0.78,39,39,71
OceanDNA-b20705,111,47.1,0.3,9.4e-17,2.2e-14,54,175,60,188,57,212,0.78,121,128,155
OceanDNA-b36158,534,15.7,0.2,6.5e-07,0.0006,147,217,35,107,20,120,0.78,70,72,100
OceanDNA-b31948,360,15.5,0.1,7.9e-07,0.0009,127,181,987,1044,984,1056,0.78,54,57,72
OceanDNA-b7465,21,10.8,0.0,1e-05,0.0045,152,196,200,245,172,272,0.78,44,45,100
OceanDNA-b38999,1473,13.1,0.1,4.1e-06,0.0045,107,185,150,239,132,262,0.78,78,89,130
OceanDNA-b466,148,7.4,0.0,0.00035,0.34,191,221,268,297,213,322,0.78,30,29,109
OceanDNA-b32084,1484,16.0,0.1,5.3e-07,0.00086,131,174,253,293,247,308,0.78,43,40,61
OceanDNA-b31537,1880,12.4,0.2,3.3e-06,0.0074,140,187,118,168,96,173,0.78,47,50,77
OceanDNA-b26844,1735,5.9,0.0,0.00032,1.0,197,264,199,264,187,271,0.78,67,65,84
OceanDNA-b20974,1857,30.1,0.2,1.4e-11,3.9e-08,76,177,371,478,340,482,0.78,101,107,142
OceanDNA-b26571,13,27.4,0.0,1.9e-10,7.5e-08,141,184,134,179,126,197,0.78,43,45,71
OceanDNA-b34892,191,38.5,0.3,7.4e-14,3.4e-11,82,173,166,271,136,275,0.78,91,105,139
OceanDNA-b24051,228,19.0,0.0,3.3e-08,1.8e-05,79,178,21,125,9,214,0.78,99,104,205
OceanDNA-b35333,154,14.3,0.0,9.1e-07,0.0003,191,265,239,313,228,314,0.78,74,74,86
OceanDNA-b32139,30,3.1,0.0,0.0048,5.6,220,264,243,286,190,289,0.78,44,43,99
OceanDNA-b37122,207,-0.4,0.0,0.028,27.0,197,227,204,233,195,244,0.78,30,29,49
OceanDNA-b44623,260,9.2,0.0,3.3e-05,0.071,195,247,611,663,606,678,0.78,52,52,72
OceanDNA-b4053,69,12.6,0.0,8.6e-06,0.002,152,237,97,188,81,209,0.78,85,91,128
OceanDNA-b22191,919,12.4,0.0,3.4e-06,0.0069,136,190,129,182,110,190,0.78,54,53,80
OceanDNA-b20096,228,18.6,0.1,8.7e-08,1.4e-05,89,174,102,192,88,199,0.78,85,90,111
OceanDNA-b45984,1104,13.7,0.0,1.3e-06,0.0015,186,241,40,98,26,106,0.78,55,58,80
OceanDNA-b36441,360,16.5,0.0,3.8e-07,0.00052,97,179,129,210,97,225,0.78,82,81,128
OceanDNA-b19590,449,28.3,0.0,4.7e-11,2.2e-08,149,225,125,203,114,233,0.78,76,78,119
OceanDNA-b9486,252,17.0,0.0,1.3e-07,4.6e-05,151,188,134,174,121,186,0.78,37,40,65
OceanDNA-b45686,408,24.2,0.0,9e-10,4.8e-07,148,189,157,199,138,255,0.78,41,42,117
OceanDNA-b10747,219,11.1,0.0,8.5e-06,0.005,149,191,165,208,149,263,0.78,42,43,114
OceanDNA-b20705,111,18.0,0.0,6.9e-08,1.7e-05,220,275,262,318,234,333,0.78,55,56,99
OceanDNA-b23139,2350,14.3,0.3,1.8e-06,0.0021,135,174,151,184,91,212,0.78,39,33,121
OceanDNA-b3626,407,9.5,0.0,2.6e-05,0.032,148,180,98,131,87,212,0.78,32,33,125
OceanDNA-b6501,215,-1.1,0.0,0.13,23.0,151,189,529,567,513,574,0.78,38,38,61
OceanDNA-b517,1813,16.4,0.0,2.1e-07,0.00081,154,187,228,262,212,266,0.78,33,34,54
OceanDNA-b40453,184,28.0,0.0,1.2e-10,7.2e-08,80,172,134,238,112,244,0.78,92,104,132
OceanDNA-b32763,549,16.0,0.1,2.7e-07,0.00042,140,181,99,140,23,157,0.78,41,41,134
OceanDNA-b12722,62,-3.1,0.0,0.19,43.0,161,172,129,140,112,149,0.78,11,11,37
OceanDNA-b44160,136,11.6,0.0,5.9e-06,0.0038,147,185,71,109,41,149,0.78,38,38,108
OceanDNA-b40713,137,-1.6,0.0,0.063,51.0,58,80,189,211,177,214,0.78,22,22,37
OceanDNA-b23104,2216,10.1,0.0,5.1e-05,0.069,150,212,401,472,378,484,0.78,62,71,106
OceanDNA-b23825,839,1.8,0.0,0.012,9.1,198,254,258,312,251,321,0.78,56,54,70
OceanDNA-b32763,549,-3.7,0.0,0.27,430.0,202,218,242,258,238,266,0.78,16,16,28
OceanDNA-b26869,83,1.7,0.1,0.0062,20.0,200,266,350,414,343,416,0.78,66,64,73
OceanDNA-b32721,1677,10.3,0.0,2.9e-05,0.033,149,184,238,273,185,284,0.78,35,35,99
OceanDNA-b38880,297,29.7,0.1,3.7e-11,1.8e-08,82,175,118,223,114,232,0.78,93,105,118
OceanDNA-b4005,288,21.0,0.0,1.6e-08,9.1e-06,83,189,156,265,145,271,0.78,106,109,126
OceanDNA-b11611,607,14.8,0.0,6.4e-07,0.00057,153,217,179,245,173,275,0.78,64,66,102
OceanDNA-b38880,867,15.1,0.0,1e-06,0.00047,138,188,84,137,66,145,0.78,50,53,79
OceanDNA-b30042,2568,12.5,0.0,9.7e-06,0.011,140,181,146,188,141,208,0.78,41,42,67
OceanDNA-b11514,128,13.7,0.0,1.4e-06,0.00037,153,232,133,212,108,242,0.78,79,79,134
OceanDNA-b37960,81,12.6,0.0,8.6e-06,0.0016,197,262,341,406,333,409,0.78,65,65,76
OceanDNA-b21042,1174,13.4,0.5,1.7e-06,0.0043,89,185,320,414,302,418,0.78,96,94,116
OceanDNA-b4044,627,23.1,0.0,1.9e-09,1.8e-06,107,189,161,248,139,257,0.78,82,87,118
OceanDNA-b12909,177,18.4,0.0,5.1e-08,3.2e-05,136,190,124,175,77,217,0.78,54,51,140
OceanDNA-b36617,613,15.2,0.0,9.4e-07,0.00047,139,180,137,179,123,191,0.78,41,42,68
OceanDNA-b35141,781,11.9,0.0,4.7e-06,0.0053,140,184,141,186,134,196,0.78,44,45,62
OceanDNA-b40629,357,4.8,0.0,0.00068,0.42,196,261,217,278,144,280,0.78,65,61,136
OceanDNA-b22423,1899,19.6,0.0,4.3e-08,5e-05,152,218,130,200,115,219,0.78,66,70,104
OceanDNA-b15286,45,12.3,0.0,7.3e-06,0.00093,149,220,108,182,92,210,0.78,71,74,118
OceanDNA-b4324,224,19.1,0.0,3e-08,7e-06,89,176,78,170,63,178,0.78,87,92,115
OceanDNA-b41349,857,97.6,0.0,7.5e-32,4.5e-29,30,274,35,291,11,308,0.78,244,256,297
OceanDNA-b37859,480,0.6,0.0,0.013,12.0,153,189,625,661,611,675,0.78,36,36,64
OceanDNA-b37859,480,20.3,0.0,1.4e-08,1.3e-05,197,269,704,778,677,782,0.78,72,74,105
OceanDNA-b46823,662,16.0,0.0,8e-07,0.00048,154,188,139,174,120,210,0.78,34,35,90
OceanDNA-b36650,251,13.6,0.0,1.5e-06,0.00052,157,183,140,166,112,181,0.78,26,26,69
OceanDNA-b4111,10,-3.6,0.0,0.25,160.0,107,122,59,74,55,86,0.78,15,15,31
OceanDNA-b17625,3689,9.5,0.0,2.6e-05,0.1,142,185,161,205,142,215,0.78,43,44,73
OceanDNA-b20957,1657,12.8,0.0,5.1e-06,0.01,30,88,30,88,5,102,0.78,58,58,97
OceanDNA-b45095,81,10.4,0.0,1.4e-05,0.011,134,174,77,114,51,141,0.78,40,37,90
OceanDNA-b17633,332,11.1,0.0,8.8e-06,0.0065,192,230,234,271,223,301,0.78,38,37,78
OceanDNA-b36709,945,16.6,0.0,1.7e-07,0.0003,71,185,55,169,40,196,0.78,114,114,156
OceanDNA-b3676,275,5.2,0.0,0.00051,1.6,201,265,220,282,204,286,0.78,64,62,82
OceanDNA-b4002,1204,11.2,0.0,1.6e-05,0.011,107,197,132,229,103,256,0.78,90,97,153
OceanDNA-b40453,373,12.2,0.0,8.1e-06,0.0049,142,181,193,231,161,254,0.78,39,38,93
OceanDNA-b22387,366,-3.2,0.0,0.38,420.0,105,122,176,193,165,194,0.78,17,17,29
OceanDNA-b41176,1182,42.6,0.1,2.2e-15,4.9e-12,92,271,108,287,19,304,0.78,179,179,285
OceanDNA-b27556,997,14.7,0.1,1.4e-06,0.0015,123,191,94,161,84,185,0.78,68,67,101
OceanDNA-b19229,137,23.0,0.0,1.9e-09,6.4e-07,148,217,144,215,108,244,0.78,69,71,136
OceanDNA-b22616,3362,10.7,0.1,3.3e-05,0.049,140,181,150,187,142,198,0.78,41,37,56
OceanDNA-b22890,496,17.9,0.0,2.1e-07,0.00015,151,217,172,240,153,259,0.78,66,68,106
OceanDNA-b30627,591,2.7,0.0,0.0031,2.9,175,246,279,355,268,364,0.78,71,76,96
OceanDNA-b40889,252,9.8,0.1,4.2e-05,0.013,109,169,132,190,125,202,0.78,60,58,77
OceanDNA-b30206,381,4.8,0.0,0.0014,1.6,175,245,272,347,258,358,0.78,70,75,100
OceanDNA-b26842,552,4.1,0.0,0.0023,2.5,179,245,310,381,295,390,0.78,66,71,95
OceanDNA-b23165,145,0.4,0.0,0.015,45.0,101,121,147,167,121,181,0.78,20,20,60
OceanDNA-b15447,354,-3.1,0.0,0.18,66.0,85,105,269,289,265,292,0.78,20,20,27
OceanDNA-b2928,1170,8.8,0.1,4.1e-05,0.049,151,180,143,172,80,175,0.78,29,29,95
OceanDNA-b38495,572,24.7,0.0,1.8e-09,5.1e-07,89,175,109,202,98,217,0.78,86,93,119
OceanDNA-b36153,427,5.2,0.0,0.00052,0.61,194,265,190,259,178,265,0.78,71,69,87
OceanDNA-b38495,763,11.2,0.0,2.4e-05,0.0065,136,180,123,168,111,187,0.78,44,45,76
OceanDNA-b36153,427,8.1,0.0,6.9e-05,0.081,158,197,109,152,46,156,0.78,39,43,110
OceanDNA-b17084,288,-1.3,0.0,0.099,54.0,158,179,147,168,112,176,0.78,21,21,64
OceanDNA-b16123,12,0.8,0.0,0.024,8.8,196,223,210,237,195,254,0.78,27,27,59
OceanDNA-b37833,583,9.5,0.0,5.2e-05,0.027,161,183,98,120,80,144,0.78,22,22,64
OceanDNA-b42278,58,16.1,0.1,2.6e-07,5.4e-05,84,175,65,160,54,165,0.78,91,95,111
OceanDNA-b36473,1282,9.6,0.5,2.4e-05,0.077,149,186,88,124,66,131,0.78,37,36,65
OceanDNA-b2514,271,1.6,0.0,0.0068,4.9,198,243,98,140,77,149,0.78,45,42,72
OceanDNA-b38974,977,13.3,0.1,1.7e-06,0.0026,105,185,85,176,15,201,0.78,80,91,186
OceanDNA-b38596,380,15.8,0.0,3.2e-07,0.00015,140,185,15,61,12,75,0.78,45,46,63
OceanDNA-b23283,114,7.9,0.0,8.2e-05,0.037,205,268,232,293,215,311,0.78,63,61,96
OceanDNA-b22306,164,11.6,0.1,1.2e-05,0.01,78,169,103,195,75,206,0.78,91,92,131
OceanDNA-b14104,303,12.2,0.0,1.2e-05,0.0019,151,213,153,218,135,249,0.78,62,65,114
OceanDNA-b6291,245,8.0,0.0,7.7e-05,0.044,149,177,115,143,26,156,0.78,28,28,130
OceanDNA-b13229,420,-0.9,0.0,0.078,26.0,153,181,93,121,70,134,0.78,28,28,64
OceanDNA-b46644,141,32.9,0.0,2e-12,2.7e-09,147,213,143,215,123,246,0.78,66,72,123
OceanDNA-b31989,707,8.7,0.0,4.6e-05,0.11,192,256,206,266,196,273,0.78,64,60,77
OceanDNA-b31989,707,2.0,0.1,0.005,12.0,136,181,81,125,61,145,0.78,45,44,84
OceanDNA-b36071,125,5.8,0.1,0.00069,0.72,198,266,197,263,162,268,0.78,68,66,106
OceanDNA-b9659,37,2.2,0.0,0.0042,2.4,180,247,283,356,258,364,0.78,67,73,106
OceanDNA-b41152,26,69.0,0.9,4e-23,4.5e-20,7,271,37,306,31,327,0.78,264,269,296
OceanDNA-b1353,1714,9.6,0.1,7.5e-05,0.097,98,174,114,189,97,203,0.78,76,75,106
OceanDNA-b46921,2201,27.3,0.0,2e-10,2.4e-07,120,189,156,224,147,274,0.78,69,68,127
OceanDNA-b37345,482,-3.4,0.0,0.65,300.0,158,196,161,199,152,200,0.78,38,38,48
OceanDNA-b46298,1400,-3.2,0.0,0.2,930.0,62,89,609,636,605,640,0.78,27,27,35
OceanDNA-b40473,212,8.2,0.0,0.00019,0.069,109,181,143,211,121,225,0.78,72,68,104
OceanDNA-b3653,1280,5.6,0.0,0.0016,0.9,161,187,123,149,68,187,0.78,26,26,119
OceanDNA-b38527,545,9.3,0.0,3e-05,0.02,143,187,63,106,46,134,0.78,44,43,88
OceanDNA-b23089,2834,32.0,0.0,7.1e-12,1.4e-08,149,227,158,237,81,268,0.78,78,79,187
OceanDNA-b9151,162,28.1,0.1,5.4e-11,1.7e-08,84,177,127,231,91,251,0.78,93,104,160
OceanDNA-b30849,481,9.8,0.0,2.1e-05,0.02,161,197,111,151,42,157,0.78,36,40,115
OceanDNA-b7219,294,-2.3,0.0,0.11,35.0,194,215,208,229,204,237,0.78,21,21,33
OceanDNA-b17033,596,-1.7,0.0,0.14,110.0,187,215,208,236,202,249,0.78,28,28,47
OceanDNA-b46520,903,9.9,0.0,2e-05,0.038,129,193,113,176,95,183,0.78,64,63,88
OceanDNA-b28110,1919,17.3,0.0,1.1e-07,0.00026,70,186,251,367,219,402,0.78,116,116,183
OceanDNA-b1712,1930,4.1,0.0,0.0011,3.0,154,218,141,207,130,237,0.78,64,66,107
OceanDNA-b34824,164,13.5,0.0,1.6e-06,0.00093,151,185,88,123,25,143,0.78,34,35,118
OceanDNA-b4491,657,5.7,0.0,0.00076,0.27,178,246,277,350,273,358,0.78,68,73,85
OceanDNA-b36084,2329,-0.3,0.0,0.025,67.0,75,121,194,242,143,264,0.78,46,48,121
OceanDNA-b22991,4364,11.7,0.1,1.7e-05,0.025,103,185,72,153,56,170,0.78,82,81,114
OceanDNA-b23145,1394,0.9,0.0,0.022,23.0,92,121,73,102,63,113,0.78,29,29,50
OceanDNA-b16182,508,17.8,0.0,8e-08,5.1e-05,130,194,233,300,214,343,0.78,64,67,129
OceanDNA-b46427,155,10.4,0.0,1.4e-05,0.0085,153,202,175,225,141,240,0.78,49,50,99
OceanDNA-b23145,1394,21.3,0.0,1.3e-08,1.4e-05,145,245,147,243,129,254,0.78,100,96,125
OceanDNA-b26870,727,3.4,0.0,0.0018,5.6,179,245,276,347,261,360,0.78,66,71,99
OceanDNA-b30938,1023,14.5,0.0,2.4e-06,0.002,101,212,119,240,74,289,0.78,111,121,215
OceanDNA-b23984,1143,0.3,0.0,0.032,28.0,229,264,224,260,190,263,0.78,35,36,73
OceanDNA-b30938,1427,22.5,0.0,8.3e-09,6.9e-06,87,182,69,172,62,184,0.78,95,103,122
OceanDNA-b44609,779,11.9,0.0,9.8e-06,0.009,155,181,150,176,124,194,0.78,26,26,70
OceanDNA-b22995,1529,-0.3,0.0,0.13,53.0,251,275,679,703,670,714,0.78,24,24,44
OceanDNA-b46552,823,12.4,0.2,3.3e-06,0.0046,77,178,211,314,183,350,0.78,101,103,167
OceanDNA-b31981,888,5.4,0.0,0.00094,1.1,187,227,247,286,238,304,0.78,40,39,66
OceanDNA-b19962,69,6.0,0.0,0.0003,0.13,149,180,74,105,60,123,0.78,31,31,63
OceanDNA-b35901,22,6.9,0.0,0.00032,0.095,192,229,219,256,191,264,0.78,37,37,73
OceanDNA-b23364,1970,6.2,0.0,0.00053,0.63,149,177,150,179,139,197,0.78,28,29,58
OceanDNA-b3608,2049,-0.3,0.0,0.025,52.0,159,175,123,139,107,153,0.78,16,16,46
OceanDNA-b21019,707,11.3,0.2,1.4e-05,0.022,52,111,125,185,76,198,0.78,59,60,122
OceanDNA-b23003,1384,15.4,0.8,2.1e-06,0.001,42,174,283,422,278,452,0.78,132,139,174
OceanDNA-b22353,82,15.5,0.0,7.7e-07,0.00044,152,192,157,198,143,232,0.78,40,41,89
OceanDNA-b34793,517,14.5,0.0,7.6e-07,0.00062,140,185,132,178,124,186,0.78,45,46,62
OceanDNA-b23003,2194,11.0,0.0,4.4e-05,0.022,148,181,191,225,180,234,0.78,33,34,54
OceanDNA-b31131,342,20.6,0.0,2.2e-08,7.3e-06,140,181,124,167,120,178,0.78,41,43,58
OceanDNA-b33570,565,18.3,0.0,5.3e-08,6.8e-05,87,186,48,153,20,164,0.78,99,105,144
OceanDNA-b24894,844,10.9,0.0,9.9e-06,0.016,161,190,114,144,110,156,0.78,29,30,46
OceanDNA-b36330,589,10.5,0.0,1.3e-05,0.0087,142,180,144,181,111,203,0.78,38,37,92
OceanDNA-b41223,916,14.7,0.0,6.6e-07,0.0013,121,211,113,202,33,245,0.78,90,89,212
OceanDNA-b46530,745,11.2,0.0,7.8e-06,0.0091,153,180,236,263,217,279,0.78,27,27,62
OceanDNA-b35823,3637,11.5,0.1,2e-05,0.029,153,191,190,233,171,245,0.78,38,43,74
OceanDNA-b41581,30,6.3,0.0,0.00024,0.14,200,245,238,284,230,294,0.78,45,46,64
OceanDNA-b15459,1164,8.6,0.0,4.9e-05,0.059,192,230,207,244,190,262,0.78,38,37,72
OceanDNA-b32650,1081,20.4,0.0,1.3e-08,2.4e-05,152,181,161,190,139,202,0.78,29,29,63
OceanDNA-b24083,575,-0.4,0.0,0.027,19.0,193,219,200,226,177,257,0.78,26,26,80
OceanDNA-b32200,2047,2.1,0.0,0.0046,11.0,197,228,234,264,230,273,0.78,31,30,43
OceanDNA-b23551,393,7.9,0.0,0.00016,0.12,157,189,54,85,33,98,0.78,32,31,65
OceanDNA-b20413,301,10.7,0.1,1.2e-05,0.0036,188,230,240,281,227,312,0.78,42,41,85
OceanDNA-b27525,756,7.6,0.2,0.00039,0.26,202,266,264,326,255,334,0.78,64,62,79
OceanDNA-b7466,301,19.0,0.0,3.3e-08,1.7e-05,85,123,110,148,104,178,0.78,38,38,74
OceanDNA-b29397,1522,15.7,0.0,3.5e-07,0.00086,153,180,145,172,123,197,0.78,27,27,74
OceanDNA-b23523,1367,13.4,0.0,1.7e-06,0.0031,150,187,129,167,114,182,0.78,37,38,68
OceanDNA-b40171,78,7.7,0.1,9.4e-05,0.044,135,184,207,250,152,258,0.78,49,43,106
OceanDNA-b23020,260,12.5,0.1,3.3e-06,0.011,152,184,855,887,844,917,0.78,32,32,73
OceanDNA-b32706,1844,11.8,0.0,5.1e-06,0.0098,88,189,48,152,30,168,0.78,101,104,138
OceanDNA-b38376,2072,12.7,0.0,1.4e-05,0.0071,198,252,335,387,328,404,0.78,54,52,76
OceanDNA-b38369,851,-1.5,0.0,0.18,100.0,196,212,267,283,261,295,0.78,16,16,34
OceanDNA-b23725,1,10.9,0.1,2.9e-05,0.021,160,185,132,157,111,171,0.78,25,25,60
OceanDNA-b4473,31,10.0,0.0,3.8e-05,0.0052,198,264,604,672,594,674,0.78,66,68,80
OceanDNA-b40439,1721,14.3,0.1,1.9e-06,0.0019,93,188,83,175,49,209,0.78,95,92,160
OceanDNA-b34946,337,11.2,0.4,7.9e-06,0.0056,220,268,228,275,196,277,0.78,48,47,81
OceanDNA-b22965,160,12.4,0.0,1e-05,0.015,94,169,96,170,73,179,0.78,75,74,106
OceanDNA-b30487,2596,18.7,0.3,8.2e-08,0.00012,85,184,74,181,57,204,0.78,99,107,147
OceanDNA-b3982,579,-1.9,0.0,0.23,46.0,235,270,206,242,196,247,0.78,35,36,51
OceanDNA-b2835,4814,-2.0,0.0,0.081,410.0,198,214,199,215,195,222,0.78,16,16,27
OceanDNA-b29503,1498,6.6,0.0,0.00039,0.79,195,220,183,208,177,245,0.78,25,25,68
OceanDNA-b12873,257,20.8,0.0,9.1e-09,6.2e-06,107,191,142,233,138,240,0.78,84,91,102
OceanDNA-b30994,2728,-3.4,0.0,0.21,610.0,107,122,111,126,95,132,0.78,15,15,37
OceanDNA-b4494,680,-2.0,0.0,0.16,93.0,218,241,37,60,30,75,0.78,23,23,45
OceanDNA-a3751,172,6.8,0.0,0.00018,0.032,177,218,375,419,369,435,0.78,41,44,66
OceanDNA-b38741,416,17.2,0.0,1.2e-07,6.1e-05,150,208,254,316,226,323,0.78,58,62,97
OceanDNA-b2835,4814,12.1,0.0,4.3e-06,0.022,148,185,89,128,80,138,0.78,37,39,58
OceanDNA-b13539,479,12.4,0.0,6.7e-06,0.0051,107,180,115,193,104,199,0.78,73,78,95
OceanDNA-b26387,424,10.4,0.0,2.8e-05,0.022,155,180,151,176,130,189,0.78,25,25,59
OceanDNA-b6212,99,14.9,0.0,1.2e-06,0.00048,67,192,14,147,3,154,0.78,125,133,151
OceanDNA-b9789,34,16.2,0.0,2.4e-07,0.00017,151,221,138,211,123,250,0.78,70,73,127
OceanDNA-b19603,348,1.3,0.0,0.016,3.1,191,230,217,255,210,286,0.78,39,38,76
OceanDNA-b30487,1180,34.5,0.4,1.3e-12,1.8e-09,82,174,136,235,131,244,0.78,92,99,113
OceanDNA-b1791,685,10.8,0.1,1e-05,0.022,149,186,145,182,125,244,0.78,37,37,119
OceanDNA-b3621,155,13.2,0.0,2e-06,0.0017,149,214,304,370,282,404,0.78,65,66,122
OceanDNA-b19690,159,19.2,0.0,5.8e-08,1.3e-05,150,218,111,181,97,196,0.78,68,70,99
OceanDNA-b939,1621,17.2,0.1,1.2e-07,0.00025,139,191,84,135,80,172,0.78,52,51,92
OceanDNA-b36415,378,10.1,0.0,3.3e-05,0.026,149,186,109,148,6,155,0.78,37,39,149
OceanDNA-b23049,1569,-1.7,0.1,0.065,150.0,159,169,116,126,100,148,0.78,10,10,48
OceanDNA-b30970,2355,9.2,0.0,3.2e-05,0.077,150,187,100,136,45,156,0.78,37,36,111
OceanDNA-b29532,1267,14.1,0.0,1e-06,0.003,88,185,240,336,207,343,0.78,97,96,136
OceanDNA-b15283,256,18.9,0.0,3.5e-08,1.1e-05,56,186,7,145,2,171,0.78,130,138,169
OceanDNA-b46741,1437,15.8,0.0,6.2e-07,0.00055,153,189,102,139,89,178,0.77,36,37,89
OceanDNA-b6501,201,15.3,0.0,1.4e-06,0.00023,93,196,43,149,11,156,0.77,103,106,145
OceanDNA-b19701,130,13.4,0.0,5e-06,0.00067,130,199,111,180,83,187,0.77,69,69,104
OceanDNA-b297,857,16.6,0.0,1.8e-07,0.00022,102,215,52,175,24,191,0.77,113,123,167
OceanDNA-b19701,291,17.5,0.0,2.9e-07,4e-05,145,191,313,359,284,379,0.77,46,46,95
OceanDNA-b6218,393,3.2,0.0,0.0022,1.2,153,175,150,172,134,185,0.77,22,22,51
OceanDNA-b3951,745,18.9,0.0,3.5e-08,3.7e-05,146,210,43,108,29,135,0.77,64,65,106
OceanDNA-b22805,2934,10.8,0.0,3.1e-05,0.068,143,214,606,672,552,704,0.77,71,66,152
OceanDNA-b16777,178,10.4,0.0,1.4e-05,0.04,98,182,355,441,339,457,0.77,84,86,118
OceanDNA-b21008,2230,15.7,0.0,3.3e-07,0.00088,125,244,80,205,18,212,0.77,119,125,194
OceanDNA-b16095,80,9.6,0.0,2.5e-05,0.023,107,181,110,184,103,195,0.77,74,74,92
OceanDNA-b25136,116,16.3,0.0,2.3e-07,5.2e-05,86,178,99,193,91,200,0.77,92,94,109
OceanDNA-b12639,372,-3.5,0.0,0.24,150.0,195,212,214,231,211,238,0.77,17,17,27
OceanDNA-b33521,2359,22.1,0.1,3.9e-09,1.1e-05,86,172,139,237,132,254,0.77,86,98,122
OceanDNA-b5492,297,11.1,0.0,8.7e-06,0.004,154,181,76,105,47,147,0.77,27,29,100
OceanDNA-b9190,106,34.0,0.0,9e-13,3.5e-10,84,177,141,245,134,258,0.77,93,104,124
OceanDNA-b38370,177,9.7,0.0,4.6e-05,0.037,197,239,223,265,211,279,0.77,42,42,68
OceanDNA-b23143,43,19.5,0.0,4.5e-08,6.2e-05,154,218,157,223,140,258,0.77,64,66,118
OceanDNA-b16229,52,3.6,0.0,0.0048,2.1,196,245,429,477,424,488,0.77,49,48,64
OceanDNA-b11387,379,17.5,0.0,2e-07,5.9e-05,51,96,39,86,30,92,0.77,45,47,62
OceanDNA-b41011,471,9.4,0.1,5.4e-05,0.067,89,186,58,153,53,167,0.77,97,95,114
OceanDNA-b6163,418,7.0,0.0,0.00015,0.088,203,268,203,266,182,275,0.77,65,63,93
OceanDNA-b16138,515,7.4,0.0,0.00011,0.088,180,246,421,490,416,499,0.77,66,69,83
OceanDNA-b23944,1715,10.4,0.2,1.4e-05,0.025,103,188,53,137,37,153,0.77,85,84,116
OceanDNA-b30224,1631,15.9,0.2,2.9e-07,0.00052,88,173,109,201,100,212,0.77,85,92,112
OceanDNA-b510,1001,6.6,0.0,0.0004,0.44,196,222,261,287,252,302,0.77,26,26,50
OceanDNA-b4487,698,16.7,0.0,1.6e-07,0.00026,86,212,117,253,98,274,0.77,126,136,176
OceanDNA-b17735,2830,-3.9,0.0,0.31,960.0,222,234,279,291,269,293,0.77,12,12,24
OceanDNA-b38499,23,8.0,0.0,7.5e-05,0.076,178,245,281,353,270,365,0.77,67,72,95
OceanDNA-b9605,71,18.1,0.0,6.3e-08,1.7e-05,153,199,210,257,198,289,0.77,46,47,91
OceanDNA-b13167,165,14.5,0.0,7.6e-07,0.0003,187,229,111,153,95,178,0.77,42,42,83
OceanDNA-b22926,1352,11.1,0.1,1.7e-05,0.039,144,188,178,224,167,234,0.77,44,46,67
OceanDNA-b30773,857,12.2,0.0,3.9e-06,0.011,152,197,158,206,124,216,0.77,45,48,92
OceanDNA-b40250,21,21.8,0.4,9.4e-09,3.4e-06,76,215,97,254,41,280,0.77,139,157,239
OceanDNA-b15238,333,18.1,0.0,6.3e-08,2.4e-05,153,215,267,335,256,353,0.77,62,68,97
OceanDNA-b3647,588,14.3,0.0,9.1e-07,0.00082,102,212,110,230,82,283,0.77,110,120,201
OceanDNA-b5607,732,14.5,0.0,7.8e-07,0.0006,143,182,72,114,45,126,0.77,39,42,81
OceanDNA-b9927,6,10.8,0.1,1e-05,0.0037,145,188,113,156,26,164,0.77,43,43,138
OceanDNA-b20259,119,68.7,0.3,2.3e-23,7.7e-21,66,282,71,317,53,327,0.77,216,246,274
OceanDNA-b9652,596,10.3,0.0,1.5e-05,0.0094,90,180,19,104,15,114,0.77,90,85,99
OceanDNA-b38177,705,-1.7,0.0,0.069,200.0,153,189,556,592,544,603,0.77,36,36,59
OceanDNA-b30226,1919,-3.3,0.0,0.21,510.0,194,219,244,269,227,272,0.77,25,25,45
OceanDNA-b46513,458,15.9,0.0,6e-07,0.00018,134,218,113,196,102,205,0.77,84,83,103
OceanDNA-b23549,1740,4.8,0.0,0.0021,1.4,198,263,189,255,183,258,0.77,65,66,75
OceanDNA-b26646,3094,15.8,0.0,9.4e-07,0.0011,175,246,186,254,179,267,0.77,71,68,88
OceanDNA-b22504,1295,14.1,0.0,3.2e-06,0.0031,148,188,387,429,371,464,0.77,40,42,93
OceanDNA-b14104,138,11.4,0.0,2e-05,0.0032,160,183,112,135,53,141,0.77,23,23,88
OceanDNA-b40444,376,26.3,0.1,8e-10,3.7e-07,83,172,144,244,127,251,0.77,89,100,124
OceanDNA-b31005,2016,6.9,0.1,0.00016,0.46,150,187,162,198,115,219,0.77,37,36,104
OceanDNA-b15230,234,21.7,0.0,9.7e-09,2.3e-06,73,214,32,181,21,220,0.77,141,149,199
OceanDNA-b46697,119,15.6,0.0,7.1e-07,0.00071,154,199,145,191,132,246,0.77,45,46,114
OceanDNA-b33194,434,4.6,0.0,0.00083,0.85,199,243,271,312,264,324,0.77,44,41,60
OceanDNA-b44168,3,-0.3,0.0,0.025,13.0,196,230,202,235,188,254,0.77,34,33,66
OceanDNA-b22888,920,16.4,0.1,4e-07,0.00027,89,185,127,221,109,243,0.77,96,94,134
OceanDNA-b23515,947,9.3,0.0,3e-05,0.037,197,263,202,269,197,271,0.77,66,67,74
OceanDNA-b22382,2584,10.8,0.0,3.1e-05,0.041,97,169,372,442,348,459,0.77,72,70,111
OceanDNA-b36646,1282,15.1,0.1,5.3e-07,0.0011,55,188,14,152,5,165,0.77,133,138,160
OceanDNA-b1657,494,14.9,0.1,1.2e-06,0.00049,106,182,75,149,59,173,0.77,76,74,114
OceanDNA-b32666,668,10.9,0.3,9.6e-06,0.012,161,183,56,78,27,89,0.77,22,22,62
OceanDNA-b17035,719,10.9,0.0,2e-05,0.0095,142,182,81,120,57,135,0.77,40,39,78
OceanDNA-b17035,8,14.2,0.0,1.9e-06,0.00091,146,187,137,178,108,228,0.77,41,41,120
OceanDNA-b112,1144,12.6,0.0,2.9e-06,0.0046,128,190,98,155,41,190,0.77,62,57,149
OceanDNA-b26769,766,-1.9,0.0,0.16,160.0,202,228,271,297,266,305,0.77,26,26,39
OceanDNA-b30073,1107,5.9,0.0,0.00033,0.76,192,232,258,298,228,321,0.77,40,40,93
OceanDNA-b33520,16,3.3,0.0,0.002,1.1,87,155,93,164,89,169,0.77,68,71,80
OceanDNA-b40912,147,5.6,0.0,0.0004,0.36,181,245,266,335,259,342,0.77,64,69,83
OceanDNA-b35155,386,15.3,0.0,4.5e-07,0.00066,140,176,127,164,123,180,0.77,36,37,57
OceanDNA-b46717,1168,15.6,0.0,7.1e-07,0.0012,154,200,145,192,133,245,0.77,46,47,112
OceanDNA-b29482,1279,24.8,0.1,5.6e-10,1.8e-06,80,187,112,227,108,244,0.77,107,115,136
OceanDNA-b20955,963,25.5,0.7,3.5e-10,2.5e-06,54,175,493,617,488,622,0.77,121,124,134
OceanDNA-b37578,813,28.6,0.0,4e-11,1e-07,75,244,92,279,13,291,0.77,169,187,278
OceanDNA-b29589,161,5.5,0.0,0.00088,1.4,166,245,251,334,246,347,0.77,79,83,101
OceanDNA-b22386,1880,27.3,0.1,4e-10,2.1e-07,153,213,187,251,172,256,0.77,60,64,84
OceanDNA-b22917,1245,19.5,0.0,9.1e-08,6.5e-05,120,246,132,279,127,288,0.77,126,147,161
OceanDNA-b46651,2931,25.6,0.0,6.3e-10,1.3e-06,154,250,216,316,199,326,0.77,96,100,127
OceanDNA-b47088,1542,10.5,0.0,2.7e-05,0.052,142,195,204,257,189,269,0.77,53,53,80
OceanDNA-b4473,31,-4.1,0.0,0.71,98.0,154,187,525,558,523,565,0.77,33,33,42
OceanDNA-b27598,443,13.1,0.1,4.2e-06,0.0043,166,231,258,325,227,344,0.77,65,67,117
OceanDNA-b36666,959,7.4,0.0,0.00033,0.14,198,252,619,673,608,687,0.77,54,54,79
OceanDNA-b5198,106,11.3,0.0,7.6e-06,0.0027,158,182,81,105,20,128,0.77,24,24,108
OceanDNA-b34942,321,-1.3,0.0,0.049,28.0,145,171,53,79,33,94,0.77,26,26,61
OceanDNA-b24117,1926,-1.4,0.0,0.11,140.0,31,61,243,273,232,279,0.77,30,30,47
OceanDNA-b22215,297,12.9,0.0,2.4e-06,0.0024,133,212,62,142,49,154,0.77,79,80,105
OceanDNA-b23396,1632,13.3,0.0,3.6e-06,0.0037,95,183,89,175,83,179,0.77,88,86,96
OceanDNA-b24238,181,11.1,0.0,8.6e-06,0.0036,146,189,140,185,131,208,0.77,43,45,77
OceanDNA-b2837,2702,-3.8,0.0,0.29,900.0,234,261,236,263,234,264,0.77,27,27,30
OceanDNA-b28083,1033,7.1,0.0,0.00028,0.24,228,266,219,258,184,268,0.77,38,39,84
OceanDNA-b13570,912,14.2,0.0,3e-06,0.0013,95,185,138,230,128,237,0.77,90,92,109
OceanDNA-b23271,1794,12.9,0.0,4.8e-06,0.006,99,187,134,231,106,295,0.77,88,97,189
OceanDNA-b25263,174,8.2,0.0,6.3e-05,0.015,194,246,247,296,228,309,0.77,52,49,81
OceanDNA-b24623,456,10.2,0.1,1.6e-05,0.01,150,204,96,153,79,178,0.77,54,57,99
OceanDNA-b3700,1479,-3.4,0.0,0.23,590.0,250,282,413,445,409,454,0.77,32,32,45
OceanDNA-b16125,732,9.5,0.0,2.7e-05,0.021,177,245,386,457,379,461,0.77,68,71,82
OceanDNA-b46651,780,20.2,0.0,2.9e-08,5.9e-05,153,250,197,297,170,303,0.77,97,100,133
OceanDNA-b41476,1378,14.7,0.0,1.4e-06,0.001,153,179,154,180,128,200,0.77,26,26,72
OceanDNA-b30221,1445,12.1,0.1,8.4e-06,0.0091,156,182,90,116,28,154,0.77,26,26,126
OceanDNA-b31523,1127,3.0,0.0,0.0026,3.8,177,216,294,341,283,367,0.77,39,47,84
OceanDNA-b3695,466,14.1,0.0,2.1e-06,0.0018,61,131,66,135,47,162,0.77,70,69,115
OceanDNA-b34951,634,10.3,0.0,1.5e-05,0.011,197,264,177,240,160,242,0.77,67,63,82
OceanDNA-b12519,196,36.0,0.0,2.3e-13,7.5e-11,153,237,133,220,111,238,0.77,84,87,127
OceanDNA-b9721,13,14.2,0.0,9.9e-07,0.00045,160,230,141,214,133,234,0.77,70,73,101
OceanDNA-b40593,473,16.3,0.0,2.2e-07,0.00012,103,171,5,84,2,89,0.77,68,79,87
OceanDNA-b7194,42,18.2,0.0,2.3e-07,4.8e-05,89,212,113,246,65,261,0.77,123,133,196
OceanDNA-b16215,845,-2.9,0.0,0.31,180.0,232,246,261,275,247,282,0.77,14,14,35
OceanDNA-b13590,1921,11.0,0.0,3.6e-05,0.026,140,187,312,358,287,403,0.77,47,46,116
OceanDNA-b13590,599,21.5,0.2,2.3e-08,1.7e-05,139,224,348,437,275,458,0.77,85,89,183
OceanDNA-b10418,245,15.9,0.0,2.9e-07,7.9e-05,151,238,140,228,123,241,0.77,87,88,118
OceanDNA-b28040,422,12.3,0.0,3.6e-06,0.0023,193,249,260,313,243,323,0.77,56,53,80
OceanDNA-b22890,202,14.5,0.0,2.4e-06,0.0017,147,178,180,212,141,232,0.77,31,32,91
OceanDNA-b2811,1320,9.6,0.0,2.4e-05,0.036,155,185,255,284,233,289,0.77,30,29,56
OceanDNA-b41178,1745,4.6,0.0,0.0017,1.8,185,216,207,237,194,268,0.77,31,30,74
OceanDNA-b45818,1062,12.0,0.0,2.2e-05,0.0066,59,169,63,181,48,200,0.77,110,118,152
OceanDNA-b14104,138,0.0,0.0,0.06,9.5,189,210,230,251,209,262,0.77,21,21,53
OceanDNA-b32052,138,10.8,0.0,2e-05,0.02,159,189,157,188,120,205,0.77,30,31,85
OceanDNA-b32059,1567,21.7,0.1,5e-09,1.1e-05,94,187,126,228,54,254,0.77,93,102,200
OceanDNA-b37356,779,6.0,0.0,0.0003,0.53,154,187,161,194,142,207,0.77,33,33,65
OceanDNA-b22965,160,-2.1,0.1,0.27,390.0,14,36,22,44,16,65,0.77,22,22,49
OceanDNA-b1353,1714,4.4,0.0,0.0028,3.7,192,265,292,361,278,362,0.77,73,69,84
OceanDNA-b23584,2007,14.8,0.1,1.3e-06,0.0016,136,183,185,229,52,239,0.77,47,44,187
OceanDNA-b22391,1470,14.1,0.0,3.2e-06,0.002,151,213,194,259,168,269,0.77,62,65,101
OceanDNA-b23839,428,14.2,0.0,1.9e-06,0.00097,154,180,242,268,223,282,0.77,26,26,59
OceanDNA-b46897,281,3.2,0.0,0.0022,1.9,200,263,253,314,245,316,0.77,63,61,71
OceanDNA-b40527,138,7.3,0.0,0.00025,0.097,140,193,120,170,56,210,0.77,53,50,154
OceanDNA-b23524,1285,-0.8,0.0,0.11,52.0,179,218,238,277,225,295,0.77,39,39,70
OceanDNA-b23333,822,18.7,0.2,8.1e-08,6.6e-05,89,215,78,207,43,242,0.77,126,129,199
OceanDNA-b34949,113,13.9,0.0,3.6e-06,0.0012,107,178,111,189,91,196,0.77,71,78,105
OceanDNA-b3980,64,11.9,0.0,9.9e-06,0.0059,97,185,74,160,52,165,0.77,88,86,113
OceanDNA-b22917,2318,-2.1,0.0,0.35,250.0,179,193,273,287,232,291,0.77,14,14,59
OceanDNA-b3631,550,10.9,0.0,9.9e-06,0.01,200,266,195,259,182,270,0.77,66,64,88
OceanDNA-b286,3125,11.0,0.0,8.9e-06,0.035,150,215,158,225,59,260,0.77,65,67,201
OceanDNA-b1738,534,9.2,0.1,9.6e-05,0.12,150,176,128,154,110,167,0.77,26,26,57
OceanDNA-b30842,113,12.5,0.0,3.1e-06,0.0017,156,181,146,171,124,188,0.77,25,25,64
OceanDNA-b13919,1478,11.5,0.0,6.6e-06,0.017,152,218,107,176,79,198,0.77,66,69,119
OceanDNA-b40473,146,14.4,0.0,2.4e-06,0.00086,154,180,147,173,124,189,0.77,26,26,65
OceanDNA-b22850,622,11.6,0.0,1.2e-05,0.016,109,191,346,435,311,443,0.77,82,89,132
OceanDNA-b1353,3339,12.0,0.0,1.4e-05,0.018,137,190,167,225,156,240,0.77,53,58,84
OceanDNA-b19612,371,16.7,0.0,3.3e-07,0.0001,151,189,116,155,106,211,0.77,38,39,105
OceanDNA-b1353,1053,2.1,0.1,0.014,18.0,154,185,151,182,111,208,0.77,31,31,97
OceanDNA-b20972,2572,30.0,0.1,1.5e-11,4.3e-08,76,175,76,181,56,187,0.77,99,105,131
OceanDNA-b37083,540,34.2,0.1,7.7e-13,5.2e-10,84,171,155,253,148,257,0.77,87,98,109
OceanDNA-b23153,73,19.5,0.0,2.4e-08,6.2e-05,145,245,207,303,189,313,0.77,100,96,124
OceanDNA-b4528,304,14.5,0.0,7.7e-07,0.00052,148,242,129,226,80,256,0.77,94,97,176
OceanDNA-b34608,1113,16.8,0.0,1.6e-07,0.00018,156,184,148,176,127,191,0.77,28,28,64
OceanDNA-b13585,163,5.3,0.0,0.0024,0.73,85,132,71,121,61,142,0.77,47,50,81
OceanDNA-b32785,766,-3.9,0.0,0.32,340.0,202,218,223,239,220,247,0.77,16,16,27
OceanDNA-b11963,1108,-0.7,0.0,0.033,63.0,253,268,318,333,305,351,0.77,15,15,46
OceanDNA-b38906,131,13.2,0.0,1.9e-06,0.0022,157,183,147,173,122,185,0.77,26,26,63
OceanDNA-b510,1001,4.5,0.0,0.0018,1.9,154,184,137,167,72,172,0.77,30,30,100
OceanDNA-b34576,1076,17.3,0.0,1.1e-07,0.00012,156,184,148,176,126,191,0.77,28,28,65
OceanDNA-b19665,86,20.9,0.0,1.7e-08,4.1e-06,126,192,290,360,284,385,0.77,66,70,101
OceanDNA-b23918,382,12.3,0.0,7.5e-06,0.0072,197,265,211,277,200,286,0.77,68,66,86
OceanDNA-b4053,506,12.1,0.0,1.3e-05,0.003,182,248,166,227,153,243,0.77,66,61,90
OceanDNA-b3635,774,22.8,0.0,4.7e-09,6.1e-06,153,217,158,227,147,253,0.77,64,69,106
OceanDNA-b36,1773,19.5,0.0,2.3e-08,4.3e-05,102,176,226,308,187,331,0.77,74,82,144
OceanDNA-b19687,279,59.0,0.0,2.1e-20,9.5e-18,73,281,82,319,60,328,0.77,208,237,268
OceanDNA-b46391,1300,10.8,0.0,1.1e-05,0.027,153,204,179,231,163,245,0.77,51,52,82
OceanDNA-b22765,288,16.7,0.0,3.3e-07,0.00027,109,212,515,625,492,644,0.77,103,110,152
OceanDNA-b19962,69,7.1,0.0,0.00014,0.062,182,221,180,219,170,249,0.77,39,39,79
OceanDNA-b16227,471,6.4,0.0,0.00069,0.24,133,182,367,417,360,423,0.77,49,50,63
OceanDNA-b50,2159,-0.8,0.0,0.036,94.0,100,122,166,188,129,192,0.77,22,22,63
OceanDNA-b40249,8,1.2,0.0,0.0085,6.1,93,124,64,98,53,116,0.77,31,34,63
OceanDNA-b26917,1112,6.0,0.0,0.0006,0.47,202,270,207,273,194,288,0.77,68,66,94
OceanDNA-b498,1429,12.5,0.0,3.2e-06,0.0091,138,177,316,354,291,401,0.77,39,38,110
OceanDNA-b9159,116,12.1,0.0,4.2e-06,0.0015,138,184,162,213,153,222,0.77,46,51,69
OceanDNA-b18640,271,2.4,0.0,0.0074,1.2,148,175,108,137,91,152,0.77,27,29,61
OceanDNA-b31431,792,10.7,0.0,1.2e-05,0.023,52,103,517,570,468,583,0.77,51,53,115
OceanDNA-b22518,1323,11.9,0.1,9.3e-06,0.017,100,169,382,449,367,470,0.77,69,67,103
OceanDNA-b35152,1683,14.5,0.0,7.7e-07,0.0015,156,177,144,165,123,183,0.77,21,21,60
OceanDNA-b28563,1394,13.4,0.0,1.7e-06,0.0035,152,175,142,165,125,183,0.77,23,23,58
OceanDNA-b4157,45,22.1,0.0,3.7e-09,1.4e-06,153,196,232,276,221,350,0.77,43,44,129
OceanDNA-b22654,819,12.8,0.0,1.3e-05,0.0031,139,187,256,303,238,362,0.77,48,47,124
OceanDNA-b16117,541,19.8,0.0,3.7e-08,1.4e-05,94,183,90,179,74,189,0.77,89,89,115
OceanDNA-b34674,221,6.5,0.1,0.00021,0.13,169,255,291,381,280,395,0.77,86,90,115
OceanDNA-b5279,16,38.8,0.3,3e-14,1.6e-11,76,245,122,308,90,322,0.77,169,186,232
OceanDNA-b29555,2035,8.7,0.1,4.5e-05,0.11,171,244,221,293,213,307,0.77,73,72,94
OceanDNA-b37582,1979,26.8,0.0,2.9e-10,3.5e-07,76,243,93,278,81,290,0.77,167,185,209
OceanDNA-b46553,761,11.6,0.1,1.2e-05,0.0091,139,172,81,114,75,135,0.77,33,33,60
OceanDNA-b18796,201,24.8,0.0,5.6e-10,1.6e-07,151,191,297,337,259,397,0.77,40,40,138
OceanDNA-b3653,1280,10.6,0.0,4.7e-05,0.027,229,265,233,270,198,279,0.77,36,37,81
OceanDNA-b46200,96,13.0,0.0,2.3e-06,0.0034,104,169,145,209,72,244,0.77,65,64,172
OceanDNA-b16198,1641,10.8,0.0,1.1e-05,0.019,181,251,114,187,107,198,0.77,70,73,91
OceanDNA-b3672,943,10.5,0.0,1.3e-05,0.033,69,168,157,263,138,270,0.77,99,106,132
OceanDNA-b32709,628,-0.6,0.0,0.061,52.0,197,224,323,349,316,364,0.77,27,26,48
OceanDNA-b40232,803,18.9,0.1,7.3e-08,8.5e-05,153,190,158,195,140,251,0.77,37,37,111
OceanDNA-b13263,277,-2.3,0.0,0.2,99.0,183,229,364,407,356,415,0.77,46,43,59
OceanDNA-b3975,243,16.6,0.0,7e-07,0.00015,107,186,95,179,59,200,0.77,79,84,141
OceanDNA-b22512,2235,15.5,0.0,7.7e-07,0.00096,154,224,133,210,117,223,0.77,70,77,106
OceanDNA-b46207,101,25.4,0.0,3.8e-10,5.1e-07,153,246,176,272,161,276,0.77,93,96,115
OceanDNA-b30095,2002,18.0,0.0,1.3e-07,0.00017,153,179,141,167,123,183,0.77,26,26,60
OceanDNA-b276,693,22.0,0.0,1.2e-08,9.5e-06,102,216,64,188,37,231,0.77,114,124,194
OceanDNA-b19817,245,49.2,0.1,2.2e-17,8.3e-15,74,280,90,330,68,341,0.77,206,240,273
OceanDNA-b12220,283,39.2,0.0,2.4e-14,9.7e-12,145,245,27,137,13,150,0.77,100,110,137
OceanDNA-b30852,157,0.8,0.0,0.023,23.0,230,268,229,268,198,272,0.77,38,39,74
OceanDNA-b11950,656,11.8,0.0,5.1e-06,0.007,148,189,198,239,183,284,0.77,41,41,101
OceanDNA-b35076,477,0.9,0.0,0.022,8.3,152,186,102,136,79,145,0.77,34,34,66
OceanDNA-b40265,482,8.7,0.0,9.4e-05,0.045,180,245,298,368,291,373,0.77,65,70,82
OceanDNA-b7128,140,14.9,0.1,5.9e-07,0.00025,143,257,135,250,122,253,0.77,114,115,131
OceanDNA-b1294,1551,9.9,0.4,2e-05,0.04,127,186,172,226,92,232,0.77,59,54,140
OceanDNA-b40943,684,29.0,0.0,6e-11,2.8e-08,153,245,155,254,129,271,0.77,92,99,142
OceanDNA-b40265,482,27.8,0.0,1.4e-10,6.8e-08,84,171,159,257,152,261,0.77,87,98,109
OceanDNA-b6561,331,11.5,0.0,1.9e-05,0.0083,94,212,115,242,86,292,0.77,118,127,206
OceanDNA-b38548,512,19.0,0.0,3.4e-08,2.1e-05,78,188,21,139,17,156,0.77,110,118,139
OceanDNA-b29555,2035,9.2,0.2,3.3e-05,0.083,153,188,120,156,104,172,0.77,35,36,68
OceanDNA-b35196,601,11.3,0.0,7.5e-06,0.0054,140,180,141,182,134,208,0.77,40,41,74
OceanDNA-b44390,296,16.5,0.0,5.7e-07,0.00013,59,193,10,151,7,158,0.77,134,141,151
OceanDNA-b36139,1255,16.0,0.0,5.5e-07,0.00055,147,184,343,382,330,387,0.77,37,39,57
OceanDNA-b4061,892,12.3,0.0,3.7e-06,0.0033,101,212,118,239,82,244,0.77,111,121,162
OceanDNA-b26937,190,13.7,0.0,2.7e-06,0.00031,155,250,127,226,111,240,0.77,95,99,129
OceanDNA-b45518,29,10.6,0.0,2.5e-05,0.02,151,187,213,249,108,256,0.77,36,36,148
OceanDNA-b9654,484,11.9,0.1,9.5e-06,0.0027,174,227,201,254,197,287,0.77,53,53,90
OceanDNA-b8073,260,15.0,0.0,5.7e-07,0.00015,149,187,140,179,121,211,0.77,38,39,90
OceanDNA-b17430,13,2.1,0.0,0.0047,10.0,190,221,235,266,209,286,0.77,31,31,77
OceanDNA-b24286,2219,6.6,0.1,0.00021,0.68,78,121,53,97,50,127,0.77,43,44,77
OceanDNA-b20668,130,15.8,0.0,6.2e-07,8.4e-05,219,282,260,323,230,337,0.77,63,63,107
OceanDNA-b41808,115,16.8,0.0,1.6e-07,3.6e-05,151,211,107,169,74,194,0.77,60,62,120
OceanDNA-b46925,462,11.5,0.0,6.3e-06,0.012,153,184,246,277,231,294,0.77,31,31,63
OceanDNA-b16510,1060,3.2,0.0,0.0022,3.0,177,223,380,431,374,450,0.77,46,51,76
OceanDNA-b9705,341,4.1,0.0,0.0011,0.92,161,185,122,146,51,163,0.77,24,24,112
OceanDNA-b15453,1335,27.5,0.0,2.6e-10,1.9e-07,106,211,133,251,129,265,0.77,105,118,136
OceanDNA-b41014,1220,10.4,0.1,4.2e-05,0.03,156,192,91,131,75,141,0.77,36,40,66
OceanDNA-b22322,1513,14.4,0.0,2.5e-06,0.0032,135,188,205,254,187,293,0.77,53,49,106
OceanDNA-b36732,2751,25.5,0.2,3.4e-10,1.2e-06,86,175,151,250,143,255,0.77,89,99,112
OceanDNA-b24875,947,10.9,0.1,3e-05,0.017,149,217,104,177,89,187,0.77,68,73,98
OceanDNA-b22452,1206,11.8,0.1,5.2e-06,0.0072,105,175,228,296,194,305,0.77,70,68,111
OceanDNA-b22998,423,12.1,0.0,4.2e-06,0.0041,139,193,326,380,317,390,0.77,54,54,73
OceanDNA-b23150,2605,-2.5,0.0,0.12,310.0,201,244,234,274,232,278,0.77,43,40,46
OceanDNA-b20657,47,17.5,0.0,1.9e-07,2.9e-05,200,271,238,312,232,335,0.77,71,74,103
OceanDNA-b34551,738,9.3,0.0,9.1e-05,0.027,168,217,253,308,225,339,0.77,49,55,114
OceanDNA-b41340,1342,13.4,0.2,5e-06,0.0024,75,183,19,134,4,148,0.77,108,115,144
OceanDNA-b35233,573,13.0,0.0,2.2e-06,0.0015,159,180,169,190,146,203,0.77,21,21,57
OceanDNA-b33325,189,-2.9,0.0,0.16,250.0,259,282,264,288,252,291,0.77,23,24,39
OceanDNA-b30051,355,18.2,0.0,6e-08,0.00014,151,180,167,196,143,210,0.77,29,29,67
OceanDNA-b31120,370,13.7,0.0,4e-06,0.0014,149,185,71,110,39,153,0.77,36,39,114
OceanDNA-b17217,1754,24.3,0.0,8.3e-10,1.5e-06,143,265,175,298,162,301,0.77,122,123,139
OceanDNA-b31130,128,3.5,0.0,0.0018,1.0,198,256,330,386,321,398,0.77,58,56,77
OceanDNA-b13250,2981,36.8,0.4,1.2e-12,5.1e-10,75,270,69,263,58,280,0.77,195,194,222
OceanDNA-b26842,273,4.7,0.0,0.0016,1.8,201,264,195,256,176,264,0.77,63,61,88
OceanDNA-b32900,696,1.6,0.0,0.0068,11.0,196,231,201,235,152,244,0.77,35,34,92
OceanDNA-b10082,567,12.5,0.0,6.6e-06,0.0025,138,226,152,242,142,280,0.76,88,90,138
OceanDNA-b13561,806,10.3,0.1,3e-05,0.012,88,182,60,152,54,161,0.76,94,92,107
OceanDNA-b6168,140,11.2,0.0,8.2e-06,0.0047,204,270,194,258,175,276,0.76,66,64,101
OceanDNA-b20629,17,3.0,0.0,0.0025,0.47,92,121,140,169,129,177,0.76,29,29,48
OceanDNA-b11344,671,37.0,0.0,1.1e-13,8.1e-11,77,241,59,239,36,255,0.76,164,180,219
OceanDNA-b19769,45,13.7,0.0,2.7e-06,0.00062,148,191,297,340,264,363,0.76,43,43,99
OceanDNA-b22797,238,12.5,0.0,6.5e-06,0.0042,89,190,171,271,160,306,0.76,101,100,146
OceanDNA-b33048,1451,13.1,0.0,2e-06,0.0075,134,188,100,148,58,161,0.76,54,48,103
OceanDNA-b30917,1286,16.7,0.0,1.6e-07,0.00036,86,180,60,162,37,169,0.76,94,102,132
OceanDNA-b1522,444,7.9,0.0,0.00024,0.079,193,245,255,303,237,318,0.76,52,48,81
OceanDNA-b6424,365,4.2,0.0,0.0033,0.67,221,265,212,255,188,257,0.76,44,43,69
OceanDNA-b34918,448,38.8,0.6,9e-14,3.1e-11,79,173,163,271,133,280,0.76,94,108,147
OceanDNA-b40450,841,14.1,0.2,1e-06,0.0016,92,185,93,183,57,200,0.76,93,90,143
OceanDNA-b17770,189,6.7,0.0,0.00019,0.055,78,183,21,132,17,139,0.76,105,111,122
OceanDNA-b44744,465,1.5,0.0,0.0072,5.9,181,216,188,225,183,251,0.76,35,37,68
OceanDNA-b19692,224,13.5,0.1,1.5e-06,0.00051,89,176,64,156,52,164,0.76,87,92,112
OceanDNA-b43,3730,3.2,0.0,0.0044,15.0,152,189,569,606,518,615,0.76,37,37,97
OceanDNA-b28083,1033,-0.6,0.0,0.062,53.0,123,164,24,64,20,68,0.76,41,40,48
OceanDNA-b26823,1130,24.2,0.1,8.9e-10,3.3e-06,82,174,125,228,119,235,0.76,92,103,116
OceanDNA-b27525,756,9.0,0.5,0.00015,0.098,161,197,178,218,121,250,0.76,36,40,129
OceanDNA-b43907,104,6.5,1.2,0.00043,0.075,143,172,165,194,75,201,0.76,29,29,126
OceanDNA-b31510,971,12.7,0.0,5.6e-06,0.0031,194,253,568,627,563,646,0.76,59,59,83
OceanDNA-b15461,1544,11.8,0.0,5.2e-06,0.0097,185,245,215,278,116,287,0.76,60,63,171
OceanDNA-b4007,753,5.9,0.0,0.00032,0.33,161,187,117,143,42,171,0.76,26,26,129
OceanDNA-b17054,10,17.5,0.0,9.3e-08,2.7e-05,131,209,205,286,192,293,0.76,78,81,101
OceanDNA-b30206,381,20.3,0.2,2.6e-08,3e-05,86,175,141,240,133,253,0.76,89,99,120
OceanDNA-b30139,2064,13.5,0.0,1.6e-06,0.0041,70,190,27,158,14,213,0.76,120,131,199
OceanDNA-b23169,1844,13.3,0.0,3.5e-06,0.004,149,189,153,194,143,225,0.76,40,41,82
OceanDNA-b33113,70,4.2,0.0,0.001,0.57,145,181,46,85,18,111,0.76,36,39,93
OceanDNA-b27525,1050,23.2,0.3,6.9e-09,4.6e-06,89,175,207,304,202,323,0.76,86,97,121
OceanDNA-b44440,1094,0.4,0.0,0.031,37.0,150,189,550,589,501,602,0.76,39,39,101
OceanDNA-b33393,2785,11.4,0.0,1.3e-05,0.028,78,185,44,159,4,168,0.76,107,115,164
OceanDNA-b33090,1196,12.1,0.2,4.2e-06,0.01,67,192,8,130,2,147,0.76,125,122,145
OceanDNA-b31510,187,27.1,0.0,2.2e-10,1.2e-07,80,176,224,331,211,343,0.76,96,107,132
OceanDNA-b7545,656,10.4,0.0,1.4e-05,0.015,110,169,85,144,69,154,0.76,59,59,85
OceanDNA-b6503,577,14.0,0.0,2.2e-06,0.00072,134,185,103,153,25,164,0.76,51,50,139
OceanDNA-b42522,68,4.9,0.0,0.0013,0.21,154,180,129,155,111,165,0.76,26,26,54
OceanDNA-b17318,494,23.8,0.0,2.2e-09,2.7e-06,154,228,406,481,397,508,0.76,74,75,111
OceanDNA-b11955,249,40.7,0.0,8.4e-15,1.1e-11,109,244,85,225,53,234,0.76,135,140,181
OceanDNA-b36767,303,5.3,0.0,0.0005,0.44,91,121,138,168,125,217,0.76,30,30,92
OceanDNA-b43700,166,7.3,0.2,0.00012,0.13,158,185,28,55,8,62,0.76,27,27,54
OceanDNA-b45502,684,26.8,0.0,1.4e-10,1.8e-07,143,244,161,270,148,278,0.76,101,109,130
OceanDNA-b26893,2504,16.2,0.0,4.6e-07,0.00076,154,189,154,190,135,214,0.76,35,36,79
OceanDNA-b30134,407,9.8,0.0,2.1e-05,0.048,192,231,244,283,210,306,0.76,39,39,96
OceanDNA-b46887,168,3.3,0.0,0.0041,1.4,179,247,184,249,176,267,0.76,68,65,91
OceanDNA-b10050,192,14.3,0.0,8.9e-07,0.00033,53,193,10,148,3,213,0.76,140,138,210
OceanDNA-b3700,1479,24.2,0.0,8.8e-10,2.3e-06,102,189,224,314,203,336,0.76,87,90,133
OceanDNA-b46916,4169,12.3,0.0,7.5e-06,0.02,138,190,153,207,138,236,0.76,52,54,98
OceanDNA-b30640,51,10.0,0.0,5.7e-05,0.023,125,186,60,122,52,129,0.76,61,62,77
OceanDNA-b3457,390,8.5,0.0,5.4e-05,0.023,148,179,81,112,52,130,0.76,31,31,78
OceanDNA-b13623,278,12.4,0.0,3.5e-06,0.0013,108,232,88,217,70,229,0.76,124,129,159
OceanDNA-b15853,401,-0.1,0.0,0.065,41.0,198,248,603,653,597,673,0.76,50,50,76
OceanDNA-b17622,995,12.7,0.1,2.8e-06,0.0037,89,187,61,157,51,168,0.76,98,96,117
OceanDNA-b46648,325,9.1,0.0,7.1e-05,0.086,193,243,253,301,181,303,0.76,50,48,122
OceanDNA-b32599,1683,8.2,0.0,6.4e-05,0.18,146,196,135,188,82,197,0.76,50,53,115
OceanDNA-b3983,883,2.6,0.0,0.01,3.5,194,262,275,339,261,350,0.76,68,64,89
OceanDNA-b38880,297,7.3,0.0,0.00024,0.11,179,244,259,329,238,341,0.76,65,70,103
OceanDNA-b41227,1263,7.3,0.1,0.00012,0.18,160,181,143,164,121,241,0.76,21,21,120
OceanDNA-b18433,539,20.0,0.0,1.7e-08,1e-05,102,212,47,167,26,175,0.76,110,120,149
OceanDNA-b2647,780,11.5,0.1,1.3e-05,0.018,140,183,226,269,195,287,0.76,43,43,92
OceanDNA-b9784,27,22.7,0.0,7.3e-09,2.9e-06,93,189,164,263,151,274,0.76,96,99,123
OceanDNA-b35383,562,8.2,0.1,6.5e-05,0.039,142,185,180,229,145,235,0.76,43,49,90
OceanDNA-b32599,1683,1.5,0.0,0.0069,20.0,196,264,229,295,198,300,0.76,68,66,102
OceanDNA-b11888,925,31.0,0.2,7.5e-12,1.1e-08,103,243,172,318,156,329,0.76,140,146,173
OceanDNA-b39,3911,5.7,0.0,0.00073,2.5,200,267,260,326,250,332,0.76,67,66,82
OceanDNA-b34782,645,8.7,0.1,4.5e-05,0.03,146,177,28,59,18,84,0.76,31,31,66
OceanDNA-b20687,126,11.7,0.0,5.5e-06,0.0011,111,175,116,185,76,198,0.76,64,69,122
OceanDNA-b6574,177,17.7,0.0,1.7e-07,7.5e-05,79,211,119,262,99,267,0.76,132,143,168
OceanDNA-b36577,1192,18.6,0.1,8.9e-08,8.6e-05,54,189,12,153,1,172,0.76,135,141,171
OceanDNA-b40639,544,19.0,0.0,6.8e-08,2.4e-05,153,191,145,184,81,237,0.76,38,39,156
OceanDNA-b17188,474,10.8,0.1,1e-05,0.0067,90,182,47,145,24,153,0.76,92,98,129
OceanDNA-b41688,10,13.9,0.0,1.2e-06,0.00025,97,183,52,136,27,160,0.76,86,84,133
OceanDNA-b23169,959,-0.1,0.0,0.045,51.0,104,121,145,162,125,168,0.76,17,17,43
OceanDNA-b40474,484,34.6,0.0,1.2e-12,5.6e-10,153,250,145,248,117,263,0.76,97,103,146
OceanDNA-b22604,970,23.9,0.0,1.1e-09,1.3e-06,151,217,151,219,124,246,0.76,66,68,122
OceanDNA-b17564,1318,-2.0,0.0,0.17,170.0,194,222,597,624,590,639,0.76,28,27,49
OceanDNA-b7194,460,8.2,0.0,0.00026,0.055,100,184,74,157,51,170,0.76,84,83,119
OceanDNA-b45862,19,-2.7,0.0,0.14,36.0,199,216,228,245,214,256,0.76,17,17,42
OceanDNA-b4534,24,19.6,0.0,2.2e-08,8.9e-06,137,183,66,111,6,122,0.76,46,45,116
OceanDNA-b40207,335,20.4,0.5,1.2e-08,5.9e-06,88,176,73,166,28,190,0.76,88,93,162
OceanDNA-b36675,330,8.2,0.0,6.6e-05,0.078,197,247,602,652,588,669,0.76,50,50,81
OceanDNA-b40265,779,35.0,0.0,8.8e-13,4.2e-10,152,244,164,263,152,282,0.76,92,99,130
OceanDNA-b9646,517,16.2,0.0,2.3e-07,0.00014,149,215,137,206,117,219,0.76,66,69,102
OceanDNA-b16784,1504,15.5,0.0,3.9e-07,0.00064,93,180,74,163,59,169,0.76,87,89,110
OceanDNA-b38527,545,0.5,0.0,0.014,9.3,185,221,197,233,177,238,0.76,36,36,61
OceanDNA-b13294,1747,24.8,0.0,5.8e-10,1e-06,139,245,11,122,5,127,0.76,106,111,122
OceanDNA-b6558,89,14.4,0.0,1.6e-06,0.00086,149,216,133,203,119,213,0.76,67,70,94
OceanDNA-b22386,1905,32.6,0.0,9.4e-12,4.9e-09,153,244,26,119,13,125,0.76,91,93,112
OceanDNA-b44771,155,14.0,0.0,1.1e-06,0.00043,145,185,78,120,51,141,0.76,40,42,90
OceanDNA-b6447,204,12.4,0.0,3.5e-06,0.0017,87,185,31,130,18,150,0.76,98,99,132
OceanDNA-b31994,2391,-1.7,0.0,0.066,210.0,192,212,215,235,199,279,0.76,20,20,80
OceanDNA-b47088,1051,23.3,0.1,3.3e-09,6.3e-06,84,254,154,322,145,368,0.76,170,168,223
OceanDNA-b34564,654,-1.4,0.0,0.056,41.0,197,228,235,266,230,289,0.76,31,31,59
OceanDNA-b31334,15,11.2,0.1,7.8e-06,0.0012,203,271,212,279,202,279,0.76,68,67,77
OceanDNA-b26748,560,11.3,0.1,7.4e-06,0.017,145,193,82,130,49,142,0.76,48,48,93
OceanDNA-b14467,90,-1.1,0.0,0.043,11.0,198,228,242,271,233,278,0.76,30,29,45
OceanDNA-b22496,4550,12.2,0.0,7.7e-06,0.018,148,185,63,100,25,137,0.76,37,37,112
OceanDNA-b6771,301,10.9,0.0,3.9e-05,0.0091,129,180,135,186,57,192,0.76,51,51,135
OceanDNA-b280,1608,16.0,0.0,2.7e-07,0.00085,102,215,66,189,33,225,0.76,113,123,192
OceanDNA-b23841,627,15.2,0.0,4.8e-07,0.0004,107,192,179,273,163,281,0.76,85,94,118
OceanDNA-b27622,294,4.1,0.2,0.0011,0.88,229,266,250,288,215,294,0.76,37,38,79
OceanDNA-b4498,1017,29.2,0.0,8e-11,2.7e-08,84,176,154,257,147,267,0.76,92,103,120
OceanDNA-b35291,674,20.2,0.1,1.4e-08,2.3e-05,138,247,123,236,105,252,0.76,109,113,147
OceanDNA-b23624,2259,18.3,0.0,1.1e-07,0.00012,128,213,155,245,117,294,0.76,85,90,177
OceanDNA-b30073,1107,4.8,0.0,0.00072,1.7,156,189,137,171,125,194,0.76,33,34,69
OceanDNA-b5321,407,13.3,0.0,1.7e-06,0.00094,98,176,92,180,83,195,0.76,78,88,112
OceanDNA-b41272,1357,7.9,0.0,7.8e-05,0.18,181,217,207,242,200,269,0.76,36,35,69
OceanDNA-b22985,494,11.8,0.0,5.1e-06,0.017,157,186,138,167,105,172,0.76,29,29,67
OceanDNA-b24045,1983,4.6,0.0,0.0024,2.1,196,219,210,233,184,262,0.76,23,23,78
OceanDNA-b26935,170,19.5,0.0,2.4e-08,6.1e-06,77,193,156,277,153,289,0.76,116,121,136
OceanDNA-b4608,21,7.3,0.0,0.00025,0.065,161,197,107,147,88,155,0.76,36,40,67
OceanDNA-b17160,71,17.7,0.0,8.1e-08,1.5e-05,140,206,281,351,269,362,0.76,66,70,93
OceanDNA-b20893,1271,13.3,0.0,1.8e-06,0.011,84,174,175,276,168,284,0.76,90,101,116
OceanDNA-a1335,150,1.2,0.0,0.0087,1.4,192,244,221,275,200,287,0.76,52,54,87
OceanDNA-b23176,189,35.5,0.0,9.3e-13,2.3e-09,84,219,64,207,36,236,0.76,135,143,200
OceanDNA-b3623,67,12.9,0.0,2.4e-06,0.0017,104,199,373,475,357,482,0.76,95,102,125
OceanDNA-b24725,2081,1.0,0.0,0.021,29.0,159,174,99,114,90,124,0.76,15,15,34
OceanDNA-b10298,542,11.6,0.0,5.8e-06,0.0033,87,185,152,253,146,263,0.76,98,101,117
OceanDNA-b22397,2136,12.8,0.0,1e-05,0.0066,147,185,223,261,211,280,0.76,38,38,69
OceanDNA-b45519,118,23.5,0.0,1.4e-09,1.7e-06,133,189,190,246,173,287,0.76,56,56,114
OceanDNA-b22193,201,15.3,0.0,4.4e-07,0.00058,138,188,306,358,269,414,0.76,50,52,145
OceanDNA-b2854,2002,14.5,0.2,2.4e-06,0.0028,89,189,43,147,7,186,0.76,100,104,179
OceanDNA-b36703,499,14.8,0.0,6.2e-07,0.00064,139,180,133,175,119,188,0.76,41,42,69
OceanDNA-b2866,2501,-1.9,0.0,0.23,200.0,194,231,291,327,288,342,0.76,37,36,54
OceanDNA-b46922,163,-0.1,0.0,0.021,48.0,223,247,280,305,274,324,0.76,24,25,50
OceanDNA-b47083,923,14.0,0.0,1.1e-06,0.0018,153,216,210,275,186,307,0.76,63,65,121
OceanDNA-b20097,208,36.4,0.0,5.1e-13,5e-11,148,243,155,260,133,270,0.76,95,105,137
OceanDNA-b16514,942,5.8,0.0,0.00036,0.36,179,224,353,403,341,434,0.76,45,50,93
OceanDNA-b3611,2804,10.3,0.0,1.5e-05,0.043,84,177,80,172,54,198,0.76,93,92,144
OceanDNA-b42477,163,16.4,0.0,2.1e-07,5.6e-05,153,189,167,203,155,275,0.76,36,36,120
OceanDNA-b12117,217,15.1,0.0,5.2e-07,0.00028,107,192,295,387,267,402,0.76,85,92,135
OceanDNA-b16517,491,3.7,0.0,0.0015,1.4,177,219,349,395,335,429,0.76,42,46,94
OceanDNA-b12878,37,10.4,0.0,1.3e-05,0.0076,99,179,70,147,58,160,0.76,80,77,102
OceanDNA-b35823,1092,14.0,0.0,3.4e-06,0.0051,67,190,13,142,4,153,0.76,123,129,149
OceanDNA-b22490,1092,16.5,0.0,1.9e-07,0.00055,152,218,176,244,165,252,0.76,66,68,87
OceanDNA-b16127,558,-2.6,0.0,0.25,77.0,196,222,237,263,225,272,0.76,26,26,47
OceanDNA-b26843,1077,4.9,0.0,0.0013,1.8,201,265,175,237,160,245,0.76,64,62,85
OceanDNA-b29542,1230,4.1,0.0,0.0023,2.6,202,266,329,391,322,394,0.76,64,62,72
OceanDNA-b34924,232,27.5,0.1,1.8e-10,8.8e-08,83,173,135,237,128,246,0.76,90,102,118
OceanDNA-b1347,1187,-2.5,0.0,0.24,170.0,250,278,354,382,336,385,0.76,28,28,49
OceanDNA-b29510,1279,19.4,0.2,7.7e-08,6.4e-05,80,179,126,232,107,237,0.76,99,106,130
OceanDNA-b22394,92,11.6,0.0,1.2e-05,0.012,152,197,447,493,424,519,0.76,45,46,95
OceanDNA-b38971,193,12.1,0.0,4.2e-06,0.0093,140,185,133,179,130,188,0.76,45,46,58
OceanDNA-b35148,1840,27.6,0.6,1.6e-10,1.7e-07,13,186,19,205,7,236,0.76,173,186,229
OceanDNA-b4056,546,10.4,0.0,1.3e-05,0.0079,102,209,120,237,83,275,0.76,107,117,192
OceanDNA-b22995,475,16.2,0.4,1.1e-06,0.00048,55,171,367,486,361,493,0.76,116,119,132
OceanDNA-b13083,150,3.6,0.0,0.0016,3.9,204,265,239,298,226,302,0.76,61,59,76
OceanDNA-b6704,774,9.6,0.0,7.3e-05,0.021,140,185,135,181,128,188,0.76,45,46,60
OceanDNA-b9656,512,19.2,0.0,5.6e-08,2e-05,89,212,103,235,78,275,0.76,123,132,197
OceanDNA-b36076,1735,-3.0,0.0,0.33,420.0,163,196,266,299,263,306,0.76,33,33,43
OceanDNA-b47087,19,-1.5,0.0,0.17,160.0,22,61,263,302,256,307,0.76,39,39,51
OceanDNA-b30061,1447,11.8,0.1,5.3e-06,0.012,73,188,52,175,35,184,0.76,115,123,149
OceanDNA-b23145,632,25.2,0.0,8.8e-10,9.3e-07,153,214,154,219,143,254,0.76,61,65,111
OceanDNA-b22554,190,13.4,0.0,3.5e-06,0.0021,153,186,137,171,115,219,0.76,33,34,104
OceanDNA-b20098,139,53.4,0.6,2.2e-18,2.8e-16,71,280,84,327,63,335,0.76,209,243,272
OceanDNA-b27533,2244,22.0,0.5,4.1e-09,1.1e-05,80,179,89,195,75,200,0.76,99,106,125
OceanDNA-b38966,1203,12.4,0.1,3.5e-06,0.0074,107,185,267,356,251,368,0.76,78,89,117
OceanDNA-b46513,458,-3.7,0.0,0.54,160.0,247,264,33,50,29,60,0.76,17,17,31
OceanDNA-b3425,433,14.9,0.0,1.2e-06,0.00046,151,193,194,239,180,251,0.76,42,45,71
OceanDNA-b30031,2048,7.0,0.0,0.00029,0.33,197,220,180,203,171,241,0.76,23,23,70
OceanDNA-b37447,660,10.5,0.1,2.6e-05,0.0093,156,186,97,133,80,140,0.76,30,36,60
OceanDNA-b41234,828,18.0,0.0,6.9e-08,0.00014,97,222,85,206,78,219,0.76,125,121,141
OceanDNA-b22076,1706,9.8,0.3,4.2e-05,0.068,148,184,329,365,298,374,0.76,36,36,76
OceanDNA-b18035,77,20.5,0.0,1.2e-08,2.1e-06,140,207,231,302,142,309,0.76,67,71,167
OceanDNA-b13250,1533,24.5,0.5,6.8e-09,2.8e-06,71,231,80,241,76,290,0.76,160,161,214
OceanDNA-b20043,202,-0.5,0.0,0.056,9.4,22,66,32,76,17,90,0.76,44,44,73
OceanDNA-b41526,356,14.2,0.1,2e-06,0.0011,107,169,116,176,102,210,0.76,62,60,108
OceanDNA-b22613,197,9.3,0.2,3.1e-05,0.11,150,186,819,855,804,875,0.76,36,36,71
OceanDNA-b23047,344,36.1,0.0,2e-13,1.6e-10,99,248,88,251,27,261,0.76,149,163,234
OceanDNA-b22406,2419,14.5,0.0,3.9e-06,0.0023,151,189,445,484,407,517,0.76,38,39,110
OceanDNA-b37592,1558,18.7,0.1,4.2e-08,8.6e-05,152,177,176,201,124,227,0.76,25,25,103
OceanDNA-b12109,280,14.9,0.0,5.8e-07,0.00023,107,193,27,120,9,136,0.76,86,93,127
OceanDNA-b5580,87,22.2,0.0,6.9e-09,1.6e-06,153,243,148,242,128,263,0.76,90,94,135
OceanDNA-b16626,660,4.0,0.1,0.0013,1.1,91,120,105,134,100,207,0.76,29,29,107
OceanDNA-b23918,382,10.2,0.1,3.2e-05,0.03,103,188,73,157,55,193,0.76,85,84,138
OceanDNA-b6582,313,2.7,0.0,0.0032,2.0,155,177,95,117,82,191,0.76,22,22,109
OceanDNA-b35240,855,11.4,0.0,1.4e-05,0.0072,140,180,123,164,116,179,0.76,40,41,63
OceanDNA-b26229,11,11.1,0.1,8.7e-06,0.0049,114,192,106,184,98,193,0.76,78,78,95
OceanDNA-b9151,162,4.4,0.0,0.0009,0.28,179,251,267,345,255,365,0.76,72,78,110
OceanDNA-b45576,305,12.0,0.0,8.7e-06,0.0057,149,186,143,180,118,200,0.76,37,37,82
OceanDNA-b23122,4081,6.6,0.0,0.00039,0.89,204,268,206,268,189,273,0.76,64,62,84
OceanDNA-b35826,534,12.9,0.0,2.4e-06,0.0028,154,215,125,186,102,235,0.76,61,61,133
OceanDNA-b46722,1229,10.9,0.0,2.8e-05,0.015,78,169,75,168,71,177,0.76,91,93,106
OceanDNA-b32047,1611,16.0,0.0,8.4e-07,0.00099,105,192,545,642,521,652,0.76,87,97,131
OceanDNA-b45442,215,4.2,0.0,0.0021,1.6,197,262,184,247,178,251,0.76,65,63,73
OceanDNA-b38658,572,10.8,0.0,1.1e-05,0.0072,138,184,26,73,13,87,0.76,46,47,74
OceanDNA-b20491,297,52.9,0.0,3.1e-18,5.2e-16,54,279,55,307,47,320,0.76,225,252,273
OceanDNA-b23153,73,-3.9,0.0,0.31,820.0,250,280,330,360,323,362,0.76,30,30,39
OceanDNA-b23153,73,0.2,0.0,0.017,45.0,97,121,138,162,107,168,0.76,24,24,61
OceanDNA-b22461,4000,-1.5,0.0,0.18,270.0,202,221,326,344,319,369,0.76,19,18,50
OceanDNA-b22767,2015,11.9,0.0,9.6e-06,0.013,157,224,149,220,107,225,0.76,67,71,118
OceanDNA-b10082,290,18.5,0.0,9.3e-08,3.6e-05,79,211,94,236,78,252,0.76,132,142,174
OceanDNA-b6508,355,14.7,0.0,6.5e-07,0.00063,95,168,133,204,107,217,0.76,73,71,110
OceanDNA-b41301,4206,11.6,0.1,1.9e-05,0.03,86,182,82,186,63,189,0.76,96,104,126
OceanDNA-b11479,73,12.7,0.0,2.7e-06,0.0014,75,187,24,137,11,154,0.76,112,113,143
OceanDNA-b17550,544,10.7,0.0,1.2e-05,0.013,143,218,153,231,145,239,0.76,75,78,94
OceanDNA-b45289,1404,-3.3,0.0,0.61,510.0,242,278,79,114,76,121,0.76,36,35,45
OceanDNA-b41301,4463,3.9,0.0,0.0039,6.4,191,221,233,263,210,282,0.76,30,30,72
OceanDNA-b20495,104,17.7,0.0,8.4e-08,1.8e-05,219,270,261,312,229,326,0.76,51,51,97
OceanDNA-b7470,187,-2.8,0.0,0.15,82.0,197,212,212,227,206,243,0.76,15,15,37
OceanDNA-b23524,1285,10.3,0.0,4.5e-05,0.021,81,186,52,161,39,183,0.76,105,109,144
OceanDNA-b38743,177,13.4,0.0,1.7e-06,0.00069,143,185,139,182,124,190,0.76,42,43,66
OceanDNA-b24641,274,16.9,0.1,1.4e-07,4.6e-05,103,205,48,152,21,178,0.76,102,104,157
OceanDNA-b34671,566,9.3,0.0,3e-05,0.023,168,255,309,400,280,411,0.76,87,91,131
OceanDNA-b46050,498,4.7,0.0,0.00077,0.75,110,174,728,793,698,801,0.76,64,65,103
OceanDNA-b22922,715,11.3,0.0,1.5e-05,0.013,152,243,172,264,165,290,0.76,91,92,125
OceanDNA-b24140,199,4.8,0.0,0.00072,0.52,139,188,72,120,58,138,0.76,49,48,80
OceanDNA-a842,279,11.2,0.0,1.6e-05,0.0029,104,187,51,143,11,150,0.76,83,92,139
OceanDNA-b30852,1197,3.0,0.0,0.005,4.9,192,244,238,288,211,298,0.76,52,50,87
OceanDNA-b15480,355,11.8,0.0,1e-05,0.0026,138,186,454,502,409,508,0.76,48,48,99
OceanDNA-b31979,1189,31.5,0.3,5.3e-12,1.2e-08,86,227,40,192,27,209,0.76,141,152,182
OceanDNA-b16147,423,16.2,0.0,7e-07,0.00016,77,180,228,350,225,353,0.76,103,122,128
OceanDNA-b44627,133,-3.4,0.0,0.44,200.0,107,122,77,92,60,99,0.76,15,15,39
OceanDNA-b46933,1709,12.1,0.0,8.5e-06,0.017,147,185,268,308,259,327,0.76,38,40,68
OceanDNA-b44627,133,11.3,0.0,1.4e-05,0.0066,154,179,146,171,125,190,0.76,25,25,65
OceanDNA-b27523,751,24.2,0.0,1.7e-09,1.1e-06,83,181,115,221,107,226,0.76,98,106,119
OceanDNA-b32856,565,7.7,0.0,9.4e-05,0.073,190,245,182,233,163,246,0.76,55,51,83
OceanDNA-b38999,680,11.6,0.0,1.2e-05,0.013,140,185,203,249,200,258,0.76,45,46,58
OceanDNA-b4058,518,9.7,0.0,4.4e-05,0.015,103,182,304,394,272,406,0.76,79,90,134
OceanDNA-b10567,54,-0.1,0.0,0.021,6.3,196,217,211,232,204,259,0.76,21,21,55
OceanDNA-b35901,408,19.4,0.1,4.9e-08,1.4e-05,68,185,28,151,18,168,0.76,117,123,150
OceanDNA-b21018,732,3.1,0.0,0.0023,7.6,188,221,240,272,229,302,0.76,33,32,73
OceanDNA-b22615,1167,17.2,0.1,3.5e-07,0.00069,151,195,133,178,127,209,0.76,44,45,82
OceanDNA-b6163,418,12.4,0.0,3.4e-06,0.0019,139,187,95,141,60,158,0.76,48,46,98
OceanDNA-b7277,105,13.0,0.0,2.2e-06,0.00095,154,215,193,259,183,309,0.76,61,66,126
OceanDNA-b19896,68,20.6,0.0,1.1e-08,4.2e-06,145,191,296,342,267,364,0.76,46,46,97
OceanDNA-b22012,141,14.6,0.0,7.3e-07,0.00022,75,176,58,163,52,177,0.76,101,105,125
OceanDNA-b37023,40,-2.7,0.0,0.27,100.0,223,261,350,389,335,396,0.76,38,39,61
OceanDNA-b42311,113,12.4,0.1,3.4e-06,0.00066,87,176,70,163,54,174,0.76,89,93,120
OceanDNA-b22917,474,21.2,0.0,2.8e-08,2e-05,105,185,101,175,81,192,0.76,80,74,111
OceanDNA-b510,1351,0.9,0.0,0.022,24.0,198,243,248,290,238,304,0.76,45,42,66
OceanDNA-b37023,40,15.1,0.0,1e-06,0.00038,81,183,136,243,99,256,0.76,102,107,157
OceanDNA-b22076,2870,27.5,0.1,1.7e-10,2.7e-07,76,174,188,295,164,303,0.75,98,107,139
OceanDNA-b20056,324,54.5,0.0,1e-18,2e-16,72,280,78,313,56,323,0.75,208,235,267
OceanDNA-b29385,2659,-2.6,0.0,0.13,420.0,251,287,580,618,575,620,0.75,36,38,45
OceanDNA-b32050,2125,11.1,0.0,8.6e-06,0.018,96,185,59,155,51,160,0.75,89,96,109
OceanDNA-b3867,683,-0.7,0.1,0.034,55.0,213,244,40,73,34,78,0.75,31,33,44
OceanDNA-b109,1050,9.8,1.0,2.1e-05,0.056,103,187,275,361,220,367,0.75,84,86,147
OceanDNA-b25026,751,1.5,0.0,0.0073,6.4,193,228,266,301,255,329,0.75,35,35,74
OceanDNA-b11507,349,11.9,0.0,4.9e-06,0.0028,153,218,161,228,149,267,0.75,65,67,118
OceanDNA-b13256,1037,36.4,0.0,1.1e-12,3.2e-10,54,248,216,429,206,436,0.75,194,213,230
OceanDNA-b5721,663,4.0,0.0,0.0012,1.2,153,175,159,181,138,196,0.75,22,22,58
OceanDNA-b3257,5,10.3,0.1,1.5e-05,0.012,82,183,62,170,24,183,0.75,101,108,159
OceanDNA-b35874,16,14.7,0.0,6.7e-07,0.0002,151,220,111,179,94,222,0.75,69,68,128
OceanDNA-b13256,1037,-2.7,0.0,0.98,280.0,262,281,82,101,48,108,0.75,19,19,60
OceanDNA-b28576,324,9.9,0.0,1.9e-05,0.0095,119,177,72,126,54,154,0.75,58,54,100
OceanDNA-b23324,307,9.7,0.1,2.3e-05,0.0088,187,269,189,269,186,294,0.75,82,80,108
OceanDNA-b41178,255,69.1,1.2,3.7e-23,4e-20,8,270,34,302,28,320,0.75,262,268,292
OceanDNA-b26680,1903,12.6,0.0,3.1e-06,0.0078,110,187,174,254,155,269,0.75,77,80,114
OceanDNA-b41055,278,12.6,0.0,5.7e-06,0.0062,127,180,125,176,119,193,0.75,53,51,74
OceanDNA-b40439,284,26.1,0.1,4.4e-10,4.4e-07,85,172,132,230,123,236,0.75,87,98,113
OceanDNA-b15171,138,17.2,0.0,1.2e-07,3.1e-05,87,212,31,164,12,216,0.75,125,133,204
OceanDNA-b22882,788,-2.8,0.0,0.14,600.0,144,176,609,641,580,650,0.75,32,32,70
OceanDNA-b20094,30,-1.0,0.0,0.12,15.0,94,120,147,173,138,180,0.75,26,26,42
OceanDNA-b37593,2183,1.8,0.0,0.0059,15.0,138,179,153,193,137,247,0.75,41,40,110
OceanDNA-b46199,612,11.6,0.0,1.2e-05,0.0092,108,182,570,652,559,661,0.75,74,82,102
OceanDNA-b35120,288,11.6,0.0,6.1e-06,0.006,79,189,119,240,60,278,0.75,110,121,218
OceanDNA-b32791,286,8.9,0.0,4e-05,0.012,145,196,136,190,87,198,0.75,51,54,111
OceanDNA-b512,417,4.8,0.0,0.0014,1.2,198,266,198,262,179,262,0.75,68,64,83
OceanDNA-b6778,256,0.4,0.0,0.015,9.1,153,176,142,165,127,178,0.75,23,23,51
OceanDNA-b16147,643,11.1,0.0,2.5e-05,0.0058,109,175,200,264,186,279,0.75,66,64,93
OceanDNA-b23484,982,14.3,0.0,1.8e-06,0.0016,159,188,96,125,84,170,0.75,29,29,86
OceanDNA-b30493,1068,15.0,0.1,5.4e-07,0.00078,167,236,240,307,233,330,0.75,69,67,97
OceanDNA-b20910,5024,19.8,0.7,1.9e-08,0.00016,72,171,36,145,15,158,0.75,99,109,143
OceanDNA-b7450,995,12.6,0.0,5.9e-06,0.0039,83,188,160,268,144,283,0.75,105,108,139
OceanDNA-b35901,22,5.2,0.0,0.0011,0.31,131,175,74,119,47,134,0.75,44,45,87
OceanDNA-b6846,218,-1.1,0.0,0.043,26.0,153,175,139,161,127,172,0.75,22,22,45
OceanDNA-b15167,1879,2.8,0.0,0.0056,5.7,187,243,202,254,195,267,0.75,56,52,72
OceanDNA-b15167,1945,11.1,0.0,1.7e-05,0.017,87,186,54,149,39,193,0.75,99,95,154
OceanDNA-b30857,1356,11.3,0.0,7.6e-06,0.021,140,180,128,169,118,185,0.75,40,41,67
OceanDNA-b2722,200,11.1,0.0,8.7e-06,0.0051,106,197,55,149,32,158,0.75,91,94,126
OceanDNA-b22823,1208,11.1,0.0,8.3e-06,0.035,154,215,105,165,79,174,0.75,61,60,95
OceanDNA-b4159,28,19.0,0.0,3.3e-08,1.5e-05,124,190,111,178,84,191,0.75,66,67,107
OceanDNA-b41337,73,14.1,0.0,1e-06,0.0018,156,180,139,163,117,182,0.75,24,24,65
OceanDNA-b21004,1525,1.0,0.0,0.031,20.0,161,188,99,125,85,153,0.75,27,26,68
OceanDNA-b45622,631,22.0,0.0,4.1e-09,3e-06,151,205,32,88,9,127,0.75,54,56,118
OceanDNA-b35314,474,23.3,0.0,1.6e-09,1.7e-06,85,187,31,148,14,152,0.75,102,117,138
OceanDNA-b4053,568,-1.5,0.0,0.18,42.0,69,96,65,97,59,103,0.75,27,32,44
OceanDNA-b2854,2002,-2.1,0.0,0.26,300.0,198,235,244,280,239,284,0.75,37,36,45
OceanDNA-b22412,1479,14.4,0.0,8.2e-07,0.002,109,187,541,618,533,645,0.75,78,77,112
OceanDNA-b6653,91,8.2,0.0,6.6e-05,0.03,134,173,112,149,36,163,0.75,39,37,127
OceanDNA-b23517,47,2.2,0.0,0.0042,6.1,145,177,130,162,102,175,0.75,32,32,73
OceanDNA-b40892,819,16.4,0.3,2.1e-07,0.00024,137,189,91,145,22,174,0.75,52,54,152
OceanDNA-b36411,1726,12.9,0.0,7.3e-06,0.0048,58,187,19,153,11,164,0.75,129,134,153
OceanDNA-b22548,17,20.1,0.0,4.7e-08,2e-05,129,214,92,182,61,210,0.75,85,90,149
OceanDNA-b19697,279,21.4,0.0,6.2e-09,2.1e-06,129,207,273,359,264,363,0.75,78,86,99
OceanDNA-b37122,207,9.2,0.1,3.2e-05,0.031,149,186,127,164,113,189,0.75,37,37,76
OceanDNA-b16133,287,15.8,0.0,9.5e-07,0.00036,159,245,372,458,356,462,0.75,86,86,106
OceanDNA-b17638,663,23.2,0.0,1.7e-09,1.3e-06,153,218,186,257,173,297,0.75,65,71,124
OceanDNA-b6653,91,5.7,0.1,0.00036,0.17,192,220,218,245,214,272,0.75,28,27,58
OceanDNA-b34663,655,10.3,0.0,2.9e-05,0.012,146,187,66,109,41,116,0.75,41,43,75
OceanDNA-b22397,543,13.0,0.0,9.1e-06,0.006,127,185,112,169,101,184,0.75,58,57,83
OceanDNA-b41510,1344,11.8,0.0,5.1e-06,0.0088,77,168,71,163,67,175,0.75,91,92,108
OceanDNA-b22507,1506,-1.7,0.0,0.13,190.0,95,122,198,225,187,227,0.75,27,27,40
OceanDNA-b20129,312,32.5,0.0,2.6e-12,9.2e-10,152,243,136,238,90,248,0.75,91,102,158
OceanDNA-b29482,1279,0.9,0.0,0.011,35.0,179,246,250,321,236,326,0.75,67,71,90
OceanDNA-b36151,655,20.6,0.1,2.2e-08,2.4e-05,75,181,54,161,30,169,0.75,106,107,139
OceanDNA-b37054,2027,15.4,0.0,8e-07,0.0013,141,180,125,166,117,181,0.75,39,41,64
OceanDNA-b17223,1768,14.7,0.0,2e-06,0.0018,153,225,408,481,363,489,0.75,72,73,126
OceanDNA-b37260,40,23.7,0.0,1.2e-09,1e-06,153,197,138,183,123,244,0.75,44,45,121
OceanDNA-b19574,99,17.5,0.0,9.6e-08,3.7e-05,146,207,332,397,301,400,0.75,61,65,99
OceanDNA-b21004,1385,-2.9,0.0,0.47,300.0,251,269,411,429,401,439,0.75,18,18,38
OceanDNA-b26937,161,11.0,0.0,1.8e-05,0.0021,149,181,223,255,183,279,0.75,32,32,96
OceanDNA-b3983,449,11.9,0.0,1.5e-05,0.0052,97,189,159,260,126,287,0.75,92,101,161
OceanDNA-b40613,659,149.3,0.2,2e-47,5.2e-45,25,279,48,321,20,333,0.75,254,273,313
OceanDNA-b15473,124,20.3,0.0,1.3e-08,7.1e-06,86,199,41,163,24,172,0.75,113,122,148
OceanDNA-b23561,1571,1.7,0.0,0.0063,14.0,105,140,155,191,140,215,0.75,35,36,75
OceanDNA-b2923,1425,15.9,0.0,5.9e-07,0.00057,88,181,40,131,4,146,0.75,93,91,142
OceanDNA-b23976,1658,3.4,0.0,0.0019,3.4,228,264,228,265,187,270,0.75,36,37,83
OceanDNA-b41341,152,10.7,0.0,1.1e-05,0.019,104,187,71,157,30,166,0.75,83,86,136
OceanDNA-b3653,1507,14.3,0.0,3.5e-06,0.002,137,243,139,249,132,256,0.75,106,110,124
OceanDNA-b34653,194,-3.9,0.0,0.31,240.0,259,284,223,249,222,258,0.75,25,26,36
OceanDNA-b3655,555,11.7,0.0,1.7e-05,0.0043,153,245,144,238,134,252,0.75,92,94,118
OceanDNA-b22450,507,13.4,0.0,3.3e-06,0.0023,151,185,193,227,163,238,0.75,34,34,75
OceanDNA-b23043,3744,13.6,0.1,4.4e-06,0.0057,137,216,145,220,123,261,0.75,79,75,138
OceanDNA-b23037,640,15.6,0.0,3.6e-07,0.00064,149,186,32,69,16,109,0.75,37,37,93
OceanDNA-b21144,22,17.9,0.0,7.4e-08,3.3e-05,150,258,128,238,72,253,0.75,108,110,181
OceanDNA-b37351,879,8.5,0.0,5.2e-05,0.065,197,241,222,263,207,274,0.75,44,41,67
OceanDNA-b23104,1060,28.0,0.1,1.8e-10,2.4e-07,46,175,569,703,563,708,0.75,129,134,145
OceanDNA-b13870,479,15.4,0.0,4.3e-07,0.00022,152,211,125,187,105,198,0.75,59,62,93
OceanDNA-b24608,76,5.8,0.0,0.00035,0.19,149,175,142,168,107,174,0.75,26,26,67
OceanDNA-b3457,390,0.8,0.0,0.011,4.8,194,226,175,206,169,226,0.75,32,31,57
OceanDNA-b23458,1638,11.5,0.1,6.6e-06,0.018,128,185,239,290,230,337,0.75,57,51,107
OceanDNA-b20559,114,11.2,0.0,7.8e-06,0.0024,124,192,210,280,201,339,0.75,68,70,138
OceanDNA-b24073,156,15.8,0.1,3e-07,0.00027,136,186,106,151,86,162,0.75,50,45,76
OceanDNA-b22513,1918,-1.0,0.0,0.04,110.0,96,122,152,178,139,181,0.75,26,26,42
OceanDNA-b32822,367,9.5,0.1,5.4e-05,0.017,152,188,85,121,26,150,0.75,36,36,124
OceanDNA-b3673,1776,6.7,0.1,0.00019,0.43,160,200,30,74,15,104,0.75,40,44,89
OceanDNA-b41358,38,11.9,0.0,1.9e-05,0.0056,156,185,157,186,136,194,0.75,29,29,58
OceanDNA-b38215,413,10.1,0.0,1.7e-05,0.023,159,215,125,189,107,228,0.75,56,64,121
OceanDNA-b41301,4463,5.6,0.0,0.0012,1.9,149,178,109,138,23,152,0.75,29,29,129
OceanDNA-b23508,519,7.9,0.0,8.2e-05,0.13,198,263,203,269,197,271,0.75,65,66,74
OceanDNA-b45271,95,-2.8,0.0,0.28,68.0,193,214,220,242,217,256,0.75,21,22,39
OceanDNA-b45271,128,-2.8,0.0,0.3,73.0,240,281,85,125,79,137,0.75,41,40,58
OceanDNA-b17208,311,22.1,0.0,3.9e-09,3.4e-06,75,171,141,248,135,259,0.75,96,107,124
OceanDNA-b950,1814,-2.1,0.0,0.18,190.0,169,187,57,75,47,93,0.75,18,18,46
OceanDNA-b2586,2370,10.4,0.1,1.4e-05,0.033,136,179,218,261,191,282,0.75,43,43,91
OceanDNA-b35857,444,8.0,0.0,7.4e-05,0.035,192,263,233,300,220,302,0.75,71,67,82
OceanDNA-b45372,298,13.5,0.0,1.5e-06,0.0012,152,217,130,197,114,206,0.75,65,67,92
OceanDNA-b43826,61,1.0,0.0,0.0098,16.0,169,218,172,225,166,240,0.75,49,53,74
OceanDNA-b3906,1521,18.8,0.0,3.7e-08,6.4e-05,75,192,187,311,167,318,0.75,117,124,151
OceanDNA-b23139,799,28.4,0.0,9.2e-11,1.1e-07,153,190,164,202,150,263,0.75,37,38,113
OceanDNA-b26126,494,3.5,0.0,0.0018,1.2,193,221,191,219,181,250,0.75,28,28,69
OceanDNA-b36733,877,3.3,0.2,0.0039,3.9,49,143,37,133,33,155,0.75,94,96,122
OceanDNA-b26842,273,5.6,0.1,0.0008,0.9,161,187,110,136,37,159,0.75,26,26,122
OceanDNA-b32138,1561,10.8,0.2,1.1e-05,0.022,98,188,120,209,108,225,0.75,90,89,117
OceanDNA-b5405,23,57.7,0.0,5.4e-20,5.1e-17,84,247,86,255,36,263,0.75,163,169,227
OceanDNA-b32695,807,-0.8,0.0,0.036,33.0,154,190,101,138,67,156,0.75,36,37,89
OceanDNA-b13654,77,7.1,0.0,0.00014,0.078,193,245,199,247,186,262,0.75,52,48,76
OceanDNA-b45263,1584,8.6,0.0,5e-05,0.13,134,181,229,270,183,279,0.75,47,41,96
OceanDNA-b34924,232,3.4,0.1,0.0037,1.8,248,280,377,409,346,420,0.75,32,32,74
OceanDNA-b46972,215,10.6,0.0,2.4e-05,0.0092,150,197,312,361,299,369,0.75,47,49,70
OceanDNA-b20044,310,48.4,0.1,3.8e-17,1.5e-14,72,282,105,342,82,352,0.75,210,237,270
OceanDNA-b22140,351,11.4,0.0,7e-06,0.0032,165,216,354,410,349,414,0.75,51,56,65
OceanDNA-b23832,3,-1.8,0.0,0.15,130.0,49,113,66,136,58,141,0.75,64,70,83
OceanDNA-b20894,1026,4.1,0.1,0.0023,4.9,152,177,124,149,110,243,0.75,25,25,133
OceanDNA-b16213,512,12.2,0.0,4e-06,0.0034,177,246,430,502,424,510,0.75,69,72,86
OceanDNA-b46894,172,11.4,0.0,1.4e-05,0.0088,153,216,129,194,115,206,0.75,63,65,91
OceanDNA-b15137,529,7.7,0.0,0.00027,0.19,152,183,85,116,59,133,0.75,31,31,74
OceanDNA-b30739,776,18.6,0.0,4.5e-08,6.1e-05,69,212,93,248,76,260,0.75,143,155,184
OceanDNA-b30854,1685,6.8,0.0,0.00034,0.39,175,244,229,300,219,314,0.75,69,71,95
OceanDNA-b33331,1087,53.4,0.1,2.2e-18,1.7e-15,97,270,209,400,191,418,0.75,173,191,227
OceanDNA-b23372,240,12.7,0.4,5.7e-06,0.0069,99,183,100,182,92,189,0.75,84,82,97
OceanDNA-b46647,1849,12.7,0.0,5.6e-06,0.0063,87,139,297,353,223,383,0.75,52,56,160
OceanDNA-b20092,192,-1.0,0.0,0.041,9.9,94,120,151,177,142,184,0.75,26,26,42
OceanDNA-b22293,614,15.1,0.1,5e-07,0.00057,138,188,118,170,112,229,0.75,50,52,117
OceanDNA-b46265,580,11.2,0.1,1.6e-05,0.015,150,185,147,182,89,202,0.75,35,35,113
OceanDNA-b38370,177,-2.0,0.0,0.17,140.0,152,172,157,177,144,182,0.75,20,20,38
OceanDNA-b3916,443,11.9,0.0,4.9e-06,0.0094,102,179,307,395,276,401,0.75,77,88,125
OceanDNA-b17273,2095,5.6,0.0,0.0012,1.0,150,194,130,177,90,186,0.75,44,47,96
OceanDNA-b37573,1579,24.5,0.0,7e-10,1.9e-06,76,243,108,293,105,304,0.75,167,185,199
OceanDNA-b40768,338,17.7,0.0,1.7e-07,5.2e-05,140,181,143,186,136,207,0.75,41,43,71
OceanDNA-b20595,175,14.4,0.0,8.2e-07,0.00022,218,279,269,331,244,343,0.75,61,62,99
OceanDNA-b46921,2201,23.6,0.0,2.6e-09,3.1e-06,135,185,436,481,421,495,0.75,50,45,74
OceanDNA-b13295,2627,19.0,0.4,3.3e-08,9e-05,80,174,101,209,68,216,0.75,94,108,148
OceanDNA-b46897,281,10.3,0.0,1.5e-05,0.013,135,191,168,220,160,250,0.75,56,52,90
OceanDNA-b1991,34,18.4,0.0,5.1e-08,3e-05,75,177,52,159,36,165,0.75,102,107,129
OceanDNA-b25128,258,0.8,0.0,0.023,9.9,195,245,227,275,220,290,0.75,50,48,70
OceanDNA-b4028,760,11.1,0.0,1.7e-05,0.0071,152,190,371,410,354,449,0.75,38,39,95
OceanDNA-b33108,794,12.0,0.0,4.5e-06,0.0059,191,246,208,259,178,274,0.75,55,51,96
OceanDNA-b6295,384,-2.1,0.0,0.18,45.0,150,185,381,417,372,429,0.75,35,36,57
OceanDNA-b22461,4000,9.9,0.0,5.8e-05,0.089,101,171,168,239,150,260,0.75,70,71,110
OceanDNA-b34562,134,15.9,0.1,2.9e-07,0.00021,143,187,153,200,91,212,0.75,44,47,121
OceanDNA-b32166,2396,9.2,0.1,3.2e-05,0.09,133,175,228,269,207,290,0.75,42,41,83
OceanDNA-b33329,584,2.8,0.0,0.0084,4.4,194,261,311,378,301,380,0.75,67,67,79
OceanDNA-b30927,693,16.4,0.0,4.1e-07,0.00043,86,183,60,165,52,180,0.75,97,105,128
OceanDNA-b43987,160,7.6,0.0,0.0002,0.022,128,175,37,86,30,93,0.75,47,49,63
OceanDNA-b45275,81,1.3,0.0,0.016,2.5,183,263,313,394,295,397,0.75,80,81,102
OceanDNA-b30042,1923,4.0,0.1,0.0038,4.4,144,218,67,142,50,157,0.75,74,75,107
OceanDNA-b38495,572,3.2,0.0,0.0066,1.8,193,245,266,318,249,323,0.75,52,52,74
OceanDNA-b30927,17,-2.6,0.0,0.26,270.0,87,104,269,288,262,295,0.75,17,19,33
OceanDNA-b40959,1853,10.8,0.0,2e-05,0.032,156,180,184,208,160,233,0.75,24,24,73
OceanDNA-b46208,180,11.2,0.0,1.6e-05,0.0082,148,196,89,137,22,142,0.75,48,48,120
OceanDNA-b40959,1116,22.3,0.0,6.4e-09,1e-05,91,211,139,269,64,305,0.75,120,130,241
OceanDNA-b4252,269,9.8,0.0,2.1e-05,0.052,154,197,70,111,59,140,0.75,43,41,81
OceanDNA-b22353,1092,16.5,0.0,3.8e-07,0.00021,152,223,120,198,106,206,0.75,71,78,100
OceanDNA-b17240,117,14.8,0.0,6.4e-07,0.00031,75,175,122,233,104,240,0.75,100,111,136
OceanDNA-b1343,542,12.1,0.1,4.2e-06,0.0066,139,187,75,122,71,155,0.75,48,47,84
OceanDNA-b25045,394,10.1,0.1,1.7e-05,0.015,155,179,146,170,124,184,0.75,24,24,60
OceanDNA-b1738,534,-0.7,0.0,0.098,120.0,198,244,219,263,190,268,0.75,46,44,78
OceanDNA-b13249,71,23.8,0.1,3.5e-09,1.1e-06,137,213,51,131,7,166,0.75,76,80,159
OceanDNA-b17201,332,18.7,0.0,4.1e-08,3.3e-05,75,171,161,268,155,278,0.75,96,107,123
OceanDNA-b45444,359,6.3,0.0,0.00025,0.13,157,198,13,54,4,61,0.75,41,41,57
OceanDNA-b44435,2563,0.9,0.0,0.021,28.0,150,189,392,431,342,444,0.75,39,39,102
OceanDNA-b31475,251,13.8,0.0,1.2e-06,0.0008,159,185,180,206,154,222,0.75,26,26,68
OceanDNA-b13288,867,44.7,0.0,5.1e-16,5.4e-13,82,225,274,437,271,457,0.75,143,163,186
OceanDNA-b13281,1799,18.2,0.0,1.2e-07,0.00011,153,189,115,151,104,193,0.75,36,36,89
OceanDNA-b6666,393,12.3,0.1,3.6e-06,0.0028,55,122,20,87,5,93,0.75,67,67,88
OceanDNA-b15967,1133,16.2,0.2,2.3e-07,0.00042,83,218,33,178,7,212,0.75,135,145,205
OceanDNA-b13561,428,10.0,0.0,3.7e-05,0.015,187,227,207,245,191,261,0.75,40,38,70
OceanDNA-b20991,229,12.6,0.1,9.1e-06,0.0057,91,168,181,269,171,284,0.75,77,88,113
OceanDNA-b23491,381,4.9,0.0,0.0013,1.2,200,267,233,298,222,306,0.75,67,65,84
OceanDNA-b22991,2903,18.9,0.1,1.1e-07,0.00017,86,192,279,391,267,425,0.75,106,112,158
OceanDNA-b20820,156,10.5,0.0,2.6e-05,0.0073,12,74,12,78,4,88,0.75,62,66,84
OceanDNA-b22755,517,11.8,0.0,5.1e-06,0.0044,152,185,558,591,521,662,0.75,33,33,141
OceanDNA-b44168,3,10.9,0.0,9.5e-06,0.005,139,185,67,114,47,140,0.75,46,47,93
OceanDNA-b22108,67,15.7,0.0,6.7e-07,0.00069,152,195,137,180,116,209,0.75,43,43,93
OceanDNA-b25927,19,9.5,0.0,2.6e-05,0.0082,137,180,208,245,183,270,0.75,43,37,87
OceanDNA-b46908,1333,-3.4,0.0,0.23,780.0,47,69,570,592,549,593,0.75,22,22,44
OceanDNA-b1588,529,2.7,0.0,0.0031,2.5,195,245,226,272,208,286,0.75,50,46,78
OceanDNA-b16098,320,7.0,0.0,0.00031,0.12,193,245,422,473,398,507,0.75,52,51,109
OceanDNA-b22108,67,3.0,0.1,0.0048,4.9,200,255,209,262,191,273,0.75,55,53,82
OceanDNA-b14740,185,13.6,0.0,1.4e-06,0.00038,123,196,79,153,69,164,0.75,73,74,95
OceanDNA-b32974,1907,13.4,0.0,3.3e-06,0.005,151,184,146,181,132,193,0.75,33,35,61
OceanDNA-b15471,102,19.0,0.2,3.4e-08,1.9e-05,103,188,55,148,26,162,0.75,85,93,136
OceanDNA-b17091,323,14.9,0.0,5.7e-07,0.00062,104,189,47,141,14,206,0.75,85,94,192
OceanDNA-b21364,347,5.0,0.0,0.00063,0.44,194,243,186,233,175,240,0.75,49,47,65
OceanDNA-b518,3661,11.1,0.1,8.6e-06,0.033,141,176,118,155,109,168,0.75,35,37,59
OceanDNA-b3965,374,-0.5,0.0,0.03,32.0,196,215,207,226,194,251,0.75,19,19,57
OceanDNA-b9243,342,17.4,0.0,1e-07,3.5e-05,151,206,147,205,130,242,0.75,55,58,112
OceanDNA-b3965,374,9.5,0.0,2.5e-05,0.027,159,208,96,145,73,169,0.75,49,49,96
OceanDNA-b6704,774,-3.0,0.0,0.5,140.0,221,240,71,90,58,94,0.75,19,19,36
OceanDNA-b40920,808,25.0,1.1,9.6e-10,6e-07,75,244,101,286,14,289,0.75,169,185,275
OceanDNA-b37535,1422,-1.1,0.0,0.09,80.0,31,53,149,171,126,178,0.75,22,22,52
OceanDNA-b9096,35,10.6,0.0,2.4e-05,0.0041,179,253,273,353,261,375,0.75,74,80,114
OceanDNA-b2513,1292,11.0,0.2,1.8e-05,0.013,77,177,29,132,16,152,0.75,100,103,136
OceanDNA-b23176,189,-1.9,0.0,0.24,600.0,250,267,280,297,265,312,0.75,17,17,47
OceanDNA-b43651,721,15.4,0.1,4.2e-07,0.0004,123,253,97,225,57,234,0.75,130,128,177
OceanDNA-b46559,174,11.9,0.0,4.8e-06,0.0039,143,186,117,160,95,184,0.75,43,43,89
OceanDNA-b31005,2016,4.9,0.0,0.00065,1.8,229,268,282,322,248,343,0.75,39,40,95
OceanDNA-b15118,491,13.2,0.0,1.9e-06,0.0013,105,187,85,182,35,201,0.75,82,97,166
OceanDNA-b27,3135,15.3,0.3,4.4e-07,0.0015,87,176,75,160,49,164,0.75,89,85,115
OceanDNA-b35325,133,11.9,0.0,4.9e-06,0.0026,93,181,30,113,14,128,0.75,88,83,114
OceanDNA-b26065,209,10.9,0.0,9.6e-06,0.0034,141,177,132,170,124,195,0.75,36,38,71
OceanDNA-b37060,975,11.7,0.0,5.5e-06,0.0056,144,186,172,216,129,228,0.75,42,44,99
OceanDNA-b37161,189,13.8,0.1,1.2e-06,0.0014,107,185,51,126,32,140,0.75,78,75,108
OceanDNA-b33329,1259,-0.1,0.0,0.064,33.0,206,250,73,116,47,127,0.75,44,43,80
OceanDNA-b44154,508,17.8,0.1,7.9e-08,4.1e-05,98,198,46,149,21,160,0.75,100,103,139
OceanDNA-b27565,2096,13.4,0.1,1.6e-06,0.004,152,185,74,107,56,150,0.75,33,33,94
OceanDNA-b30,835,4.1,0.0,0.0023,4.2,193,228,309,343,303,368,0.75,35,34,65
OceanDNA-b13296,356,11.2,0.0,7.9e-06,0.008,149,185,228,264,149,271,0.74,36,36,122
OceanDNA-b23396,1251,-1.8,0.0,0.14,140.0,196,222,268,294,233,298,0.74,26,26,65
OceanDNA-b35218,372,11.6,0.0,6e-06,0.0053,160,180,148,168,123,181,0.74,20,20,58
OceanDNA-b3934,51,15.2,0.0,9.9e-07,0.00035,84,188,152,259,141,266,0.74,104,107,125
OceanDNA-b36889,1742,14.4,0.1,8.3e-07,0.0021,89,177,79,172,65,214,0.74,88,93,149
OceanDNA-b41695,121,-0.3,0.0,0.05,4.6,197,254,215,268,208,275,0.74,57,53,67
OceanDNA-b12642,408,-0.6,0.0,0.031,18.0,195,213,201,220,195,232,0.74,18,19,37
OceanDNA-b16662,303,8.6,0.0,5e-05,0.049,136,177,324,364,314,375,0.74,41,40,61
OceanDNA-b31523,1127,26.7,0.2,1.5e-10,2.2e-07,82,175,156,263,148,271,0.74,93,107,123
OceanDNA-b22997,222,9.8,0.0,6.2e-05,0.021,153,215,155,221,125,225,0.74,62,66,100
OceanDNA-b8980,2,27.2,0.0,1.1e-10,3e-08,153,244,195,291,184,311,0.74,91,96,127
OceanDNA-b31510,187,1.1,0.0,0.019,10.0,179,230,366,423,349,451,0.74,51,57,102
OceanDNA-b16220,1203,29.0,0.1,6e-11,3.7e-08,52,180,260,403,221,409,0.74,128,143,188
OceanDNA-b9532,294,12.8,0.0,5e-06,0.00077,138,238,167,269,147,295,0.74,100,102,148
OceanDNA-b40235,671,-3.6,0.0,0.26,190.0,163,185,18,40,15,57,0.74,22,22,42
OceanDNA-b15892,186,-3.8,0.0,0.29,88.0,202,216,204,218,200,234,0.74,14,14,34
OceanDNA-b9659,37,28.5,0.0,4.2e-11,2.3e-08,84,174,141,243,131,250,0.74,90,102,119
OceanDNA-b40245,298,14.0,0.1,3.3e-06,0.0008,105,197,76,171,43,230,0.74,92,95,187
OceanDNA-b13585,1281,10.6,0.0,5.9e-05,0.018,125,182,133,189,125,209,0.74,57,56,84
OceanDNA-b24117,1926,16.0,0.1,5.3e-07,0.00069,67,191,11,143,2,155,0.74,124,132,153
OceanDNA-b30743,468,16.4,0.0,2.1e-07,0.00032,79,211,48,191,21,243,0.74,132,143,222
OceanDNA-b37960,81,-2.9,0.0,0.48,90.0,12,44,187,219,174,224,0.74,32,32,50
OceanDNA-b4594,24,5.9,0.0,0.00064,0.16,161,197,107,147,20,153,0.74,36,40,133
OceanDNA-b30627,591,24.6,0.3,6.6e-10,6.2e-07,86,176,149,249,135,268,0.74,90,100,133
OceanDNA-b4005,959,3.6,0.0,0.0033,1.8,185,241,143,201,118,221,0.74,56,58,103
OceanDNA-b32,392,3.1,0.0,0.0045,1.4,77,124,121,172,53,197,0.74,47,51,144
OceanDNA-b4022,800,16.1,0.3,4.9e-07,0.0003,75,184,36,152,16,192,0.74,109,116,176
OceanDNA-b40639,13,12.4,0.0,6.9e-06,0.0025,93,181,27,109,5,118,0.74,88,82,113
OceanDNA-b44376,357,10.0,0.0,1.9e-05,0.0096,141,185,166,210,126,215,0.74,44,44,89
OceanDNA-b1424,451,3.2,0.0,0.0042,1.7,195,244,202,247,184,258,0.74,49,45,74
OceanDNA-b23289,1196,-0.6,0.0,0.032,57.0,22,82,56,115,36,134,0.74,60,59,98
OceanDNA-b45640,461,22.9,0.0,2.2e-09,1.3e-06,136,252,126,252,120,269,0.74,116,126,149
OceanDNA-b33272,1193,10.7,0.0,1.2e-05,0.027,137,189,184,239,178,253,0.74,52,55,75
OceanDNA-b32692,1303,1.9,0.0,0.0055,13.0,192,236,182,225,165,248,0.74,44,43,83
OceanDNA-b20975,3216,18.0,0.1,6.9e-08,0.00039,91,170,115,204,91,216,0.74,79,89,125
OceanDNA-b40889,92,22.7,0.0,5.1e-09,1.6e-06,85,171,126,223,120,227,0.74,86,97,107
OceanDNA-b20703,336,14.1,0.0,1e-06,0.00039,130,192,216,281,208,313,0.74,62,65,105
OceanDNA-b35385,206,12.7,0.0,2.7e-06,0.0021,148,219,113,192,96,230,0.74,71,79,134
OceanDNA-b423,584,-3.6,0.1,0.26,260.0,152,177,229,254,219,257,0.74,25,25,38
OceanDNA-b7949,171,-1.0,0.0,0.041,13.0,194,217,216,239,211,268,0.74,23,23,57
OceanDNA-b32645,804,-0.4,0.0,0.026,22.0,156,191,135,168,123,184,0.74,35,33,61
OceanDNA-b17610,131,4.2,0.0,0.0022,4.1,197,230,265,297,255,314,0.74,33,32,59
OceanDNA-b44390,296,3.9,0.0,0.0041,0.95,203,264,242,301,228,311,0.74,61,59,83
OceanDNA-b15333,114,3.1,0.0,0.0023,0.7,193,222,254,283,243,306,0.74,29,29,63
OceanDNA-b22991,1117,11.8,0.0,1.6e-05,0.024,94,180,271,355,262,373,0.74,86,84,111
OceanDNA-b28146,1182,10.0,0.4,1.9e-05,0.035,134,196,72,129,34,133,0.74,62,57,99
OceanDNA-b34767,496,1.7,0.0,0.012,5.6,201,230,227,255,215,282,0.74,29,28,67
OceanDNA-b40257,356,13.4,0.1,1.7e-06,0.0014,50,177,68,216,62,228,0.74,127,148,166
OceanDNA-b20893,1271,0.6,0.0,0.013,79.0,247,277,416,446,399,460,0.74,30,30,61
OceanDNA-b22093,3173,15.8,0.0,3.1e-07,0.0011,150,221,496,568,477,609,0.74,71,72,132
OceanDNA-b9718,79,13.2,0.0,2e-06,0.001,160,235,123,200,116,217,0.74,75,77,101
OceanDNA-b40453,184,9.3,0.0,6e-05,0.036,178,241,276,344,271,352,0.74,63,68,81
OceanDNA-b17610,1895,14.0,0.0,2.2e-06,0.0041,141,186,206,250,159,263,0.74,45,44,104
OceanDNA-b20925,7938,8.9,0.0,4.1e-05,0.35,196,246,263,309,239,318,0.74,50,46,79
OceanDNA-b13263,346,27.2,0.0,2.1e-10,1e-07,91,246,138,296,115,307,0.74,155,158,192
OceanDNA-b7917,251,-3.6,0.0,0.25,64.0,196,213,138,155,132,160,0.74,17,17,28
OceanDNA-b29542,1230,12.4,0.1,6.8e-06,0.0076,106,198,189,284,171,298,0.74,92,95,127
OceanDNA-b6493,506,15.5,0.0,7.9e-07,0.0003,88,212,108,242,81,292,0.74,124,134,211
OceanDNA-b45128,771,12.8,0.0,2.5e-06,0.0026,89,214,48,187,17,210,0.74,125,139,193
OceanDNA-b22687,325,24.9,0.1,5.4e-10,5.3e-07,137,219,135,216,126,245,0.74,82,81,119
OceanDNA-b17331,550,11.9,0.1,4.9e-06,0.0045,141,183,161,203,129,210,0.74,42,42,81
OceanDNA-b8077,136,-3.1,0.0,0.18,36.0,198,218,213,234,208,242,0.74,20,21,34
OceanDNA-b6768,369,17.6,0.0,8.9e-08,6.5e-05,152,228,115,195,105,215,0.74,76,80,110
OceanDNA-b34943,650,10.7,0.0,1.1e-05,0.0081,156,180,161,185,140,204,0.74,24,24,64
OceanDNA-b36411,1843,11.4,0.0,2e-05,0.013,115,186,148,217,124,231,0.74,71,69,107
OceanDNA-b20726,68,0.5,0.0,0.015,2.4,220,282,256,316,229,328,0.74,62,60,99
OceanDNA-b22806,4603,13.5,0.0,4.8e-06,0.0074,105,179,205,285,167,298,0.74,74,80,131
OceanDNA-b276,205,37.0,0.0,3.3e-13,2.5e-10,142,244,124,228,79,236,0.74,102,104,157
OceanDNA-b34892,416,12.4,0.0,6.6e-06,0.003,107,212,129,245,105,256,0.74,105,116,151
OceanDNA-b34892,191,5.7,0.0,0.00073,0.33,181,243,315,379,307,400,0.74,62,64,93
OceanDNA-b42603,1,12.3,0.0,3.7e-06,0.00087,149,229,169,255,155,283,0.74,80,86,128
OceanDNA-b22377,438,14.4,0.0,1.7e-06,0.002,75,184,39,148,4,166,0.74,109,109,162
OceanDNA-b30938,2151,2.1,0.0,0.014,11.0,188,245,252,309,230,321,0.74,57,57,91
OceanDNA-b19419,260,22.9,0.0,2.1e-09,6.4e-07,138,189,140,187,85,242,0.74,51,47,157
OceanDNA-b38979,688,11.1,0.1,8.7e-06,0.02,107,185,150,239,134,268,0.74,78,89,134
OceanDNA-b35333,154,13.4,0.0,1.7e-06,0.00057,77,182,41,152,20,160,0.74,105,111,140
OceanDNA-b16098,490,2.2,0.0,0.0084,3.3,179,243,230,297,222,310,0.74,64,67,88
OceanDNA-b25124,314,11.6,0.0,6.1e-06,0.0071,147,186,133,172,111,204,0.74,39,39,93
OceanDNA-b17223,1759,10.9,0.1,3e-05,0.027,90,175,71,152,66,160,0.74,85,81,94
OceanDNA-b10297,536,-1.0,0.0,0.04,23.0,150,189,525,564,514,575,0.74,39,39,61
OceanDNA-b24086,214,9.8,0.0,4.3e-05,0.013,144,186,233,269,152,275,0.74,42,36,123
OceanDNA-b3920,1406,10.4,0.0,4.1e-05,0.026,102,180,307,396,276,403,0.74,78,89,127
OceanDNA-b15769,787,23.0,0.0,8.2e-09,3.6e-06,80,204,27,160,12,196,0.74,124,133,184
OceanDNA-b43873,508,20.9,3.5,8.8e-09,1e-05,72,249,70,241,11,279,0.74,177,171,268
OceanDNA-b21019,1371,10.9,0.0,1.9e-05,0.029,120,187,91,160,86,165,0.74,67,69,79
OceanDNA-b6556,429,8.3,0.0,6.2e-05,0.071,202,265,196,257,180,260,0.74,63,61,80
OceanDNA-b13249,128,17.7,0.0,2.5e-07,7.7e-05,152,261,34,149,1,177,0.74,109,115,176
OceanDNA-b260,2646,22.9,0.0,6.3e-09,6.9e-06,149,218,140,212,111,245,0.74,69,72,134
OceanDNA-b8783,80,25.7,0.0,3e-10,5.5e-08,153,227,206,285,194,319,0.74,74,79,125
OceanDNA-b18639,90,56.7,1.6,2.2e-19,4.5e-17,68,282,99,340,78,352,0.74,214,241,274
OceanDNA-b24097,631,15.8,0.0,3.2e-07,0.00048,79,180,98,205,63,223,0.74,101,107,160
OceanDNA-b22017,4207,11.2,0.1,7.6e-06,0.042,104,197,318,414,268,421,0.74,93,96,153
OceanDNA-b23143,876,-1.2,0.0,0.094,130.0,248,280,352,384,342,390,0.74,32,32,48
OceanDNA-b34885,288,11.1,0.0,1.7e-05,0.006,125,181,48,105,36,123,0.74,56,57,87
OceanDNA-b34885,92,10.0,0.0,3.6e-05,0.013,140,186,496,544,453,559,0.74,46,48,106
OceanDNA-b5608,496,11.7,0.0,5.7e-06,0.0044,141,187,30,79,11,93,0.74,46,49,82
OceanDNA-b37083,540,5.9,0.0,0.00033,0.22,180,245,294,364,287,369,0.74,65,70,82
OceanDNA-b37442,757,10.3,0.1,2.9e-05,0.015,156,186,89,125,72,132,0.74,30,36,60
OceanDNA-b13300,331,7.9,0.0,7.9e-05,0.13,152,179,136,163,97,172,0.74,27,27,75
OceanDNA-b30217,1058,21.5,0.7,5.6e-09,1.3e-05,82,175,130,234,125,245,0.74,93,104,120
OceanDNA-b21004,811,11.5,0.0,2e-05,0.013,140,179,20,60,11,77,0.74,39,40,66
OceanDNA-b19130,5,11.3,0.0,1.4e-05,0.0032,131,191,279,343,269,355,0.74,60,64,86
OceanDNA-b42542,274,15.6,0.0,3.6e-07,0.0001,96,215,39,171,18,200,0.74,119,132,182
OceanDNA-b46554,500,18.1,0.0,6.1e-08,6.4e-05,143,191,145,192,132,223,0.74,48,47,91
OceanDNA-b12076,229,-1.6,0.0,0.061,25.0,191,212,216,237,190,245,0.74,21,21,55
OceanDNA-b5857,282,0.5,0.0,0.014,6.0,153,172,139,158,120,172,0.74,19,19,52
OceanDNA-b46647,2053,18.7,0.1,8.5e-08,9.6e-05,138,190,139,188,118,220,0.74,52,49,102
OceanDNA-b20036,199,-1.6,0.0,0.18,23.0,127,150,353,375,335,378,0.74,23,22,43
OceanDNA-b20349,336,7.7,0.0,9.5e-05,0.039,219,275,250,307,212,322,0.74,56,57,110
OceanDNA-b34544,647,19.9,0.0,3.5e-08,1.3e-05,123,246,92,219,50,232,0.74,123,127,182
OceanDNA-b30001,346,17.8,0.0,1.6e-07,0.00013,88,178,119,216,85,227,0.74,90,97,142
OceanDNA-b17381,628,15.2,0.0,4.8e-07,0.00049,84,212,265,403,236,416,0.74,128,138,180
OceanDNA-b512,233,-2.5,0.0,0.23,190.0,56,73,150,167,145,202,0.74,17,17,57
OceanDNA-a2885,877,11.8,0.0,5.3e-06,0.0075,151,176,100,125,45,138,0.74,25,25,93
OceanDNA-b269,1108,25.1,0.0,9.2e-10,9.5e-07,152,243,184,280,135,295,0.74,91,96,160
OceanDNA-b22800,299,2.4,0.0,0.0074,6.3,105,174,386,453,359,463,0.74,69,67,104
OceanDNA-b42461,83,9.6,0.0,2.5e-05,0.0077,197,266,216,281,209,283,0.74,69,65,74
OceanDNA-b22997,222,-4.0,0.0,0.99,330.0,266,279,415,428,406,431,0.74,13,13,25
OceanDNA-b16209,599,11.4,0.0,1.4e-05,0.0088,154,240,105,191,81,203,0.74,86,86,122
OceanDNA-b22461,2712,13.1,0.1,6.4e-06,0.0098,122,182,132,195,64,279,0.74,60,63,215
OceanDNA-b22893,2192,10.7,0.1,3.3e-05,0.026,136,186,211,262,199,270,0.74,50,51,71
OceanDNA-b22797,381,18.6,0.3,8.5e-08,5.5e-05,69,196,224,359,192,364,0.74,127,135,172
OceanDNA-b22130,1424,21.6,0.1,1.1e-08,1.4e-05,92,177,276,363,257,368,0.74,85,87,111
OceanDNA-b46908,1333,-3.1,0.0,0.17,600.0,180,247,448,513,443,515,0.74,67,65,72
OceanDNA-b32091,179,13.6,0.0,1.5e-06,0.0028,105,194,555,654,536,661,0.74,89,99,125
OceanDNA-b14516,393,3.4,0.0,0.0019,1.1,186,233,199,245,183,266,0.74,47,46,83
OceanDNA-b11343,100,13.6,0.0,1.5e-06,0.00068,138,191,154,210,130,245,0.74,53,56,115
OceanDNA-b3643,751,10.7,0.1,1.1e-05,0.0096,134,182,97,144,20,194,0.74,48,47,174
OceanDNA-b16227,638,-2.0,0.0,0.24,85.0,196,229,219,251,204,277,0.74,33,32,73
OceanDNA-b3144,1036,14.9,0.1,1.2e-06,0.0008,75,188,97,222,22,235,0.74,113,125,213
OceanDNA-b45818,450,16.0,0.0,1.3e-06,0.0004,106,181,566,649,552,657,0.74,75,83,105
OceanDNA-b16161,577,18.3,0.0,5.4e-08,4.3e-05,77,173,42,149,35,155,0.74,96,107,120
OceanDNA-b29209,436,10.7,0.0,1.1e-05,0.0064,136,193,205,259,141,271,0.74,57,54,130
OceanDNA-b27536,721,8.3,0.0,6e-05,0.099,172,245,264,342,254,349,0.74,73,78,95
OceanDNA-b6748,244,17.5,0.0,9.3e-08,7.6e-05,44,212,59,238,55,251,0.74,168,179,196
OceanDNA-b42533,111,15.7,0.0,3.3e-07,7.1e-05,96,172,59,133,29,143,0.74,76,74,114
OceanDNA-b7503,295,18.2,0.0,6e-08,4.6e-05,151,215,153,221,140,232,0.74,64,68,92
OceanDNA-b31969,612,14.7,0.0,7e-07,0.001,101,189,180,266,166,280,0.74,88,86,114
OceanDNA-b35112,63,12.7,0.0,5.4e-06,0.0028,156,183,20,47,2,61,0.74,27,27,59
OceanDNA-b20782,503,10.7,0.0,2.3e-05,0.011,87,184,35,134,23,141,0.74,97,99,118
OceanDNA-b32285,973,-2.1,0.0,0.092,92.0,94,130,62,102,59,118,0.74,36,40,59
OceanDNA-b22759,156,19.8,0.1,3.8e-08,1.9e-05,139,219,152,228,139,257,0.74,80,76,118
OceanDNA-b22406,759,14.6,0.0,3.8e-06,0.0022,108,191,169,259,165,266,0.74,83,90,101
OceanDNA-b13250,4012,42.1,0.9,3e-14,1.2e-11,101,231,182,303,139,341,0.74,130,121,202
OceanDNA-b13250,1592,-3.4,0.0,2.2,910.0,199,218,248,267,246,281,0.74,19,19,35
OceanDNA-b32148,502,0.5,0.0,0.014,26.0,193,218,219,244,198,277,0.74,25,25,79
OceanDNA-b10261,75,-1.0,0.0,0.042,14.0,195,225,215,244,209,253,0.74,30,29,44
OceanDNA-b23093,2434,16.9,0.0,4.4e-07,0.0009,75,171,375,482,372,492,0.74,96,107,120
OceanDNA-b30046,2482,4.3,0.2,0.002,3.0,139,177,51,88,24,99,0.74,38,37,75
OceanDNA-b23832,3,2.8,0.0,0.0058,5.0,153,215,140,207,127,225,0.74,62,67,98
OceanDNA-a4078,317,2.3,0.1,0.0041,1.4,71,129,90,153,75,154,0.74,58,63,79
OceanDNA-a1335,150,13.2,0.0,2e-06,0.00031,84,180,36,128,22,145,0.74,96,92,123
OceanDNA-b16209,388,9.1,0.0,6.9e-05,0.044,194,246,453,504,431,512,0.74,52,51,81
OceanDNA-b46839,520,15.4,0.0,8.2e-07,0.00052,152,243,163,256,146,267,0.74,91,93,121
OceanDNA-b46964,505,20.0,0.0,1.7e-08,1.2e-05,151,229,152,241,138,276,0.74,78,89,138
OceanDNA-b13256,418,22.4,0.2,2.2e-08,6.1e-06,93,270,195,362,155,385,0.74,177,167,230
OceanDNA-b13256,790,21.2,0.0,4.9e-08,1.4e-05,106,189,416,493,346,541,0.74,83,77,195
OceanDNA-b17273,2095,4.5,0.0,0.0025,2.1,205,266,229,288,216,292,0.74,61,59,76
OceanDNA-b15777,1620,8.0,0.0,0.00022,0.13,149,180,103,134,28,160,0.74,31,31,132
OceanDNA-b22607,683,20.4,0.1,2.6e-08,1.2e-05,152,216,152,218,132,246,0.74,64,66,114
OceanDNA-b36831,738,20.5,0.0,1.2e-08,1.3e-05,153,187,143,177,115,249,0.74,34,34,134
OceanDNA-b44039,156,8.5,0.5,0.0001,0.016,129,172,142,187,69,193,0.74,43,45,124
OceanDNA-b27525,1377,21.9,0.5,1.8e-08,1.2e-05,80,178,115,220,99,225,0.74,98,105,126
OceanDNA-b36885,333,-2.7,0.0,0.14,95.0,92,120,119,147,111,150,0.74,28,28,39
OceanDNA-b6501,201,3.2,0.1,0.0067,1.1,204,265,198,257,181,262,0.74,61,59,81
OceanDNA-b6674,104,15.4,0.1,8.1e-07,0.00026,150,264,152,270,137,277,0.74,114,118,140
OceanDNA-b21507,90,0.4,0.0,0.015,2.6,100,145,85,132,73,143,0.74,45,47,70
OceanDNA-b6844,273,15.1,0.0,5e-07,0.00049,142,183,125,166,109,190,0.74,41,41,81
OceanDNA-b9758,608,13.2,0.0,3.8e-06,0.0022,147,222,171,249,160,290,0.74,75,78,130
OceanDNA-b19147,46,6.4,0.0,0.00045,0.08,154,190,306,342,271,352,0.74,36,36,81
OceanDNA-b44444,1331,1.4,0.0,0.0075,17.0,173,243,254,329,240,334,0.74,70,75,94
OceanDNA-b16227,471,4.7,0.0,0.0022,0.76,194,224,473,504,451,529,0.74,30,31,78
OceanDNA-b23811,325,11.1,0.0,8.6e-06,0.013,162,186,100,124,93,149,0.74,24,24,56
OceanDNA-b22393,1546,16.1,0.0,5e-07,0.0004,134,185,6,53,3,67,0.74,51,47,64
OceanDNA-b35991,369,22.3,0.0,3.2e-09,1.4e-06,77,227,104,257,83,288,0.74,150,153,205
OceanDNA-b22409,1234,11.9,0.0,4.8e-06,0.02,150,186,602,638,534,650,0.74,36,36,116
OceanDNA-b33388,547,1.1,0.0,0.047,36.0,230,260,218,249,209,254,0.74,30,31,45
OceanDNA-b17582,63,21.7,0.0,5.2e-09,1.7e-05,153,219,167,235,148,276,0.74,66,68,128
OceanDNA-b24879,1546,1.1,0.1,0.019,17.0,24,72,27,75,6,79,0.74,48,48,73
OceanDNA-b484,1486,18.6,0.1,4.3e-08,8.7e-05,121,220,259,372,207,397,0.74,99,113,190
OceanDNA-b26769,766,-0.8,0.0,0.074,74.0,53,73,218,238,175,243,0.74,20,20,68
OceanDNA-b19767,37,13.4,0.0,1.6e-06,0.00051,149,207,131,193,94,199,0.74,58,62,105
OceanDNA-b42522,247,20.6,0.0,2.1e-08,3.3e-06,153,244,153,248,134,266,0.74,91,95,132
OceanDNA-b9314,190,14.5,0.0,7.6e-07,0.00025,151,206,139,197,118,218,0.74,55,58,100
OceanDNA-b30235,805,22.0,0.2,3.9e-09,1.1e-05,84,175,158,260,151,269,0.74,91,102,118
OceanDNA-b31695,307,2.2,0.0,0.0043,8.0,196,246,621,672,615,679,0.74,50,51,64
OceanDNA-b272,1587,10.6,0.0,1.2e-05,0.031,102,186,45,128,15,194,0.74,84,83,179
OceanDNA-b34951,634,-2.4,0.0,0.11,77.0,150,171,58,79,44,92,0.74,21,21,48
OceanDNA-b45813,470,-2.1,0.0,0.092,100.0,198,230,296,327,290,332,0.74,32,31,42
OceanDNA-b30043,702,16.3,0.1,4.5e-07,0.00044,129,179,76,127,67,142,0.74,50,51,75
OceanDNA-b41214,2347,6.2,0.0,0.00026,0.99,186,216,191,220,179,234,0.74,30,29,55
OceanDNA-b40593,473,7.1,0.0,0.00014,0.07,179,229,124,180,116,199,0.74,50,56,83
OceanDNA-b3867,683,9.7,0.0,2.3e-05,0.037,126,181,120,176,103,202,0.74,55,56,99
OceanDNA-b1696,215,13.0,0.1,2.3e-06,0.0017,150,184,136,170,84,181,0.74,34,34,97
OceanDNA-b23549,1740,8.7,0.0,0.00014,0.089,143,189,64,111,44,130,0.74,46,47,86
OceanDNA-b22386,1905,14.4,0.0,3.3e-06,0.0017,151,192,258,300,227,337,0.74,41,42,110
OceanDNA-b43700,166,4.8,0.0,0.00071,0.77,168,230,107,172,101,194,0.74,62,65,93
OceanDNA-b32958,1170,18.7,0.0,4e-08,9.8e-05,105,183,320,406,304,422,0.74,78,86,118
OceanDNA-b22650,1489,3.4,0.0,0.0038,4.5,201,244,125,168,108,181,0.74,43,43,73
OceanDNA-b2668,146,-2.4,0.0,0.23,45.0,201,222,120,141,113,151,0.73,21,21,38
OceanDNA-b28141,234,0.3,0.0,0.033,27.0,153,188,122,158,111,170,0.73,35,36,59
OceanDNA-b42439,30,12.0,0.0,8.9e-06,0.0012,95,217,42,177,23,225,0.73,122,135,202
OceanDNA-b22382,1397,11.0,0.0,2.7e-05,0.035,136,187,486,536,456,571,0.73,51,50,115
OceanDNA-b35371,154,17.2,0.0,1.2e-07,0.0001,101,197,50,149,20,162,0.73,96,99,142
OceanDNA-b30771,946,14.5,0.1,7.8e-07,0.0018,87,211,104,238,41,248,0.73,124,134,207
OceanDNA-b37532,1746,30.0,0.0,1.5e-11,3.9e-08,76,228,92,265,89,279,0.73,152,173,190
OceanDNA-b46852,1158,-0.9,0.0,0.11,45.0,153,214,393,459,371,465,0.73,61,66,94
OceanDNA-b23725,806,-0.8,0.0,0.1,76.0,187,263,248,320,239,329,0.73,76,72,90
OceanDNA-a3040,26,13.5,0.0,1.6e-06,0.0012,153,192,164,203,90,213,0.73,39,39,123
OceanDNA-b13256,1664,17.4,0.0,7.2e-07,0.0002,42,286,361,588,350,594,0.73,244,227,244
OceanDNA-b37535,76,31.2,0.1,1.3e-11,1.1e-08,75,243,118,304,35,315,0.73,168,186,280
OceanDNA-b2866,1726,11.2,0.0,2.4e-05,0.021,112,181,74,140,15,149,0.73,69,66,134
OceanDNA-b41044,685,52.5,1.1,4.1e-18,3.8e-15,16,265,11,268,3,288,0.73,249,257,285
OceanDNA-b46852,56,14.2,0.0,3e-06,0.0012,154,205,150,203,132,258,0.73,51,53,126
OceanDNA-b36140,2310,1.5,0.0,0.015,21.0,132,192,553,610,516,619,0.73,60,57,103
OceanDNA-b40263,195,28.3,0.2,4.9e-11,3.4e-08,74,182,89,208,20,275,0.73,108,119,255
OceanDNA-b19934,261,21.3,0.0,6.7e-09,2.4e-06,124,192,266,338,261,360,0.73,68,72,99
OceanDNA-b15138,937,15.1,0.3,5e-07,0.00054,61,134,8,86,1,152,0.73,73,78,151
OceanDNA-b27579,40,9.1,0.1,6.7e-05,0.098,195,245,239,286,207,299,0.73,50,47,92
OceanDNA-b45652,400,9.8,0.0,4.3e-05,0.013,155,243,146,248,130,257,0.73,88,102,127
OceanDNA-b18804,177,23.1,0.0,1.9e-09,6e-07,139,217,146,222,126,249,0.73,78,76,123
OceanDNA-b289,2632,30.0,0.0,3e-11,5.7e-08,153,252,211,314,191,327,0.73,99,103,136
OceanDNA-b11316,39,12.3,0.0,7.5e-06,0.0012,141,190,145,197,134,206,0.73,49,52,72
OceanDNA-b22260,1342,20.7,0.0,1e-08,1.9e-05,148,214,212,280,189,288,0.73,66,68,99
OceanDNA-b16514,942,15.6,0.1,3.6e-07,0.00037,89,176,207,307,177,317,0.73,87,100,140
OceanDNA-b45094,335,15.3,0.0,4.5e-07,0.00042,79,213,27,176,5,208,0.73,134,149,203
OceanDNA-b39756,387,20.5,0.0,3.6e-08,5e-06,153,185,142,174,117,242,0.73,32,32,125
OceanDNA-b22403,3109,11.3,0.0,7.5e-06,0.029,133,186,139,188,109,213,0.73,53,49,104
OceanDNA-b20562,61,3.8,0.0,0.0014,0.42,192,229,191,227,185,255,0.73,37,36,70
OceanDNA-b36771,228,15.1,0.0,5.1e-07,0.00056,151,193,231,273,199,294,0.73,42,42,95
OceanDNA-b3912,1700,11.2,0.0,2.4e-05,0.016,124,181,101,159,48,175,0.73,57,58,127
OceanDNA-b3301,835,5.1,0.0,0.0011,1.5,130,177,69,116,32,120,0.73,47,47,88
OceanDNA-b33331,208,-1.4,0.0,0.11,86.0,208,244,75,110,57,127,0.73,36,35,70
OceanDNA-b22460,863,12.3,0.0,7.5e-06,0.013,109,170,200,272,196,279,0.73,61,72,83
OceanDNA-b22487,2098,-3.8,0.0,0.29,710.0,102,115,217,230,215,239,0.73,13,13,24
OceanDNA-b16140,405,13.8,0.1,2.5e-06,0.0011,180,233,420,476,413,499,0.73,53,56,86
OceanDNA-b35371,154,2.4,0.1,0.0037,3.2,203,264,196,255,183,267,0.73,61,59,84
OceanDNA-b45554,234,8.2,0.0,6.6e-05,0.039,148,189,117,160,52,172,0.73,41,43,120
OceanDNA-b35035,536,-0.2,0.0,0.047,18.0,150,186,524,560,508,569,0.73,36,36,61
OceanDNA-b31056,401,4.9,0.0,0.0013,2.0,203,265,231,291,217,298,0.73,62,60,81
OceanDNA-b4054,583,12.8,0.0,2.5e-06,0.0015,109,195,23,116,6,131,0.73,86,93,125
OceanDNA-b9937,387,-0.9,0.0,0.039,17.0,196,217,209,230,202,257,0.73,21,21,55
OceanDNA-b13621,231,10.6,0.0,2.3e-05,0.0035,109,229,57,182,39,197,0.73,120,125,158
OceanDNA-b24712,366,4.4,0.2,0.00095,0.58,222,265,213,256,186,257,0.73,43,43,71
OceanDNA-b23176,7390,11.7,0.0,1.6e-05,0.041,32,136,42,150,10,165,0.73,104,108,155
OceanDNA-b21040,2808,11.4,0.0,2.1e-05,0.032,152,182,139,169,102,177,0.73,30,30,75
OceanDNA-b14149,56,12.3,0.0,3.6e-06,0.0017,152,217,126,194,114,199,0.73,65,68,85
OceanDNA-b22654,1156,15.8,0.0,1.6e-06,0.00039,153,242,527,620,498,636,0.73,89,93,138
OceanDNA-b10294,774,9.8,0.0,4.1e-05,0.017,100,185,54,138,32,159,0.73,85,84,127
OceanDNA-b36076,862,3.7,0.1,0.003,3.8,136,176,184,225,163,282,0.73,40,41,119
OceanDNA-b1333,679,14.7,0.1,2.1e-06,0.0011,105,187,51,144,10,160,0.73,82,93,150
OceanDNA-b44390,515,18.8,0.1,1.1e-07,2.6e-05,152,245,131,226,96,247,0.73,93,95,151
OceanDNA-b24712,366,10.2,0.1,1.6e-05,0.0097,161,197,108,148,97,172,0.73,36,40,75
OceanDNA-b6424,365,11.6,0.0,1.8e-05,0.0038,99,185,47,132,21,153,0.73,86,85,132
OceanDNA-b36405,186,-2.2,0.0,0.096,42.0,109,126,75,92,56,102,0.73,17,17,46
OceanDNA-b23020,260,-4.1,0.1,0.37,1300.0,88,112,677,700,676,705,0.73,24,23,29
OceanDNA-b27545,1368,10.1,0.0,1.7e-05,0.037,161,198,108,149,35,160,0.73,37,41,125
OceanDNA-b1749,43,5.7,0.0,0.00037,0.68,138,169,75,105,33,122,0.73,31,30,89
OceanDNA-b28155,1056,7.5,0.0,0.0001,0.16,195,253,198,252,184,263,0.73,58,54,79
OceanDNA-b35132,707,-1.5,0.0,0.057,59.0,107,127,149,169,139,185,0.73,20,20,46
OceanDNA-b31421,2275,13.2,0.1,2e-06,0.007,100,176,106,178,97,194,0.73,76,72,97
OceanDNA-b45289,1404,8.8,0.0,0.00013,0.11,150,179,223,252,161,271,0.73,29,29,110
OceanDNA-b22407,1618,-1.8,0.0,0.071,210.0,143,176,19,52,9,62,0.73,33,33,53
OceanDNA-b3696,1147,-1.3,0.0,0.049,120.0,154,176,194,216,181,229,0.73,22,22,48
OceanDNA-b27544,463,15.1,0.1,5.1e-07,0.0008,108,198,47,140,22,180,0.73,90,93,158
OceanDNA-b41418,435,9.5,0.0,2.6e-05,0.022,150,186,106,142,27,167,0.73,36,36,140
OceanDNA-b10080,453,11.5,0.0,1.3e-05,0.0064,103,211,164,281,128,319,0.73,108,117,191
OceanDNA-b46942,588,10.6,0.0,1.2e-05,0.0089,149,186,195,234,186,286,0.73,37,39,100
OceanDNA-b45194,1708,7.6,0.0,9.9e-05,0.23,195,228,193,225,163,232,0.73,33,32,69
OceanDNA-b7996,86,13.4,0.0,1.7e-06,0.00048,148,191,142,186,116,223,0.73,43,44,107
OceanDNA-b22322,1513,-1.0,0.1,0.12,160.0,7,53,30,77,25,80,0.73,46,47,55
OceanDNA-b3645,564,16.6,0.0,1.8e-07,0.00016,186,230,279,321,273,356,0.73,44,42,83
OceanDNA-b23019,3479,0.8,0.0,0.023,43.0,153,193,169,214,139,229,0.73,40,45,90
OceanDNA-b22292,899,42.9,3.7,1.8e-15,3.4e-12,74,231,77,243,38,259,0.73,157,166,221
OceanDNA-b21043,56,-3.5,0.1,0.73,430.0,197,217,179,199,174,204,0.73,20,20,30
OceanDNA-b3704,1601,0.6,0.1,0.014,37.0,77,130,40,97,8,114,0.73,53,57,106
OceanDNA-b23019,128,15.7,0.1,6.9e-07,0.0013,68,175,693,806,678,813,0.73,107,113,135
OceanDNA-b20909,5248,13.4,0.0,3.3e-06,0.012,113,194,232,316,227,323,0.73,81,84,96
OceanDNA-b6184,38,16.7,0.0,1.7e-07,0.00012,74,192,54,179,37,186,0.73,118,125,149
OceanDNA-b15190,1628,9.5,0.0,2.7e-05,0.06,93,185,35,124,25,130,0.73,92,89,105
OceanDNA-b9010,182,10.2,0.0,1.6e-05,0.0039,109,189,59,145,54,159,0.73,80,86,105
OceanDNA-b28826,1069,9.1,0.0,3.5e-05,0.041,154,189,89,124,72,147,0.73,35,35,75
OceanDNA-b34938,785,-3.4,0.0,0.45,280.0,154,185,550,581,497,589,0.73,31,31,92
OceanDNA-b19575,372,17.7,0.1,8.3e-08,3.1e-05,53,186,23,148,16,154,0.73,133,125,138
OceanDNA-b25939,345,9.7,0.0,2.3e-05,0.0095,137,179,217,253,182,279,0.73,42,36,97
OceanDNA-b28261,86,9.1,0.0,3.3e-05,0.0096,194,227,166,194,155,230,0.73,33,28,75
OceanDNA-b12351,370,-3.8,0.1,0.3,130.0,77,85,49,57,47,67,0.73,8,8,20
OceanDNA-b30427,1176,11.8,0.1,1.1e-05,0.011,176,231,235,292,220,308,0.73,55,57,88
OceanDNA-b16139,377,4.0,0.0,0.0024,0.97,66,116,235,291,186,296,0.73,50,56,110
OceanDNA-b3654,348,26.6,0.1,1.6e-10,2.1e-07,85,174,144,245,136,255,0.73,89,101,119
OceanDNA-b45818,242,11.6,0.0,2.9e-05,0.0087,59,170,67,186,54,198,0.73,111,119,144
OceanDNA-b28587,550,6.3,0.0,0.00024,0.2,135,187,100,154,78,161,0.73,52,54,83
OceanDNA-b24965,1753,8.7,0.0,9.4e-05,0.091,75,186,53,173,13,181,0.73,111,120,168
OceanDNA-b36896,572,13.4,0.1,1.7e-06,0.0021,81,183,83,185,61,200,0.73,102,102,139
OceanDNA-b30640,386,12.6,0.1,9.2e-06,0.0038,142,182,81,119,31,129,0.73,40,38,98
OceanDNA-b506,1249,9.1,0.0,0.0001,0.066,169,246,333,409,327,425,0.73,77,76,98
OceanDNA-b24128,1437,15.4,0.1,4.2e-07,0.00092,156,185,87,116,52,123,0.73,29,29,71
OceanDNA-b20976,1531,6.5,0.0,0.00042,1.3,139,168,172,204,129,218,0.73,29,32,89
OceanDNA-b18519,68,13.2,0.0,2e-06,0.00061,148,215,85,160,64,201,0.73,67,75,137
OceanDNA-b1825,1867,5.2,0.0,0.001,1.9,197,269,576,651,566,654,0.73,72,75,88
OceanDNA-b24965,1095,16.8,0.0,3.2e-07,0.00031,75,190,27,146,6,172,0.73,115,119,166
OceanDNA-b30427,1668,-2.8,0.0,0.28,300.0,109,137,135,164,117,174,0.73,28,29,57
OceanDNA-b43907,104,-0.6,0.0,0.062,11.0,195,245,236,292,228,318,0.73,50,56,90
OceanDNA-b17084,129,11.7,0.0,1.1e-05,0.0062,148,222,171,245,148,251,0.73,74,74,103
OceanDNA-b6745,55,13.4,0.0,1.7e-06,0.00094,95,204,112,231,79,246,0.73,109,119,167
OceanDNA-b38208,1052,14.4,0.0,8.5e-07,0.0023,78,189,57,170,33,184,0.73,111,113,151
OceanDNA-b45233,797,24.9,0.0,1e-09,7.6e-07,96,174,109,185,83,245,0.73,78,76,162
OceanDNA-b16125,732,23.1,0.0,1.8e-09,1.4e-06,78,176,229,344,221,354,0.73,98,115,133
OceanDNA-b20908,8483,31.5,0.0,5.2e-12,5.2e-08,86,245,48,232,40,245,0.73,159,184,205
OceanDNA-b156,162,9.4,0.0,2.8e-05,0.076,189,243,251,308,232,321,0.73,54,57,89
OceanDNA-b30927,693,5.9,0.0,0.00067,0.7,191,244,223,274,193,289,0.73,53,51,96
OceanDNA-b47071,688,26.6,0.0,3.2e-10,1.2e-07,153,250,89,195,76,206,0.73,97,106,130
OceanDNA-b26646,1305,11.3,0.0,2.3e-05,0.027,196,219,208,231,183,262,0.73,23,23,79
OceanDNA-b41456,66,30.8,0.0,8.7e-12,8.8e-09,92,230,110,267,105,283,0.73,138,157,178
OceanDNA-b22423,1643,15.4,0.0,8.5e-07,0.001,137,185,190,235,155,252,0.73,48,45,97
OceanDNA-b31692,265,7.8,0.9,8.5e-05,0.095,86,182,48,145,19,167,0.73,96,97,148
OceanDNA-b5215,68,1.9,0.0,0.0055,1.6,193,216,200,223,194,275,0.73,23,23,81
OceanDNA-b33388,547,12.4,0.0,1.7e-05,0.013,138,195,86,145,36,173,0.73,57,59,137
OceanDNA-b32822,367,-1.1,0.0,0.085,27.0,166,215,170,221,161,227,0.73,49,51,66
OceanDNA-b13759,281,21.7,0.0,5e-09,1.7e-06,102,212,42,161,18,189,0.73,110,119,171
OceanDNA-b16220,1203,6.5,0.0,0.00042,0.26,193,244,463,517,437,576,0.73,51,54,139
OceanDNA-b3934,230,6.6,0.0,0.00041,0.14,160,187,105,132,37,149,0.73,27,27,112
OceanDNA-a2896,263,11.8,0.0,5.1e-06,0.0071,152,176,189,213,135,229,0.73,24,24,94
OceanDNA-b6298,94,18.1,0.0,1.3e-07,2.7e-05,78,212,94,239,81,257,0.73,134,145,176
OceanDNA-b13561,428,-1.7,0.0,0.13,53.0,156,180,103,127,89,145,0.73,24,24,56
OceanDNA-b20657,149,3.6,0.0,0.0032,0.49,192,244,179,229,171,248,0.73,52,50,77
OceanDNA-b29509,1618,10.4,0.0,2.7e-05,0.062,153,182,93,122,16,145,0.73,29,29,129
OceanDNA-b36152,858,16.4,1.0,2e-07,0.00048,75,185,123,252,112,262,0.73,110,129,150
OceanDNA-b31334,15,11.0,0.0,9.2e-06,0.0015,146,196,111,164,95,169,0.73,50,53,74
OceanDNA-b38049,473,3.3,0.0,0.002,1.6,109,188,494,579,488,588,0.73,79,85,100
OceanDNA-b30151,698,14.0,0.0,1.1e-06,0.0034,157,229,80,153,63,164,0.73,72,73,101
OceanDNA-b20782,503,2.1,0.1,0.0093,4.5,199,263,218,281,206,283,0.73,64,63,77
OceanDNA-b34729,429,17.4,0.1,1.1e-07,9.2e-05,189,249,227,290,204,308,0.73,60,63,104
OceanDNA-b3975,486,10.3,0.0,6e-05,0.013,97,179,573,661,551,682,0.73,82,88,131
OceanDNA-b24040,1710,-1.8,0.0,0.072,130.0,250,275,171,196,159,211,0.73,25,25,52
OceanDNA-b17633,332,-2.4,0.0,0.11,83.0,157,182,107,132,94,136,0.73,25,25,42
OceanDNA-b16213,512,19.6,0.0,2.3e-08,1.9e-05,83,189,272,401,229,409,0.73,106,129,180
OceanDNA-b6168,140,9.7,0.0,2.2e-05,0.013,129,194,75,142,35,157,0.73,65,67,122
OceanDNA-b30719,763,12.0,0.5,4.6e-06,0.0057,84,214,59,196,27,203,0.73,130,137,176
OceanDNA-b20957,2309,9.9,0.1,3.8e-05,0.076,100,185,10,94,3,117,0.73,85,84,114
OceanDNA-b27445,13,-0.4,0.0,0.027,5.9,197,248,299,347,292,363,0.73,51,48,71
OceanDNA-b17165,105,10.9,0.0,9.8e-06,0.0036,109,186,64,149,36,170,0.73,77,85,134
OceanDNA-b24086,214,-3.7,0.0,0.55,160.0,197,223,317,342,303,349,0.73,26,25,46
OceanDNA-b36670,896,1.7,0.0,0.0063,8.7,197,227,240,270,234,293,0.73,30,30,59
OceanDNA-b20992,1880,12.5,0.0,3.3e-06,0.0065,144,175,171,202,90,210,0.73,31,31,120
OceanDNA-b22517,1461,19.7,0.0,4.1e-08,6.8e-05,128,214,170,255,160,286,0.73,86,85,126
OceanDNA-b9190,106,3.4,0.0,0.0019,0.74,175,243,277,350,269,363,0.73,68,73,94
OceanDNA-b9322,239,17.8,0.0,7.9e-08,2.1e-05,151,207,95,154,76,175,0.73,56,59,99
OceanDNA-b26298,393,9.0,0.1,3.8e-05,0.024,141,195,146,199,113,211,0.73,54,53,98
OceanDNA-b40245,290,25.3,0.5,1.2e-09,3e-07,76,215,97,254,92,279,0.73,139,157,187
OceanDNA-b10475,234,-3.0,0.0,0.16,79.0,157,175,159,177,147,188,0.73,18,18,41
OceanDNA-b26756,121,-3.0,0.0,0.17,230.0,94,122,54,85,49,87,0.73,28,31,38
OceanDNA-b23063,1570,26.5,0.5,1.7e-10,2.8e-07,81,186,67,177,35,191,0.73,105,110,156
OceanDNA-b16095,80,2.8,0.0,0.003,2.7,194,272,223,295,214,299,0.73,78,72,85
OceanDNA-b1142,658,11.0,0.0,9.1e-06,0.0092,148,213,88,163,74,185,0.73,65,75,111
OceanDNA-b35318,70,5.7,0.0,0.00038,0.38,200,261,197,257,192,261,0.73,61,60,69
OceanDNA-b20097,224,46.4,0.0,4.5e-16,4.5e-14,55,282,60,316,56,324,0.73,227,256,268
OceanDNA-b46939,472,-3.2,0.0,0.2,260.0,155,168,38,51,33,73,0.73,13,13,40
OceanDNA-b235,598,15.0,0.0,5.6e-07,0.00043,75,190,96,221,83,248,0.73,115,125,165
OceanDNA-b3712,2033,13.0,0.0,4.5e-06,0.0047,104,199,21,122,13,130,0.73,95,101,117
OceanDNA-b9791,496,12.0,0.0,4.6e-06,0.0035,68,210,81,233,52,242,0.73,142,152,190
OceanDNA-b23559,253,18.7,0.0,4.2e-08,6.8e-05,133,182,127,173,52,183,0.73,49,46,131
OceanDNA-b23093,1592,34.2,0.2,2.3e-12,4.6e-09,89,243,83,249,24,284,0.73,154,166,260
OceanDNA-b24136,3202,12.1,0.0,8.6e-06,0.016,75,190,95,217,78,229,0.73,115,122,151
OceanDNA-b46199,236,23.5,0.0,2.9e-09,2.1e-06,135,184,150,194,133,202,0.73,49,44,69
OceanDNA-b16147,120,6.3,0.0,0.00072,0.17,186,246,422,482,406,491,0.73,60,60,85
OceanDNA-b35378,46,11.0,0.1,9.3e-06,0.015,101,194,50,142,20,151,0.73,93,92,131
OceanDNA-b16229,171,24.0,0.0,3e-09,1.3e-06,88,191,55,169,30,212,0.73,103,114,182
OceanDNA-b22849,1144,14.2,0.0,2.9e-06,0.0019,124,186,186,251,163,278,0.73,62,65,115
OceanDNA-b28158,2580,10.5,0.5,1.3e-05,0.034,66,168,77,174,46,194,0.73,102,97,148
OceanDNA-b35180,16,11.1,0.0,8.3e-06,0.0059,140,180,127,168,115,194,0.73,40,41,79
OceanDNA-b36740,366,10.5,0.0,1.3e-05,0.0071,147,186,124,164,111,187,0.73,39,40,76
OceanDNA-b21437,139,6.1,0.0,0.00028,0.062,91,186,9,102,5,123,0.73,95,93,118
OceanDNA-b1232,562,17.8,0.1,7.7e-08,0.00015,88,168,185,274,173,280,0.73,80,89,107
OceanDNA-b44039,156,2.8,0.0,0.0058,0.88,195,245,229,285,220,295,0.73,50,56,75
OceanDNA-b16229,53,1.1,0.0,0.028,13.0,179,272,422,518,416,534,0.73,93,96,118
OceanDNA-b40467,631,12.1,0.1,8.3e-06,0.0065,126,187,146,211,123,223,0.73,61,65,100
OceanDNA-b38636,415,14.6,0.0,7.2e-07,0.00037,97,172,115,188,94,207,0.73,75,73,113
OceanDNA-b6575,684,20.0,0.0,1.7e-08,1.7e-05,69,192,19,150,8,157,0.73,123,131,149
OceanDNA-b30849,481,5.3,0.1,0.00051,0.5,199,265,194,258,182,266,0.73,66,64,84
OceanDNA-b38325,1042,12.3,0.0,3.6e-06,0.0059,97,190,74,172,40,182,0.73,93,98,142
OceanDNA-b38499,23,-0.6,0.0,0.031,31.0,249,282,388,423,360,432,0.73,33,35,72
OceanDNA-b38942,1826,35.6,0.8,2.8e-13,5.5e-10,96,252,94,245,11,269,0.73,156,151,258
OceanDNA-b2647,1155,11.8,0.1,1e-05,0.015,77,179,14,120,3,132,0.73,102,106,129
OceanDNA-b45854,2076,5.8,0.0,0.001,0.73,200,262,141,203,136,215,0.73,62,62,79
OceanDNA-b35863,368,11.0,0.0,9e-06,0.02,143,190,155,203,129,232,0.73,47,48,103
OceanDNA-b10020,85,5.8,0.0,0.001,0.17,102,185,59,141,36,159,0.72,83,82,123
OceanDNA-b33100,1988,-2.9,0.0,0.16,370.0,189,216,261,288,255,296,0.72,27,27,41
OceanDNA-b23417,1309,-0.1,0.0,0.065,63.0,195,243,666,714,656,736,0.72,48,48,80
OceanDNA-b40467,458,-2.3,0.1,0.2,160.0,93,125,280,312,269,319,0.72,32,32,50
OceanDNA-b22378,991,7.8,0.0,0.00017,0.18,105,175,103,171,70,199,0.72,70,68,129
OceanDNA-b3658,1305,19.5,0.1,4.6e-08,3.1e-05,62,192,53,193,33,201,0.72,130,140,168
OceanDNA-b7203,304,15.5,0.0,3.8e-07,0.00027,154,212,184,243,61,253,0.72,58,59,192
OceanDNA-b10073,275,6.5,0.0,0.00021,0.13,101,185,70,153,46,170,0.72,84,83,124
OceanDNA-b45789,235,12.1,0.0,8.5e-06,0.0023,154,243,151,254,128,269,0.72,89,103,141
OceanDNA-b46982,639,26.1,0.0,6.9e-10,1.5e-07,153,193,164,205,150,239,0.72,40,41,89
OceanDNA-b46763,1616,16.4,0.0,4.1e-07,0.00051,154,211,145,204,132,246,0.72,57,59,114
OceanDNA-b20963,6458,10.6,0.0,2.4e-05,0.079,156,217,71,141,49,153,0.72,61,70,104
OceanDNA-b9793,474,-3.4,0.0,0.22,120.0,158,180,127,149,111,160,0.72,22,22,49
OceanDNA-b6759,585,11.4,0.0,1.3e-05,0.0049,147,185,144,182,135,221,0.72,38,38,86
OceanDNA-b36732,2751,3.1,0.0,0.0024,8.1,181,260,284,369,275,373,0.72,79,85,98
OceanDNA-b30874,1412,7.4,0.0,0.00022,0.26,181,245,214,280,197,293,0.72,64,66,96
OceanDNA-b45789,15,4.5,0.0,0.0017,0.48,190,263,172,243,162,245,0.72,73,71,83
OceanDNA-b13249,460,15.4,2.4,1.3e-06,0.00039,71,269,130,323,125,347,0.72,198,193,222
OceanDNA-b23489,873,-0.2,0.0,0.024,52.0,187,246,267,322,251,342,0.72,59,55,91
OceanDNA-b4143,217,16.3,0.0,6.7e-07,0.00036,153,218,135,202,123,234,0.72,65,67,111
OceanDNA-b17625,3689,0.3,0.0,0.017,66.0,47,89,215,260,208,294,0.72,42,45,86
OceanDNA-b27535,1573,9.3,0.6,2.9e-05,0.069,161,223,143,204,87,214,0.72,62,61,127
OceanDNA-b36140,2310,-0.0,0.0,0.042,59.0,58,116,384,449,374,461,0.72,58,65,87
OceanDNA-b15507,1408,15.2,0.1,4.7e-07,0.0009,79,198,43,171,25,179,0.72,119,128,154
OceanDNA-b26685,1657,10.5,0.0,1.2e-05,0.031,97,175,79,155,53,163,0.72,78,76,110
OceanDNA-b20098,140,44.9,0.0,8.3e-16,1e-13,55,280,95,349,91,359,0.72,225,254,268
OceanDNA-b20925,7938,-1.1,0.0,0.043,360.0,161,179,138,156,126,166,0.72,18,18,40
OceanDNA-b22654,1156,-2.1,0.0,0.45,110.0,20,53,251,286,232,299,0.72,33,35,67
OceanDNA-b23551,407,-0.5,0.0,0.058,44.0,186,246,262,318,254,339,0.72,60,56,85
OceanDNA-b34551,738,26.9,0.2,3.9e-10,1.2e-07,84,173,115,217,100,221,0.72,89,102,121
OceanDNA-b24045,2236,0.9,0.0,0.032,28.0,145,193,131,177,126,208,0.72,48,46,82
OceanDNA-b27536,721,25.9,0.1,2.6e-10,4.4e-07,89,173,142,233,135,247,0.72,84,91,112
OceanDNA-b46553,591,18.9,0.1,7.2e-08,5.3e-05,154,191,144,182,114,244,0.72,37,38,130
OceanDNA-b26879,966,21.8,0.0,4.8e-09,1.7e-05,108,176,86,168,67,175,0.72,68,82,108
OceanDNA-b17083,134,3.1,0.0,0.0023,2.3,198,220,238,259,231,292,0.72,22,21,61
OceanDNA-b37665,1090,8.8,0.1,8.7e-05,0.068,202,273,205,274,189,292,0.72,71,69,103
OceanDNA-b28262,307,11.4,0.0,6.9e-06,0.0035,195,263,198,264,187,267,0.72,68,66,80
OceanDNA-b16143,250,20.0,0.0,3.2e-08,1.4e-05,88,176,239,346,205,354,0.72,88,107,149
OceanDNA-b6505,278,9.6,0.0,2.5e-05,0.02,104,187,48,130,22,146,0.72,83,82,124
OceanDNA-b20946,2606,15.3,0.1,4.4e-07,0.0018,123,176,120,171,113,172,0.72,53,51,59
OceanDNA-b34544,56,4.8,0.0,0.0014,0.51,164,254,217,308,186,314,0.72,90,91,128
OceanDNA-b21013,3975,14.6,0.0,7.1e-07,0.0029,106,215,119,238,108,270,0.72,109,119,162
OceanDNA-b20820,150,0.5,0.0,0.028,7.9,96,121,149,174,135,193,0.72,25,25,58
OceanDNA-b17424,1206,-0.5,0.0,0.057,51.0,178,217,317,359,311,375,0.72,39,42,64
OceanDNA-b4498,1017,5.3,0.0,0.0015,0.5,178,247,293,368,262,374,0.72,69,75,112
OceanDNA-b25128,263,-3.2,0.0,0.38,160.0,11,44,183,216,177,218,0.72,33,33,41
OceanDNA-b34735,132,11.2,0.0,1.6e-05,0.0053,109,198,573,670,568,686,0.72,89,97,118
OceanDNA-b9808,396,15.9,0.0,5.9e-07,0.00017,147,215,145,217,130,225,0.72,68,72,95
OceanDNA-b36303,17,10.0,0.0,1.8e-05,0.012,110,177,90,154,78,184,0.72,67,64,106
OceanDNA-b34610,1103,12.1,0.1,4.2e-06,0.0056,75,171,407,512,386,533,0.72,96,105,147
OceanDNA-b5446,232,14.3,0.0,9.2e-07,0.0004,105,188,217,302,140,316,0.72,83,85,176
OceanDNA-b41301,4143,19.9,0.1,5.5e-08,8.8e-05,73,188,32,165,5,198,0.72,115,133,193
OceanDNA-b45835,44,11.2,0.1,1.6e-05,0.0077,62,172,58,176,50,195,0.72,110,118,145
OceanDNA-b22333,591,16.9,0.1,1.5e-07,0.00043,122,217,148,242,142,283,0.72,95,94,141
OceanDNA-b34384,115,5.1,0.0,0.0017,0.47,165,246,218,300,185,312,0.72,81,82,127
OceanDNA-b31521,1422,7.3,0.1,0.00024,0.25,198,261,191,253,179,257,0.72,63,62,78
OceanDNA-b31521,1422,15.6,0.2,7.2e-07,0.00075,102,187,51,135,9,191,0.72,85,84,182
OceanDNA-b38873,431,10.6,0.0,1.2e-05,0.009,147,182,84,119,62,162,0.72,35,35,100
OceanDNA-b47053,235,-2.7,0.0,0.14,89.0,156,168,30,42,4,51,0.72,12,12,47
OceanDNA-b13590,1844,19.7,0.0,8.2e-08,6e-05,158,218,158,224,86,255,0.72,60,66,169
OceanDNA-b30627,591,-1.0,0.0,0.041,38.0,250,285,389,426,376,432,0.72,35,37,56
OceanDNA-b24965,1095,-2.6,0.0,0.25,250.0,182,214,218,250,211,263,0.72,32,32,52
OceanDNA-b24117,2173,9.3,0.0,6.1e-05,0.081,182,228,186,228,169,261,0.72,46,42,92
OceanDNA-b6575,684,-3.9,0.0,0.32,320.0,220,242,261,284,257,287,0.72,22,23,30
OceanDNA-b46204,227,16.9,0.0,1.5e-07,0.00016,153,216,137,207,121,219,0.72,63,70,98
OceanDNA-b30021,940,-0.9,0.0,0.039,71.0,124,164,42,81,30,118,0.72,40,39,88
OceanDNA-b14001,78,14.5,0.0,7.8e-07,0.00018,128,214,63,159,55,173,0.72,86,96,118
OceanDNA-b41127,1967,64.5,2.9,4.7e-22,1e-18,12,270,33,297,22,314,0.72,258,264,292
OceanDNA-b28083,1033,11.9,0.1,9.5e-06,0.0082,106,198,56,151,34,171,0.72,92,95,137
OceanDNA-b9009,59,7.9,0.0,0.00016,0.018,109,189,485,571,481,586,0.72,80,86,105
OceanDNA-b33394,954,11.5,0.1,1.2e-05,0.016,61,99,239,278,213,294,0.72,38,39,81
OceanDNA-a1367,84,10.9,0.0,9.7e-06,0.0036,194,237,161,205,156,229,0.72,43,44,73
OceanDNA-b20907,2112,26.1,1.4,2.2e-10,1.2e-06,109,245,198,343,179,352,0.72,136,145,173
OceanDNA-b20094,148,22.5,0.0,8.8e-09,1.1e-06,147,225,127,208,114,244,0.72,78,81,130
OceanDNA-b36456,1321,6.3,0.0,0.00025,0.54,60,179,50,174,17,186,0.72,119,124,169
OceanDNA-b33090,1196,0.1,0.0,0.018,44.0,201,250,213,258,189,268,0.72,49,45,79
OceanDNA-b22423,1643,-3.4,0.0,0.44,520.0,33,51,357,375,350,386,0.72,18,18,36
OceanDNA-a4805,308,10.5,0.0,1.3e-05,0.0057,113,176,88,156,69,256,0.72,63,68,187
OceanDNA-b265,82,30.3,0.0,2.3e-11,2.1e-08,153,243,172,264,150,285,0.72,90,92,135
OceanDNA-b2829,1964,9.6,0.2,7.1e-05,0.074,79,179,19,118,12,129,0.72,100,99,117
OceanDNA-b39139,2159,10.6,0.0,1.2e-05,0.029,157,180,217,240,196,254,0.72,23,23,58
OceanDNA-b43986,170,4.5,0.0,0.00088,0.22,194,245,232,289,224,300,0.72,51,57,76
OceanDNA-b7208,478,9.5,0.0,2.6e-05,0.018,195,248,212,260,197,276,0.72,53,48,79
OceanDNA-b36587,1116,7.0,0.0,0.00015,0.27,55,178,47,175,38,188,0.72,123,128,150
OceanDNA-b40641,971,7.6,0.2,0.00041,0.13,151,175,130,154,81,171,0.72,24,24,90
OceanDNA-b40641,883,1.4,0.0,0.03,9.9,202,265,208,269,198,274,0.72,63,61,76
OceanDNA-b13256,77,-2.7,0.0,0.96,270.0,108,128,82,103,61,106,0.72,20,21,45
OceanDNA-b28111,1558,16.7,0.0,1.7e-07,0.00035,147,199,115,170,51,192,0.72,52,55,141
OceanDNA-b4587,117,-1.2,0.1,0.049,34.0,162,183,111,132,105,153,0.72,21,21,48
OceanDNA-b41267,1339,13.1,0.0,2.1e-06,0.0063,130,206,128,203,96,228,0.72,76,75,132
OceanDNA-b45289,873,11.3,0.0,2.3e-05,0.019,89,197,170,282,146,289,0.72,108,112,143
OceanDNA-b34725,328,17.2,0.1,2.4e-07,8.4e-05,155,264,142,253,126,256,0.72,109,111,130
OceanDNA-b43541,53,18.7,0.0,4.1e-08,4.4e-05,100,215,55,184,13,224,0.72,115,129,211
OceanDNA-b34630,236,17.5,0.0,1.9e-07,9e-05,109,202,103,193,80,203,0.72,93,90,123
OceanDNA-b6781,378,-2.2,0.0,0.098,50.0,150,172,135,159,129,174,0.72,22,24,45
OceanDNA-b18031,140,24.1,0.0,9.1e-10,1.4e-07,151,215,135,203,117,214,0.72,64,68,97
OceanDNA-b1776,514,11.6,0.1,1.2e-05,0.022,129,182,235,288,197,294,0.72,53,53,97
OceanDNA-b1435,542,23.3,0.2,4.8e-09,1.3e-06,133,182,110,158,74,167,0.72,49,48,93
OceanDNA-b20951,936,11.7,0.0,1.1e-05,0.014,104,176,121,207,105,226,0.72,72,86,121
OceanDNA-b19307,78,18.2,0.0,5.8e-08,1.6e-05,152,200,357,409,330,450,0.72,48,52,120
OceanDNA-b46839,919,14.3,0.0,1.8e-06,0.0011,153,198,203,249,183,300,0.72,45,46,117
OceanDNA-b22386,1896,12.8,0.0,1e-05,0.0054,155,194,48,88,35,133,0.72,39,40,98
OceanDNA-b45818,6,27.1,0.0,5.6e-10,1.7e-07,144,211,169,239,150,276,0.72,67,70,126
OceanDNA-b16215,845,11.0,0.0,1.9e-05,0.011,106,173,112,186,73,191,0.72,67,74,118
OceanDNA-b32958,1170,-1.8,0.0,0.07,170.0,189,216,462,489,441,506,0.72,27,27,65
OceanDNA-b39,3911,7.6,0.1,0.0002,0.7,103,185,119,200,101,219,0.72,82,81,118
OceanDNA-b20977,2184,14.6,0.0,2.1e-06,0.0026,149,189,206,246,146,253,0.72,40,40,107
OceanDNA-b20895,1799,25.0,0.1,5.1e-10,2e-06,107,211,163,281,153,349,0.72,104,118,196
OceanDNA-b22999,1727,15.3,0.0,4.6e-07,0.00089,153,196,136,182,122,203,0.72,43,46,81
OceanDNA-b36767,303,15.3,0.0,4.5e-07,0.0004,150,193,230,273,193,294,0.72,43,43,101
OceanDNA-b3144,908,13.3,0.0,3.7e-06,0.0024,105,190,97,192,80,217,0.72,85,95,137
OceanDNA-b488,1357,4.7,0.0,0.0016,2.0,149,185,263,298,208,327,0.72,36,35,119
OceanDNA-b4503,685,14.4,0.0,8.5e-07,0.00059,147,211,133,199,88,223,0.72,64,66,135
OceanDNA-b22828,2407,20.6,0.0,1.1e-08,4.6e-05,130,246,133,248,122,272,0.72,116,115,150
OceanDNA-b26380,46,20.9,0.1,9e-09,7e-06,89,190,46,152,40,167,0.72,101,106,127
OceanDNA-b22849,589,12.0,0.0,1.4e-05,0.0092,108,171,171,245,163,259,0.72,63,74,96
OceanDNA-b9784,941,13.6,0.0,4.3e-06,0.0017,148,188,122,163,111,241,0.72,40,41,130
OceanDNA-b32606,3261,2.8,0.0,0.0029,13.0,191,243,264,318,243,325,0.72,52,54,82
OceanDNA-b32153,1760,-0.7,0.2,0.032,80.0,158,171,157,170,139,179,0.72,13,13,40
OceanDNA-b40967,187,43.1,0.3,1.6e-15,4.9e-12,100,268,92,260,3,283,0.72,168,168,280
OceanDNA-b15853,1523,20.1,0.1,4.5e-08,2.8e-05,100,211,114,238,14,273,0.72,111,124,259
OceanDNA-b26613,119,-1.3,0.0,0.051,29.0,180,217,188,223,173,250,0.72,37,35,77
OceanDNA-b24219,68,16.6,0.0,1.8e-07,0.00021,79,174,58,167,54,198,0.72,95,109,144
OceanDNA-b10027,423,7.3,0.0,0.00012,0.067,101,185,50,133,27,152,0.72,84,83,125
OceanDNA-b29496,1411,19.0,0.0,6.8e-08,8.9e-05,154,189,139,175,124,246,0.72,35,36,122
OceanDNA-b13088,539,3.4,0.0,0.0019,6.9,146,191,521,566,475,584,0.72,45,45,109
OceanDNA-b30953,299,12.2,0.0,4e-06,0.011,141,178,127,166,117,191,0.72,37,39,74
OceanDNA-b6750,637,15.6,0.0,1.1e-06,0.00027,148,223,138,216,123,254,0.72,75,78,131
OceanDNA-b20036,199,8.5,0.0,0.00016,0.02,221,280,275,333,245,350,0.72,59,58,105
OceanDNA-b23949,1238,10.4,0.2,1.4e-05,0.026,77,172,94,208,36,234,0.72,95,114,198
OceanDNA-b36722,553,2.3,0.0,0.008,3.9,221,244,243,267,214,287,0.72,23,24,73
OceanDNA-b20891,298,47.5,0.0,7e-17,5.3e-14,153,243,161,253,93,266,0.72,90,92,173
OceanDNA-b332,28,21.7,0.6,5.1e-09,4e-06,79,189,30,137,4,143,0.72,110,107,139
OceanDNA-b40634,443,-0.4,0.0,0.055,22.0,195,227,203,236,198,252,0.72,32,33,54
OceanDNA-b17739,3688,11.4,0.0,6.9e-06,0.029,91,186,130,229,110,283,0.72,95,99,173
OceanDNA-b22610,773,7.1,0.0,0.00014,0.14,143,189,115,162,60,173,0.72,46,47,113
OceanDNA-b41451,1294,-2.2,0.0,0.19,140.0,16,68,14,65,6,68,0.72,52,51,62
OceanDNA-b44154,508,1.5,0.1,0.0071,3.7,229,265,218,255,183,272,0.72,36,37,89
OceanDNA-b45584,658,-1.4,0.0,0.11,75.0,54,102,16,63,13,71,0.72,48,47,58
OceanDNA-b16182,508,12.2,0.0,4e-06,0.0026,29,120,100,192,81,196,0.72,91,92,115
OceanDNA-b37447,293,7.5,0.1,0.00021,0.075,148,200,127,179,116,242,0.72,52,52,126
OceanDNA-b34944,344,12.1,0.0,4.2e-06,0.003,156,180,45,69,24,92,0.72,24,24,68
OceanDNA-b26844,1735,7.8,0.1,8.6e-05,0.28,94,187,50,144,42,161,0.72,93,94,119
OceanDNA-b22995,1529,21.1,0.3,3.8e-08,1.6e-05,52,206,455,622,421,630,0.72,154,167,209
OceanDNA-b22205,1803,10.9,0.0,9.5e-06,0.026,109,195,20,117,15,131,0.72,86,97,116
OceanDNA-b46766,1355,13.9,0.0,2.4e-06,0.0021,154,192,205,244,185,302,0.72,38,39,117
OceanDNA-b16517,491,14.2,0.3,9.6e-07,0.00086,88,174,204,303,152,310,0.71,86,99,158
OceanDNA-b5955,63,9.7,0.0,2.3e-05,0.0092,108,191,530,623,525,629,0.71,83,93,104
OceanDNA-b32135,345,1.2,0.0,0.009,24.0,195,250,213,269,199,274,0.71,55,56,75
OceanDNA-b33520,16,1.7,0.0,0.0062,3.3,198,244,178,220,171,238,0.71,46,42,67
OceanDNA-b6493,685,10.0,0.0,3.6e-05,0.014,146,179,432,465,418,493,0.71,33,33,75
OceanDNA-b40634,229,38.2,0.1,9.7e-14,4e-11,62,244,78,275,68,282,0.71,182,197,214
OceanDNA-b44183,327,17.2,0.0,1.2e-07,5.7e-05,135,195,119,173,61,196,0.71,60,54,135
OceanDNA-b20906,284,15.4,0.6,4.1e-07,0.0018,84,177,119,223,111,290,0.71,93,104,179
OceanDNA-b4045,852,20.1,0.0,1.6e-08,1.4e-05,65,192,43,178,22,186,0.71,127,135,164
OceanDNA-b3337,1561,-2.9,0.0,0.31,560.0,196,213,111,129,96,137,0.71,17,18,41
OceanDNA-b24091,658,10.8,0.1,2.1e-05,0.011,133,210,99,184,93,196,0.71,77,85,103
OceanDNA-b22443,289,11.2,0.0,8e-06,0.02,129,183,544,591,511,606,0.71,54,47,95
OceanDNA-b20977,3170,10.7,0.0,3.3e-05,0.041,151,205,216,272,205,325,0.71,54,56,120
OceanDNA-b30641,77,12.9,0.1,4.7e-06,0.0025,152,185,79,110,19,120,0.71,33,31,101
OceanDNA-b23370,1686,15.1,0.5,1.1e-06,0.0011,97,178,81,160,74,179,0.71,81,79,105
OceanDNA-b33520,16,8.1,0.1,6.9e-05,0.037,147,177,49,79,38,91,0.71,30,30,53
OceanDNA-b18639,160,-0.2,0.0,0.047,9.6,86,120,141,175,92,181,0.71,34,34,89
OceanDNA-b45271,128,14.9,0.0,1.2e-06,0.00028,90,179,168,260,157,278,0.71,89,92,121
OceanDNA-b38872,355,8.9,0.0,4.1e-05,0.027,106,195,51,143,30,151,0.71,89,92,121
OceanDNA-b34219,1085,-3.2,0.0,0.19,480.0,21,48,92,119,77,125,0.71,27,27,48
OceanDNA-b10079,394,23.4,0.0,1.5e-09,1.3e-06,147,206,175,237,162,255,0.71,59,62,93
OceanDNA-a3708,129,7.6,0.0,0.0001,0.033,92,174,227,322,222,334,0.71,82,95,112
OceanDNA-b22017,4207,0.7,0.0,0.013,71.0,205,264,466,523,455,534,0.71,59,57,79
OceanDNA-b37529,835,23.4,0.1,1.5e-09,3.1e-06,75,230,83,260,12,278,0.71,155,177,266
OceanDNA-b31695,307,10.9,0.0,9.5e-06,0.018,126,183,517,576,482,588,0.71,57,59,106
OceanDNA-b23108,845,15.2,0.0,9.5e-07,0.00097,150,256,221,342,211,350,0.71,106,121,139
OceanDNA-b44444,1331,25.0,0.0,4.8e-10,1.1e-06,89,170,127,219,123,239,0.71,81,92,116
OceanDNA-b22261,1742,17.5,0.0,9.8e-08,0.00019,133,187,172,224,156,257,0.71,54,52,101
OceanDNA-b22554,194,12.6,0.1,5.8e-06,0.0035,78,176,526,626,523,635,0.71,98,100,112
OceanDNA-b32684,1044,-2.9,0.0,0.16,250.0,198,213,207,222,173,248,0.71,15,15,75
OceanDNA-b24240,502,-2.1,0.0,0.087,100.0,232,257,190,214,174,226,0.71,25,24,52
OceanDNA-b8222,62,-0.7,0.0,0.033,9.1,154,185,70,102,51,144,0.71,31,32,93
OceanDNA-b40641,883,9.1,0.1,0.00014,0.046,105,187,68,149,47,168,0.71,82,81,121
OceanDNA-b15711,972,-1.8,0.0,0.15,84.0,243,284,71,112,45,121,0.71,41,41,76
OceanDNA-b22637,1373,15.2,0.0,4.9e-07,0.0015,149,181,111,145,101,163,0.71,32,34,62
OceanDNA-b35159,1207,11.2,0.1,7.6e-06,0.013,92,184,43,144,32,178,0.71,92,101,146
OceanDNA-b43987,160,5.4,0.0,0.00091,0.1,194,245,124,181,115,190,0.71,51,57,75
OceanDNA-b36076,1735,13.4,0.0,3.3e-06,0.0042,151,189,534,573,522,615,0.71,38,39,93
OceanDNA-b30681,143,14.0,0.1,1.1e-06,0.00075,104,196,53,148,15,155,0.71,92,95,140
OceanDNA-b20404,296,-1.7,0.0,0.065,27.0,103,120,161,178,146,182,0.71,17,17,36
OceanDNA-b40943,23,13.0,0.0,4.4e-06,0.0021,104,181,38,109,23,119,0.71,77,71,96
OceanDNA-b7584,366,3.2,0.0,0.0022,0.84,153,175,155,177,133,191,0.71,22,22,58
OceanDNA-b38376,703,4.1,0.0,0.0059,2.9,196,243,266,309,259,323,0.71,47,43,64
OceanDNA-b38369,225,23.8,0.0,3.4e-09,2e-06,105,254,109,272,61,284,0.71,149,163,223
OceanDNA-b13198,39,8.8,0.0,4.4e-05,0.023,104,183,52,130,26,153,0.71,79,78,127
OceanDNA-b26837,1569,11.7,0.1,5.4e-06,0.016,130,169,89,130,41,148,0.71,39,41,107
OceanDNA-b32747,410,6.0,0.0,0.00031,0.15,182,263,288,366,274,368,0.71,81,78,94
OceanDNA-b41451,1294,32.5,0.0,5e-12,3.6e-09,92,243,107,274,102,281,0.71,151,167,179
OceanDNA-b7450,617,9.2,0.0,6.2e-05,0.041,100,193,48,144,16,151,0.71,93,96,135
OceanDNA-b36401,961,12.0,0.1,1.3e-05,0.0049,67,188,47,178,25,208,0.71,121,131,183
OceanDNA-b3545,477,33.2,0.0,1.6e-12,1.1e-09,84,239,65,227,43,238,0.71,155,162,195
OceanDNA-b3257,5,-1.5,0.0,0.06,47.0,198,224,260,286,255,350,0.71,26,26,95
OceanDNA-b37510,398,7.3,0.1,0.00025,0.2,97,131,78,110,72,136,0.71,34,32,64
OceanDNA-b20902,2959,11.6,0.0,5.8e-06,0.025,143,212,151,222,139,231,0.71,69,71,92
OceanDNA-b34946,337,10.5,0.1,1.2e-05,0.0089,104,185,70,150,40,169,0.71,81,80,129
OceanDNA-b44662,1421,1.7,0.1,0.013,17.0,56,99,523,569,512,576,0.71,43,46,64
OceanDNA-b23148,295,21.2,0.0,1.4e-08,1.8e-05,91,229,381,539,371,551,0.71,138,158,180
OceanDNA-b19147,356,1.8,0.0,0.011,2.0,129,176,118,166,113,181,0.71,47,48,68
OceanDNA-b32900,696,8.9,0.2,4e-05,0.067,154,187,87,120,38,127,0.71,33,33,89
OceanDNA-b46295,121,10.6,0.0,2.4e-05,0.034,103,158,25,82,13,107,0.71,55,57,94
OceanDNA-b19686,2,59.5,0.0,3e-20,7e-18,64,282,78,330,63,341,0.71,218,252,278
OceanDNA-b20627,234,3.0,0.0,0.0024,0.78,83,122,133,172,125,212,0.71,39,39,87
OceanDNA-b22460,1842,13.8,0.0,2.5e-06,0.0044,134,211,703,782,671,797,0.71,77,79,126
OceanDNA-b3034,104,14.8,0.0,6.1e-07,0.00015,91,207,25,142,18,163,0.71,116,117,145
OceanDNA-b41476,951,18.7,0.0,8e-08,5.7e-05,89,243,93,263,87,273,0.71,154,170,186
OceanDNA-b3956,990,9.0,0.0,3.7e-05,0.038,159,193,108,146,9,153,0.71,34,38,144
OceanDNA-b1522,751,13.8,0.1,3.7e-06,0.0012,101,185,61,142,8,179,0.71,84,81,171
OceanDNA-b9705,341,5.4,0.0,0.00046,0.38,201,268,207,272,191,287,0.71,67,65,96
OceanDNA-b13153,314,-3.5,0.0,0.23,170.0,70,86,16,32,14,51,0.71,16,16,37
OceanDNA-b45634,653,6.1,0.0,0.00058,0.21,157,188,16,47,4,60,0.71,31,31,56
OceanDNA-b20682,69,23.5,0.0,1.4e-09,4e-07,129,244,25,146,18,162,0.71,115,121,144
OceanDNA-b41358,206,11.7,0.1,2.2e-05,0.0066,58,181,102,229,40,266,0.71,123,127,226
OceanDNA-b8544,124,-2.3,0.0,0.1,19.0,199,227,215,242,208,251,0.71,28,27,43
OceanDNA-b30994,2728,12.0,0.0,4.5e-06,0.013,145,178,169,205,156,227,0.71,33,36,71
OceanDNA-b44414,115,17.7,1.6,8.2e-08,1.9e-05,80,248,73,251,48,269,0.71,168,178,221
OceanDNA-b24146,108,7.5,0.0,0.00011,0.24,187,245,256,310,241,320,0.71,58,54,79
OceanDNA-b40618,310,134.4,0.1,9.4e-43,1.4e-40,17,250,44,296,28,346,0.71,233,252,318
OceanDNA-b3972,255,12.4,0.0,3.5e-06,0.0022,153,189,587,624,534,638,0.71,36,37,104
OceanDNA-b32793,1396,3.0,0.1,0.0024,8.3,136,188,69,124,55,136,0.71,52,55,81
OceanDNA-b33317,1303,10.6,0.0,1.2e-05,0.032,125,180,87,145,79,155,0.71,55,58,76
OceanDNA-b26937,161,3.8,0.0,0.0028,0.32,195,264,306,376,298,381,0.71,69,70,83
OceanDNA-b17212,2925,2.0,0.0,0.01,21.0,169,217,111,163,91,190,0.71,48,52,99
OceanDNA-b1825,2392,28.3,0.4,9.7e-11,1.8e-07,87,243,492,672,486,678,0.71,156,180,192
OceanDNA-b506,1249,-0.3,0.0,0.075,48.0,99,150,99,154,58,178,0.71,51,55,120
OceanDNA-b40889,92,1.3,0.0,0.017,5.4,181,244,265,333,258,338,0.71,63,68,80
OceanDNA-b40685,499,17.5,0.1,1.9e-07,0.0001,187,261,217,289,191,294,0.71,74,72,103
OceanDNA-b35069,891,17.2,0.0,2.3e-07,0.00011,83,186,57,167,48,175,0.71,103,110,127
OceanDNA-b10728,419,3.9,0.0,0.0013,0.94,161,185,129,153,42,176,0.71,24,24,134
OceanDNA-b31994,2391,18.3,0.1,5.5e-08,0.00018,98,171,78,165,62,177,0.71,73,87,115
OceanDNA-b31581,1882,5.5,0.0,0.00043,1.0,98,168,121,189,111,200,0.71,70,68,89
OceanDNA-b45590,333,11.5,0.0,6.2e-06,0.0032,154,243,159,262,138,269,0.71,89,103,131
OceanDNA-b6704,397,10.4,0.0,4e-05,0.012,105,187,155,241,140,260,0.71,82,86,120
OceanDNA-b36144,426,12.4,0.0,6.8e-06,0.0085,148,216,512,584,500,600,0.71,68,72,100
OceanDNA-b20756,163,51.3,0.0,4.8e-18,1.4e-15,72,281,96,331,73,340,0.71,209,235,267
OceanDNA-b44480,233,-2.1,0.0,0.09,31.0,106,129,100,125,68,134,0.71,23,25,66
OceanDNA-b2513,1391,9.4,0.5,5.8e-05,0.042,155,211,185,246,169,267,0.71,56,61,98
OceanDNA-b22478,650,13.9,0.0,3.5e-06,0.0027,153,211,226,284,213,366,0.71,58,58,153
OceanDNA-b202,1210,19.1,0.1,9.5e-08,7.1e-05,64,216,19,181,8,230,0.71,152,162,222
OceanDNA-b40245,298,5.1,0.1,0.0018,0.43,230,265,241,277,206,279,0.71,35,36,73
OceanDNA-b9777,817,13.3,0.0,1.8e-06,0.0023,94,180,65,146,59,155,0.71,86,81,96
OceanDNA-b33096,89,11.6,0.0,1.8e-05,0.0075,104,175,12,93,5,107,0.71,71,81,102
OceanDNA-b6704,841,13.3,0.0,5.6e-06,0.0016,86,211,105,239,84,250,0.71,125,134,166
OceanDNA-b21873,149,0.8,0.0,0.012,2.2,198,248,197,245,179,261,0.71,50,48,82
OceanDNA-b45289,7,13.4,0.0,5e-06,0.0042,88,181,164,260,156,277,0.71,93,96,121
OceanDNA-b3547,369,-1.1,0.0,0.043,32.0,197,229,220,250,194,279,0.71,32,30,85
OceanDNA-b35208,909,7.8,0.0,8.8e-05,0.084,150,181,126,157,86,166,0.71,31,31,80
OceanDNA-b15777,593,14.0,0.0,3.3e-06,0.0019,150,202,174,225,161,292,0.71,52,51,131
OceanDNA-b22894,353,22.6,0.3,2.7e-09,5.7e-06,77,245,73,284,69,293,0.71,168,211,224
OceanDNA-b5500,93,11.0,0.0,9.2e-06,0.0036,151,192,198,243,135,254,0.71,41,45,119
OceanDNA-b23839,810,13.8,0.0,2.6e-06,0.0014,107,192,128,222,113,230,0.71,85,94,117
OceanDNA-b13635,603,25.9,0.0,2.6e-10,3.1e-07,151,244,139,233,120,261,0.71,93,94,141
OceanDNA-b17618,82,12.2,0.1,3.8e-06,0.0056,92,193,64,165,56,174,0.71,101,101,118
OceanDNA-b17212,4055,14.0,0.1,2.1e-06,0.0044,197,243,84,128,48,135,0.71,46,44,87
OceanDNA-b4022,184,-0.2,0.0,0.047,29.0,176,222,276,328,271,356,0.71,46,52,85
OceanDNA-b46309,1863,12.5,0.0,9.8e-06,0.0075,151,189,209,248,194,286,0.71,38,39,92
OceanDNA-b23324,307,16.8,0.0,1.5e-07,5.9e-05,83,193,40,154,19,161,0.7,110,114,142
OceanDNA-b42293,157,-2.7,0.0,0.14,27.0,252,273,28,50,14,60,0.7,21,22,46
OceanDNA-a3751,172,-2.6,0.0,0.12,23.0,50,88,164,202,152,218,0.7,38,38,66
OceanDNA-b20909,1214,10.7,0.1,2.3e-05,0.083,105,190,196,283,180,289,0.7,85,87,109
OceanDNA-b46897,281,0.7,0.0,0.013,11.0,35,86,29,77,5,82,0.7,51,48,77
OceanDNA-b36071,125,14.9,0.2,1.2e-06,0.0013,104,196,59,154,22,162,0.7,92,95,140
OceanDNA-b15777,1620,5.4,0.0,0.0014,0.79,194,230,216,250,208,284,0.7,36,34,76
OceanDNA-b19603,228,10.9,0.0,1.9e-05,0.0038,151,241,97,194,80,209,0.7,90,97,129
OceanDNA-b22518,1323,-3.3,0.0,0.4,750.0,95,110,508,523,496,527,0.7,15,15,31
OceanDNA-b33195,96,1.1,0.0,0.0097,6.9,201,264,202,263,195,264,0.7,63,61,69
OceanDNA-b22848,486,16.6,0.0,1.8e-07,0.00071,112,212,505,608,466,634,0.7,100,103,168
OceanDNA-b13541,1191,-3.4,0.0,0.23,310.0,201,258,305,362,300,368,0.7,57,57,68
OceanDNA-b3199,754,18.1,0.0,6.2e-08,0.00012,102,190,49,148,29,172,0.7,88,99,143
OceanDNA-b5499,196,11.2,0.1,7.9e-06,0.0031,142,189,225,277,130,293,0.7,47,52,163
OceanDNA-b3301,835,4.1,0.0,0.0023,3.1,197,221,219,243,213,281,0.7,24,24,68
OceanDNA-b12642,408,13.4,0.0,1.7e-06,0.001,140,185,97,141,10,148,0.7,45,44,138
OceanDNA-b30224,1631,4.4,0.0,0.00095,1.7,177,223,237,289,227,320,0.7,46,52,93
OceanDNA-b15450,418,16.4,0.1,4e-07,0.00041,80,189,47,164,34,185,0.7,109,117,151
OceanDNA-b35229,353,12.4,0.0,3.5e-06,0.0024,136,186,256,305,189,353,0.7,50,49,164
OceanDNA-b22891,1048,5.5,0.1,0.00044,1.2,143,177,85,121,44,132,0.7,34,36,88
OceanDNA-b23131,668,18.9,0.0,3.7e-08,3.6e-05,150,208,148,210,129,218,0.7,58,62,89
OceanDNA-b21342,331,-1.9,0.0,0.077,37.0,197,231,194,227,187,253,0.7,34,33,66
OceanDNA-b31131,267,12.9,0.0,4.7e-06,0.0016,125,236,45,158,26,185,0.7,111,113,159
OceanDNA-b31573,834,-1.7,0.0,0.13,120.0,198,218,300,320,297,361,0.7,20,20,64
OceanDNA-b15991,1008,11.8,0.5,5.1e-06,0.0075,143,186,187,231,113,242,0.7,43,44,129
OceanDNA-b3920,492,17.3,0.0,3.2e-07,0.0002,153,213,365,427,347,442,0.7,60,62,95
OceanDNA-b36755,104,5.5,0.0,0.00089,1.7,197,244,206,251,199,267,0.7,47,45,68
OceanDNA-b6561,240,5.7,0.0,0.0011,0.51,200,264,194,256,181,260,0.7,64,62,79
OceanDNA-b40245,93,10.8,0.0,3.2e-05,0.0078,192,245,238,294,217,316,0.7,53,56,99
OceanDNA-b42461,83,-1.1,0.0,0.045,14.0,201,227,90,116,32,125,0.7,26,26,93
OceanDNA-b36995,376,-3.1,0.0,0.18,140.0,94,120,154,180,149,182,0.7,26,26,33
OceanDNA-b31192,461,-2.2,0.0,0.093,73.0,198,223,212,236,209,276,0.7,25,24,67
OceanDNA-b11531,252,14.1,0.0,1e-06,0.00045,93,176,101,198,84,214,0.7,83,97,130
OceanDNA-b17035,8,-3.9,0.0,0.61,290.0,16,50,41,75,35,80,0.7,34,34,45
OceanDNA-b4252,269,0.1,0.0,0.02,50.0,188,228,164,203,149,206,0.7,40,39,57
OceanDNA-b22131,554,21.8,0.0,9.1e-09,3.9e-06,149,248,158,261,134,267,0.7,99,103,133
OceanDNA-b10043,168,11.4,0.0,6.6e-06,0.0027,133,188,122,175,45,185,0.7,55,53,140
OceanDNA-b22765,1312,18.8,0.0,7.8e-08,6.3e-05,151,216,168,235,149,246,0.7,65,67,97
OceanDNA-b16143,19,2.8,0.0,0.0058,2.5,177,246,412,484,405,494,0.7,69,72,89
OceanDNA-b16143,19,15.4,0.0,8.5e-07,0.00037,78,181,256,375,252,391,0.7,103,119,139
OceanDNA-b23261,187,12.2,0.0,7.8e-06,0.0091,84,188,49,162,32,196,0.7,104,113,164
OceanDNA-b35383,562,1.8,0.0,0.0058,3.5,176,239,266,325,259,336,0.7,63,59,77
OceanDNA-b35168,500,4.0,0.1,0.0012,0.67,61,184,8,133,4,156,0.7,123,125,152
OceanDNA-b46812,2392,13.3,0.0,5.4e-06,0.0044,152,225,301,385,287,423,0.7,73,84,136
OceanDNA-b46050,498,12.6,0.0,3e-06,0.0029,153,214,249,311,235,376,0.7,61,62,141
OceanDNA-b31945,387,1.4,0.0,0.0075,14.0,199,251,199,248,192,265,0.7,52,49,73
OceanDNA-b37653,1001,36.4,0.2,1.7e-13,1.8e-10,88,244,147,322,140,334,0.7,156,175,194
OceanDNA-b45289,7,2.3,0.0,0.012,10.0,179,225,304,350,296,393,0.7,46,46,97
OceanDNA-b34735,132,-2.7,0.0,0.28,91.0,52,81,490,519,477,529,0.7,29,29,52
OceanDNA-b5248,272,15.6,0.0,3.5e-07,0.00024,107,191,550,644,538,656,0.7,84,94,118
OceanDNA-b41418,435,6.6,0.0,0.00019,0.17,197,219,237,259,224,302,0.7,22,22,78
OceanDNA-b13674,206,4.2,0.1,0.001,0.23,56,121,55,124,42,129,0.7,65,69,87
OceanDNA-b31172,1603,5.4,0.0,0.00045,0.73,197,249,291,340,283,357,0.7,52,49,74
OceanDNA-b45790,316,11.6,0.0,5.9e-06,0.0024,90,196,68,174,48,179,0.7,106,106,131
OceanDNA-b34551,215,0.4,0.0,0.045,13.0,147,189,531,573,482,584,0.7,42,42,102
OceanDNA-b34725,188,8.2,0.0,0.00013,0.044,75,181,398,514,381,524,0.7,106,116,143
OceanDNA-b36890,852,-2.0,0.0,0.084,130.0,201,233,254,281,251,292,0.7,32,27,41
OceanDNA-b7475,556,10.6,0.0,1.2e-05,0.0072,146,180,78,112,42,138,0.7,34,34,96
OceanDNA-b15230,311,12.8,0.0,5.1e-06,0.0012,154,187,93,126,24,132,0.7,33,33,108
OceanDNA-b14822,76,6.9,0.0,0.00016,0.038,136,176,90,128,24,137,0.7,40,38,113
OceanDNA-b18620,349,-2.1,0.0,0.17,36.0,93,120,114,141,105,146,0.7,27,27,41
OceanDNA-b13083,150,8.6,0.0,4.8e-05,0.12,135,185,126,174,74,205,0.7,50,48,131
OceanDNA-b34854,147,2.4,0.0,0.0038,2.3,107,175,479,554,473,583,0.7,68,75,110
OceanDNA-b17563,225,0.4,0.0,0.031,35.0,52,107,63,121,55,139,0.7,55,58,84
OceanDNA-b19120,201,19.5,0.0,4.8e-08,7.9e-06,108,186,69,157,34,192,0.7,78,88,158
OceanDNA-b30157,926,12.9,0.1,2.4e-06,0.0051,107,198,70,164,47,188,0.7,91,94,141
OceanDNA-b23491,381,9.6,0.3,4.8e-05,0.044,161,188,149,176,42,196,0.7,27,27,154
OceanDNA-b1522,281,0.9,0.0,0.033,11.0,194,250,238,293,222,300,0.7,56,55,78
OceanDNA-b1522,281,10.9,0.1,3e-05,0.01,139,183,102,145,46,153,0.7,44,43,107
OceanDNA-b30216,630,12.3,0.1,3.7e-06,0.0074,134,198,295,361,256,376,0.7,64,66,120
OceanDNA-b23832,3,8.1,0.0,0.00014,0.12,137,185,397,443,333,475,0.7,48,46,142
OceanDNA-b37058,112,-3.3,0.0,0.2,130.0,94,120,194,220,189,222,0.7,26,26,33
OceanDNA-b34942,321,9.1,0.0,3.5e-05,0.02,193,260,173,236,159,242,0.7,67,63,83
OceanDNA-b20676,199,8.9,0.0,8.1e-05,0.014,217,273,260,319,229,340,0.7,56,59,111
OceanDNA-b21000,2867,22.9,0.2,2.2e-09,6.4e-06,98,171,179,264,173,273,0.7,73,85,100
OceanDNA-b3462,229,-2.8,0.0,0.14,92.0,95,141,138,188,128,199,0.7,46,50,71
OceanDNA-b4039,846,10.8,0.0,1.1e-05,0.01,96,131,12,48,4,77,0.7,35,36,73
OceanDNA-b10085,654,18.3,0.0,5.6e-08,4.9e-05,153,247,360,456,342,468,0.7,94,96,126
OceanDNA-b42600,70,12.2,0.0,3.9e-06,0.0011,151,227,171,253,155,262,0.7,76,82,107
OceanDNA-b22978,1065,10.7,0.0,2.2e-05,0.024,103,186,165,243,152,289,0.7,83,78,137
OceanDNA-b35330,190,15.9,0.1,2.8e-07,5.9e-05,94,190,46,141,33,155,0.7,96,95,122
OceanDNA-b41044,1573,10.9,0.7,1.9e-05,0.018,84,191,30,143,15,164,0.7,107,113,149
OceanDNA-b269,1802,30.2,0.0,2.6e-11,2.6e-08,126,243,148,269,140,292,0.7,117,121,152
OceanDNA-b43987,64,17.1,0.1,2.5e-07,2.8e-05,73,172,84,195,77,200,0.7,99,111,123
OceanDNA-b43839,1693,0.3,0.0,0.033,30.0,189,217,225,253,194,299,0.7,28,28,105
OceanDNA-b8264,293,-3.0,0.0,0.33,120.0,191,212,221,242,219,251,0.7,21,21,32
OceanDNA-b12697,485,11.9,0.0,5e-06,0.0041,107,177,547,623,532,644,0.7,70,76,112
OceanDNA-b1719,179,9.5,0.1,5.3e-05,0.078,101,185,157,240,142,259,0.7,84,83,117
OceanDNA-b5526,379,12.9,0.0,4.7e-06,0.0012,108,191,543,636,510,650,0.7,83,93,140
OceanDNA-b37895,508,0.9,0.0,0.022,8.8,110,189,472,557,465,565,0.7,79,85,100
OceanDNA-b38590,329,6.0,0.0,0.00029,0.2,169,218,204,259,185,296,0.7,49,55,111
OceanDNA-b22380,600,11.6,0.0,1.8e-05,0.0093,108,176,142,208,48,223,0.7,68,66,175
OceanDNA-b30115,454,12.0,0.2,4.5e-06,0.012,166,244,219,296,213,312,0.7,78,77,99
OceanDNA-b30225,956,15.2,0.0,9.8e-07,0.0013,153,188,146,185,129,213,0.7,35,39,84
OceanDNA-b2904,2752,9.4,0.6,2.7e-05,0.12,109,183,161,231,100,247,0.7,74,70,147
OceanDNA-b15541,1753,17.3,0.0,3.3e-07,0.00021,107,209,140,255,134,271,0.7,102,115,137
OceanDNA-b10602,233,10.6,0.0,2.5e-05,0.0039,133,189,100,154,33,161,0.7,56,54,128
OceanDNA-b13299,275,10.6,0.0,2.4e-05,0.013,77,186,81,196,50,211,0.7,109,115,161
OceanDNA-b6574,401,10.1,0.0,3.5e-05,0.016,93,180,18,100,12,110,0.7,87,82,98
OceanDNA-b13078,1187,-1.8,0.0,0.07,90.0,197,248,276,329,268,349,0.7,51,53,81
OceanDNA-b18640,271,11.3,0.0,1.4e-05,0.0023,183,228,241,284,227,316,0.7,45,43,89
OceanDNA-b35375,221,12.7,0.0,2.7e-06,0.0043,101,229,111,249,23,272,0.7,128,138,249
OceanDNA-b37613,422,19.7,0.0,2.1e-08,4.2e-05,108,215,64,185,35,196,0.69,107,121,161
OceanDNA-b11616,217,4.5,0.1,0.00085,0.86,252,282,307,339,281,350,0.69,30,32,69
OceanDNA-b1347,737,30.4,0.1,2.2e-11,1.6e-08,86,246,193,367,185,384,0.69,160,174,199
OceanDNA-b11616,217,17.1,0.3,1.3e-07,0.00013,74,170,175,281,153,291,0.69,96,106,138
OceanDNA-b16212,559,-3.2,0.0,0.19,220.0,64,85,25,44,19,47,0.69,21,19,28
OceanDNA-b40613,167,-2.5,0.0,0.35,89.0,94,123,54,86,47,96,0.69,29,32,49
OceanDNA-b32865,275,15.6,0.1,3.6e-07,0.00019,109,223,66,178,48,197,0.69,114,112,149
OceanDNA-b3315,1347,12.3,0.2,7.5e-06,0.013,89,187,44,140,37,160,0.69,98,96,123
OceanDNA-b16128,406,15.7,0.0,3.4e-07,0.00031,98,202,190,295,164,301,0.69,104,105,137
OceanDNA-b22377,438,-1.6,0.0,0.13,140.0,234,266,240,274,212,274,0.69,32,34,62
OceanDNA-b23283,114,6.8,0.0,0.00017,0.078,75,188,57,170,38,189,0.69,113,113,151
OceanDNA-b13273,1079,13.6,0.0,1.5e-06,0.0016,79,245,62,233,44,242,0.69,166,171,198
OceanDNA-b34562,134,2.1,0.0,0.0046,3.3,191,246,290,342,255,355,0.69,55,52,100
OceanDNA-b1833,1400,21.7,0.4,4.9e-09,7.1e-06,89,221,145,309,137,330,0.69,132,164,193
OceanDNA-b22650,2148,14.8,0.0,1.3e-06,0.0015,134,186,129,178,83,185,0.69,52,49,102
OceanDNA-b22385,1572,-3.9,0.0,0.61,1200.0,35,78,562,608,557,612,0.69,43,46,55
OceanDNA-b40262,146,11.0,0.0,9e-06,0.0044,45,180,55,186,14,202,0.69,135,131,188
OceanDNA-b23293,1110,6.9,0.2,0.00016,0.23,101,172,56,127,46,143,0.69,71,71,97
OceanDNA-b31152,265,3.8,0.0,0.0029,1.2,199,246,248,294,241,316,0.69,47,46,75
OceanDNA-b41211,1622,34.8,0.1,5.2e-13,1e-09,17,268,33,289,17,303,0.69,251,256,286
OceanDNA-b1154,1338,13.5,0.0,1.6e-06,0.0028,109,194,220,316,213,322,0.69,85,96,109
OceanDNA-b23850,1393,4.7,0.3,0.0023,1.1,154,254,215,321,182,330,0.69,100,106,148
OceanDNA-b34663,386,-0.5,0.0,0.058,24.0,140,177,481,519,442,527,0.69,37,38,85
OceanDNA-b3454,606,12.0,0.0,4.4e-06,0.0032,134,188,100,148,88,188,0.69,54,48,100
OceanDNA-b30842,113,0.1,0.0,0.019,11.0,107,139,75,109,58,125,0.69,32,34,67
OceanDNA-b31981,888,7.2,0.1,0.00026,0.3,112,183,102,176,86,187,0.69,71,74,101
OceanDNA-b23813,1139,13.2,0.2,2e-06,0.0029,76,243,64,247,59,254,0.69,167,183,195
OceanDNA-b31945,387,11.1,0.0,8.4e-06,0.016,159,188,114,143,11,157,0.69,29,29,146
OceanDNA-b24966,964,11.3,0.0,7.4e-06,0.011,133,172,127,171,118,231,0.69,39,44,113
OceanDNA-b41526,837,28.4,0.1,9e-11,5e-08,77,230,84,254,81,273,0.69,153,170,192
OceanDNA-b33328,841,5.1,0.0,0.0011,0.65,96,173,138,217,110,230,0.69,77,79,120
OceanDNA-b20343,316,12.2,0.1,3.9e-06,0.0014,135,172,133,175,124,178,0.69,37,42,54
OceanDNA-b36151,881,10.9,0.0,1.9e-05,0.021,109,202,99,189,89,217,0.69,93,90,128
OceanDNA-b36658,243,16.4,0.0,4.1e-07,0.00018,140,218,190,264,106,295,0.69,78,74,189
OceanDNA-b34895,715,-0.8,0.0,0.036,31.0,188,213,194,220,179,233,0.69,25,26,54
OceanDNA-b30238,288,13.3,0.0,1.9e-06,0.0038,133,197,91,157,49,170,0.69,64,66,121
OceanDNA-b3712,1818,16.7,0.0,3.3e-07,0.00034,100,177,173,256,132,267,0.69,77,83,135
OceanDNA-b15525,654,11.7,0.0,5.5e-06,0.0089,127,197,95,159,14,164,0.69,70,64,150
OceanDNA-b45383,7997,1.0,0.0,0.021,95.0,60,108,338,383,329,385,0.69,48,45,56
OceanDNA-b6556,429,6.7,0.0,0.00018,0.21,160,197,109,150,6,161,0.69,37,41,155
OceanDNA-b40768,273,18.5,0.1,9.3e-08,2.9e-05,63,185,37,175,28,207,0.69,122,138,179
OceanDNA-b23396,1251,17.6,0.0,1.8e-07,0.00018,109,188,103,179,89,222,0.69,79,76,133
OceanDNA-b466,1643,18.2,0.0,1.8e-07,0.00017,123,222,227,340,222,364,0.69,99,113,142
OceanDNA-b47087,1306,14.2,0.0,2.9e-06,0.0027,151,212,238,301,220,316,0.69,61,63,96
OceanDNA-b4594,274,13.9,0.0,2.4e-06,0.00059,129,189,137,191,126,261,0.69,60,54,135
OceanDNA-b26870,727,-3.8,0.0,0.3,910.0,250,275,383,408,371,420,0.69,25,25,49
OceanDNA-b35857,444,1.0,0.3,0.01,4.9,97,173,58,133,50,146,0.69,76,75,96
OceanDNA-b33397,92,14.6,0.0,7.4e-07,0.00022,79,228,30,191,12,224,0.69,149,161,212
OceanDNA-b12523,276,32.3,0.0,3e-12,9.2e-10,85,244,73,239,53,250,0.69,159,166,197
OceanDNA-b3688,499,14.7,0.0,6.9e-07,0.00064,158,199,81,126,67,191,0.69,41,45,124
OceanDNA-a3737,266,5.0,0.0,0.0006,0.17,92,178,15,114,10,123,0.69,86,99,113
OceanDNA-b1424,555,12.6,0.0,6e-06,0.0023,137,195,587,648,539,654,0.69,58,61,115
OceanDNA-b38900,207,11.3,0.0,7.3e-06,0.0083,137,181,58,103,29,114,0.69,44,45,85
OceanDNA-a14,380,13.5,0.0,1.6e-06,0.0014,85,188,38,150,19,158,0.69,103,112,139
OceanDNA-b7374,41,-3.1,0.0,0.18,57.0,43,72,309,337,305,340,0.69,29,28,35
OceanDNA-b45584,416,10.3,0.0,2.9e-05,0.02,157,243,156,256,137,263,0.69,86,100,126
OceanDNA-b17210,56,10.2,0.0,1.6e-05,0.018,154,187,127,160,34,174,0.69,33,33,140
OceanDNA-b40797,403,14.1,0.2,1e-06,0.001,89,189,41,154,19,185,0.69,100,113,166
OceanDNA-b23468,2679,1.9,0.0,0.011,14.0,164,243,540,616,531,630,0.69,79,76,99
OceanDNA-b45520,838,25.4,0.0,7.6e-10,5.3e-07,149,217,170,240,143,274,0.69,68,70,131
OceanDNA-b16147,120,14.8,0.0,1.9e-06,0.00044,78,176,254,368,246,377,0.69,98,114,131
OceanDNA-b30235,805,1.7,0.0,0.0061,18.0,175,214,292,337,278,377,0.69,39,45,99
OceanDNA-b740,193,13.5,0.2,1.5e-06,0.00071,90,214,147,276,136,303,0.69,124,129,167
OceanDNA-b16210,467,27.5,0.4,1.8e-10,9.9e-08,78,180,301,426,237,443,0.69,102,125,206
OceanDNA-b13250,950,13.8,0.1,1.3e-05,0.0051,149,245,208,299,126,307,0.69,96,91,181
OceanDNA-b1435,497,11.0,0.1,2.7e-05,0.0076,148,184,96,133,43,149,0.69,36,37,106
OceanDNA-b17273,796,16.2,0.0,7.1e-07,0.00059,154,225,187,259,173,289,0.69,71,72,116
OceanDNA-b314,121,29.7,2.6,1.8e-11,1.5e-08,75,220,96,265,77,291,0.69,145,169,214
OceanDNA-b30487,1180,1.5,0.0,0.015,21.0,175,245,268,342,259,349,0.69,70,74,90
OceanDNA-b34263,511,12.3,0.0,7.5e-06,0.0024,153,181,593,621,518,626,0.69,28,28,108
OceanDNA-b46728,1025,15.7,0.0,1.4e-06,0.00057,155,194,5,45,1,106,0.69,39,40,105
OceanDNA-b7477,488,13.1,0.0,4.3e-06,0.0014,130,192,125,192,103,201,0.69,62,67,98
OceanDNA-b16510,1060,15.3,0.2,4.6e-07,0.00062,88,175,235,335,218,342,0.69,87,100,124
OceanDNA-b2877,23,-0.7,0.0,0.033,100.0,201,261,452,508,444,510,0.69,60,56,66
OceanDNA-b24875,724,-1.1,0.0,0.13,73.0,24,71,36,83,14,87,0.69,47,47,73
OceanDNA-b35132,707,9.8,0.0,2.1e-05,0.022,153,228,215,299,193,315,0.69,75,84,122
OceanDNA-b7448,64,12.4,0.0,6.6e-06,0.0022,96,169,360,431,334,453,0.69,73,71,119
OceanDNA-b45,2039,11.5,0.0,6.6e-06,0.024,6,178,89,265,85,272,0.69,172,176,187
OceanDNA-b9344,34,9.8,0.0,2.1e-05,0.0062,157,184,91,118,26,129,0.69,27,27,103
OceanDNA-b22616,3382,15.3,0.0,1.4e-06,0.002,128,216,357,446,348,456,0.69,88,89,108
OceanDNA-b41688,10,-0.3,0.0,0.025,5.2,202,234,199,230,189,263,0.69,32,31,74
OceanDNA-b30225,1942,7.1,0.1,0.00028,0.36,140,198,134,194,88,201,0.69,58,60,113
OceanDNA-b46695,66,17.7,0.2,5.1e-07,0.00018,11,188,100,290,93,308,0.69,177,190,215
OceanDNA-b4045,852,-2.7,0.0,0.13,120.0,197,233,269,302,248,314,0.69,36,33,66
OceanDNA-b23175,2997,18.6,1.0,8.9e-08,0.00032,103,220,264,409,175,472,0.69,117,145,297
OceanDNA-b3655,170,11.6,0.0,1.8e-05,0.0046,139,198,77,137,22,148,0.69,59,60,126
OceanDNA-b37266,1047,-1.9,0.0,0.079,280.0,152,189,541,578,490,590,0.69,37,37,100
OceanDNA-b2904,2752,2.7,0.0,0.003,13.0,136,237,268,372,258,382,0.69,101,104,124
OceanDNA-b23843,2041,-1.9,0.0,0.08,180.0,78,124,58,107,27,122,0.69,46,49,95
OceanDNA-b45518,70,26.4,0.0,3.7e-10,3e-07,150,243,148,243,120,250,0.69,93,95,130
OceanDNA-b20998,1644,14.4,0.1,8.1e-07,0.0031,89,185,152,261,130,278,0.69,96,109,148
OceanDNA-b46916,2442,19.4,0.1,5.1e-08,0.00014,134,212,210,291,205,333,0.69,78,81,128
OceanDNA-b42995,28,9.4,0.0,2.8e-05,0.0073,199,289,163,259,156,265,0.69,90,96,109
OceanDNA-b401,641,-1.3,0.0,0.05,48.0,161,207,27,77,25,80,0.68,46,50,55
OceanDNA-b40624,223,35.4,0.2,6.7e-13,3.3e-10,59,244,80,280,15,287,0.68,185,200,272
OceanDNA-b15726,327,19.2,0.0,2.9e-08,2.5e-05,107,202,51,155,22,164,0.68,95,104,142
OceanDNA-b4147,901,11.6,0.0,1.2e-05,0.013,101,181,129,209,110,222,0.68,80,80,112
OceanDNA-b31521,15,-1.5,0.0,0.12,120.0,149,189,590,630,541,638,0.68,40,40,97
OceanDNA-b21790,8,12.0,0.0,4.6e-06,0.0012,109,194,545,641,531,647,0.68,85,96,116
OceanDNA-b29510,1942,6.8,0.0,0.00052,0.43,149,198,60,111,14,115,0.68,49,51,101
OceanDNA-b33307,615,10.1,0.1,1.7e-05,0.055,102,187,91,175,70,193,0.68,85,84,123
OceanDNA-b20897,2001,-1.4,0.0,0.056,150.0,158,179,124,145,113,160,0.68,21,21,47
OceanDNA-b15801,1289,21.9,0.1,8.7e-09,6.4e-06,149,206,107,164,24,178,0.68,57,57,154
OceanDNA-b17690,254,-0.3,0.0,0.024,48.0,198,249,218,271,214,280,0.68,51,53,66
OceanDNA-b32052,711,10.3,0.0,2.9e-05,0.028,105,194,562,661,541,667,0.68,89,99,126
OceanDNA-b23634,1957,17.9,0.4,2.1e-07,0.00017,75,189,70,185,3,204,0.68,114,115,201
OceanDNA-b5274,115,13.1,0.0,2e-06,0.0013,107,192,539,634,508,646,0.68,85,95,138
OceanDNA-b32706,1844,3.0,0.0,0.0026,4.9,201,261,246,308,209,312,0.68,60,62,103
OceanDNA-b32135,345,15.4,0.0,4.1e-07,0.0011,107,170,81,158,49,180,0.68,63,77,131
OceanDNA-b21043,1237,21.5,0.0,1.7e-08,1e-05,99,246,208,355,186,403,0.68,147,147,217
OceanDNA-b20184,195,13.3,0.0,1.8e-06,0.00099,140,180,111,151,46,152,0.68,40,40,106
OceanDNA-b906,322,19.4,0.0,2.6e-08,1.1e-05,89,191,85,201,70,236,0.68,102,116,166
OceanDNA-b37665,1090,6.3,0.2,0.00049,0.38,104,197,63,159,44,185,0.68,93,96,141
OceanDNA-b37652,816,-1.8,0.0,0.073,92.0,137,183,15,63,11,83,0.68,46,48,72
OceanDNA-b24046,1182,10.7,0.1,2.3e-05,0.029,109,205,174,269,151,276,0.68,96,95,125
OceanDNA-b10437,4,20.6,0.0,1.1e-08,2.6e-06,151,215,223,293,212,343,0.68,64,70,131
OceanDNA-b950,1814,10.2,0.0,3.2e-05,0.034,151,191,169,214,149,240,0.68,40,45,91
OceanDNA-b3323,131,-3.8,0.0,0.58,950.0,201,228,296,322,294,334,0.68,27,26,40
OceanDNA-b16039,280,1.8,0.1,0.0057,6.9,178,223,435,485,430,507,0.68,45,50,77
OceanDNA-b19691,328,10.8,0.8,1.1e-05,0.0042,55,122,24,92,19,152,0.68,67,68,133
OceanDNA-b23850,133,13.1,0.0,6.2e-06,0.0031,105,192,638,734,605,742,0.68,87,96,137
OceanDNA-b26843,1308,9.3,1.3,6e-05,0.083,94,180,99,192,85,197,0.68,86,93,112
OceanDNA-b21002,2868,21.5,0.0,1.7e-08,3.2e-05,84,244,224,399,218,405,0.68,160,175,187
OceanDNA-b41011,1460,13.3,0.0,3.6e-06,0.0045,129,177,168,222,136,232,0.68,48,54,96
OceanDNA-b32786,574,10.9,0.2,3e-05,0.016,98,183,448,539,377,546,0.68,85,91,169
OceanDNA-b1776,2429,17.6,0.4,1.8e-07,0.00034,82,214,165,302,154,318,0.68,132,137,164
OceanDNA-b4134,225,12.4,0.0,6.8e-06,0.0029,102,177,293,379,262,387,0.68,75,86,125
OceanDNA-b25939,345,-0.9,0.0,0.037,15.0,197,263,309,375,301,382,0.68,66,66,81
OceanDNA-b17424,328,26.1,0.0,4.4e-10,3.9e-07,151,244,164,262,113,276,0.68,93,98,163
OceanDNA-b3023,43,11.0,0.0,8.9e-06,0.0025,156,197,97,139,24,163,0.68,41,42,139
OceanDNA-a840,382,3.2,0.0,0.0021,0.83,182,242,305,365,295,386,0.68,60,60,91
OceanDNA-b22893,1361,17.1,0.0,3.9e-07,0.0003,85,211,505,641,496,669,0.68,126,136,173
OceanDNA-b18466,166,16.6,0.0,1.7e-07,6.4e-05,80,186,55,171,34,214,0.68,106,116,180
OceanDNA-b41304,3569,14.9,0.0,5.8e-07,0.0024,89,188,138,250,106,281,0.68,99,112,175
OceanDNA-b43426,332,-1.7,0.0,0.067,27.0,195,218,222,245,208,278,0.68,23,23,70
OceanDNA-b26893,2504,-3.6,0.0,0.51,840.0,94,128,69,106,67,114,0.68,34,37,47
OceanDNA-b22872,3058,13.9,0.0,2.4e-06,0.0037,151,179,62,90,45,109,0.68,28,28,64
OceanDNA-b10508,195,10.8,0.0,1.1e-05,0.0047,104,197,28,126,16,135,0.68,93,98,119
OceanDNA-b8956,293,23.7,0.0,1.2e-09,3.8e-07,138,211,116,193,105,203,0.68,73,77,98
OceanDNA-b40527,277,9.8,0.0,4.1e-05,0.016,184,261,107,180,102,184,0.68,77,73,82
OceanDNA-b12096,376,5.0,0.0,0.00061,0.46,100,196,49,148,23,161,0.68,96,99,138
OceanDNA-b6771,503,10.6,0.0,4.7e-05,0.011,89,182,119,226,101,233,0.68,93,107,132
OceanDNA-b2828,2980,10.6,0.1,3.7e-05,0.044,130,197,98,171,24,188,0.68,67,73,164
OceanDNA-b36616,37,16.0,0.8,2.7e-07,0.00078,104,172,167,251,160,285,0.68,68,84,125
OceanDNA-b23273,1319,-0.0,0.0,0.02,45.0,153,185,313,349,305,358,0.68,32,36,53
OceanDNA-b17714,1521,18.1,0.0,6.1e-08,0.00013,148,216,158,226,141,237,0.68,68,68,96
OceanDNA-b3869,277,14.7,0.0,6.8e-07,0.0004,152,247,155,253,98,265,0.68,95,98,167
OceanDNA-b517,1813,-0.4,0.5,0.027,100.0,144,195,19,74,15,96,0.68,51,55,81
OceanDNA-b13261,8,4.3,0.0,0.002,1.2,193,260,193,257,174,261,0.68,67,64,87
OceanDNA-b26636,3711,13.4,0.0,1.7e-06,0.0066,80,133,73,129,58,153,0.68,53,56,95
OceanDNA-b22876,3254,4.1,0.1,0.0022,4.1,128,175,123,170,89,242,0.68,47,47,153
OceanDNA-b488,1656,1.7,0.1,0.013,16.0,199,234,199,233,172,269,0.68,35,34,97
OceanDNA-b488,1656,8.3,0.4,0.00012,0.16,153,203,123,175,108,182,0.68,50,52,74
OceanDNA-b36722,252,12.7,0.0,5.5e-06,0.0027,100,212,170,291,141,342,0.68,112,121,201
OceanDNA-b34615,91,12.8,0.2,2.6e-06,0.0023,35,237,81,292,47,309,0.68,202,211,262
OceanDNA-b45383,5853,-3.9,0.0,0.64,2900.0,208,224,141,158,134,162,0.68,16,17,28
OceanDNA-b18515,271,13.9,0.0,1.2e-06,0.00051,149,220,55,131,34,176,0.68,71,76,142
OceanDNA-b19355,313,20.3,0.0,1.3e-08,4.9e-06,152,219,158,227,135,253,0.68,67,69,118
OceanDNA-b1333,1154,13.1,0.0,6.4e-06,0.0034,109,194,501,597,495,603,0.68,85,96,108
OceanDNA-b45279,1373,12.2,0.0,3.8e-06,0.0062,151,176,149,174,121,253,0.68,25,25,132
OceanDNA-b36730,3243,-0.0,0.0,0.041,67.0,151,173,108,128,46,161,0.68,22,20,115
OceanDNA-b23417,135,7.3,0.1,0.00037,0.35,78,121,87,130,83,235,0.68,43,43,152
OceanDNA-b26879,966,-0.5,0.0,0.03,100.0,192,217,214,239,203,278,0.68,25,25,75
OceanDNA-b1836,2232,10.5,0.1,1.3e-05,0.043,147,185,127,165,73,173,0.68,38,38,100
OceanDNA-b44694,1736,-3.0,0.0,0.16,640.0,102,125,69,94,42,102,0.68,23,25,60
OceanDNA-b23515,947,6.2,0.0,0.00027,0.34,122,189,57,122,51,134,0.68,67,65,83
OceanDNA-b23491,1528,14.8,0.0,1.3e-06,0.0012,90,190,112,226,94,261,0.68,100,114,167
OceanDNA-b45663,568,12.6,0.0,6e-06,0.0026,137,197,83,144,25,148,0.68,60,61,123
OceanDNA-b42821,541,13.2,0.0,2e-06,0.0017,158,182,159,183,137,231,0.68,24,24,94
OceanDNA-b1358,1852,15.0,0.5,5.6e-07,0.0016,148,195,102,147,37,174,0.68,47,45,137
OceanDNA-b3464,97,0.3,0.0,0.016,14.0,85,119,157,192,149,198,0.68,34,35,49
OceanDNA-b41496,132,7.7,1.1,9.1e-05,0.17,104,130,173,198,166,278,0.68,26,25,112
OceanDNA-b7279,119,-2.2,0.0,0.19,35.0,197,215,216,234,210,261,0.67,18,18,51
OceanDNA-b43986,170,8.2,1.2,6.6e-05,0.016,125,175,142,194,72,199,0.67,50,52,127
OceanDNA-b23530,1318,10.8,0.0,1.1e-05,0.022,98,183,454,545,448,553,0.67,85,91,105
OceanDNA-b3338,1288,14.0,1.2,1.1e-06,0.0038,87,186,46,143,36,162,0.67,99,97,126
OceanDNA-b14328,67,13.4,0.0,1.7e-06,0.0008,148,258,102,211,92,217,0.67,110,109,125
OceanDNA-b39756,409,12.2,0.0,1.2e-05,0.0017,108,176,124,197,120,216,0.67,68,73,96
OceanDNA-b19928,527,17.9,0.0,7.2e-08,4.2e-05,130,192,272,338,264,360,0.67,62,66,96
OceanDNA-b41340,879,9.1,0.1,0.00011,0.051,78,181,20,127,3,146,0.67,103,107,143
OceanDNA-b17248,509,14.8,0.0,6.3e-07,0.00034,194,236,698,743,629,765,0.67,42,45,136
OceanDNA-b40631,559,4.0,0.0,0.0013,0.72,193,243,292,341,266,347,0.67,50,49,81
OceanDNA-b23530,1318,-1.9,0.0,0.077,160.0,195,253,596,654,584,667,0.67,58,58,83
OceanDNA-b6820,3,8.4,0.0,5.7e-05,0.029,154,187,90,124,63,168,0.67,33,34,105
OceanDNA-b25927,19,-1.5,0.0,0.059,19.0,197,263,300,366,293,379,0.67,66,66,86
OceanDNA-a3751,172,2.7,0.0,0.003,0.54,92,126,231,267,219,336,0.67,34,36,117
OceanDNA-b21002,2868,-0.4,0.1,0.079,150.0,117,140,117,139,110,192,0.67,23,22,82
OceanDNA-b3912,1924,14.4,0.0,2.5e-06,0.0017,97,175,112,188,72,210,0.67,78,76,138
OceanDNA-b13844,27,-3.3,0.0,0.2,59.0,87,120,93,125,83,128,0.67,33,32,45
OceanDNA-b6425,553,-2.7,0.0,0.13,110.0,195,214,257,276,240,319,0.67,19,19,79
OceanDNA-b4004,18,5.8,0.0,0.00071,0.4,161,187,60,86,4,116,0.67,26,26,112
OceanDNA-b24591,1677,-0.7,0.0,0.033,90.0,76,122,43,95,4,102,0.67,46,52,98
OceanDNA-b37833,583,-1.8,0.0,0.15,77.0,189,213,218,242,189,261,0.67,24,24,72
OceanDNA-b38495,642,-3.1,0.0,0.56,150.0,193,213,236,256,234,269,0.67,20,20,35
OceanDNA-b43704,545,8.3,0.4,6.2e-05,0.067,110,181,4,70,1,80,0.67,71,66,79
OceanDNA-b26501,866,13.1,0.1,2.1e-06,0.0033,80,187,90,201,81,207,0.67,107,111,126
OceanDNA-b46520,903,-0.6,0.0,0.032,60.0,198,262,222,283,217,285,0.67,64,61,68
OceanDNA-b34767,496,18.8,0.1,7.4e-08,3.3e-05,82,186,56,163,26,176,0.67,104,107,150
OceanDNA-b32734,108,10.7,0.1,1.1e-05,0.0042,138,231,69,168,60,179,0.67,93,99,119
OceanDNA-b10367,795,12.6,0.0,3e-06,0.0024,150,226,36,117,9,158,0.67,76,81,149
OceanDNA-b13871,832,11.3,0.0,7.5e-06,0.0073,105,180,94,167,10,179,0.67,75,73,169
OceanDNA-b36144,1955,17.2,0.3,2.3e-07,0.00029,104,174,160,246,146,285,0.67,70,86,139
OceanDNA-b276,1268,29.6,0.0,6e-11,4.6e-08,149,244,50,149,18,172,0.67,95,99,154
OceanDNA-b40913,598,15.1,0.2,5.3e-07,0.00069,76,218,99,260,94,284,0.67,142,161,190
OceanDNA-b23643,888,1.8,0.0,0.011,14.0,197,261,232,297,227,300,0.67,64,65,73
OceanDNA-b10020,332,12.6,0.0,9e-06,0.0015,152,190,599,638,544,650,0.67,38,39,106
OceanDNA-b33070,487,16.3,0.0,2.1e-07,0.0002,105,188,56,145,19,156,0.67,83,89,137
OceanDNA-b28170,113,8.1,0.0,7.1e-05,0.19,196,237,170,206,161,236,0.67,41,36,75
OceanDNA-b34217,652,3.5,0.0,0.0018,2.3,183,239,151,209,143,233,0.67,56,58,90
OceanDNA-b28170,113,1.9,0.0,0.0055,14.0,156,187,56,87,43,127,0.67,31,31,84
OceanDNA-b43839,38,3.5,0.1,0.0034,3.0,145,177,89,121,69,134,0.67,32,32,65
OceanDNA-b37238,465,10.2,0.0,1.6e-05,0.029,109,193,531,625,515,633,0.67,84,94,118
OceanDNA-b15769,683,13.9,0.0,4.9e-06,0.0021,148,203,162,216,139,284,0.67,55,54,145
OceanDNA-b26197,431,-1.8,0.0,0.071,50.0,193,223,270,303,260,309,0.67,30,33,49
OceanDNA-b17223,1759,-1.8,0.0,0.22,200.0,184,216,246,278,216,291,0.67,32,32,75
OceanDNA-b23108,1029,22.9,0.0,4.3e-09,4.4e-06,109,212,350,474,340,484,0.67,103,124,144
OceanDNA-b32133,1141,1.6,0.0,0.0068,17.0,196,245,472,518,445,526,0.67,49,46,81
OceanDNA-b36971,832,15.4,0.1,4.2e-07,0.00042,136,183,119,166,53,184,0.67,47,47,131
OceanDNA-b39,2116,13.7,0.0,2.7e-06,0.0094,144,185,179,223,162,240,0.67,41,44,78
OceanDNA-b4471,6,20.7,0.0,9.9e-09,2.2e-06,100,184,240,335,210,358,0.67,84,95,148
OceanDNA-b3144,908,-1.5,0.0,0.11,74.0,61,104,225,267,210,270,0.67,43,42,60
OceanDNA-b9056,116,10.7,0.0,1.1e-05,0.0035,157,233,91,168,75,181,0.67,76,77,106
OceanDNA-b5270,260,50.2,0.4,1e-17,5.2e-15,89,244,81,244,31,255,0.67,155,163,224
OceanDNA-b4143,1413,6.6,0.0,0.00058,0.32,100,185,54,138,31,159,0.67,85,84,128
OceanDNA-b7448,59,5.2,0.0,0.0011,0.36,132,185,83,134,28,151,0.67,53,51,123
OceanDNA-b37447,660,-3.2,0.0,0.37,130.0,197,213,211,227,204,250,0.67,16,16,46
OceanDNA-b34217,652,17.7,0.0,8.1e-08,0.0001,101,195,20,116,6,124,0.67,94,96,118
OceanDNA-b23655,703,-1.8,0.0,0.15,140.0,107,135,84,114,15,127,0.67,28,30,112
OceanDNA-b26843,1077,8.4,0.1,0.00011,0.15,108,188,38,117,17,131,0.67,80,79,114
OceanDNA-b3323,1598,19.2,0.2,5.7e-08,9.4e-05,106,185,181,265,133,277,0.67,79,84,144
OceanDNA-b17563,670,22.8,0.0,4.5e-09,5.1e-06,108,217,79,198,47,214,0.67,109,119,167
OceanDNA-b41553,665,34.4,0.0,6.6e-13,7.7e-10,104,270,201,391,182,404,0.67,166,190,222
OceanDNA-b17609,3614,12.8,0.2,2.5e-06,0.012,107,181,151,235,147,250,0.67,74,84,103
OceanDNA-b35314,474,3.9,0.0,0.0013,1.4,201,263,197,258,192,260,0.67,62,61,68
OceanDNA-b9532,299,13.9,0.0,2.4e-06,0.00037,75,202,211,353,209,358,0.67,127,142,149
OceanDNA-b37960,81,-3.2,0.0,0.57,110.0,167,185,146,164,105,180,0.67,18,18,75
OceanDNA-b32265,1592,11.8,0.1,5.3e-06,0.0095,39,177,5,161,2,168,0.67,138,156,166
OceanDNA-b3385,1277,15.4,0.0,8.5e-07,0.0015,86,191,101,233,86,244,0.67,105,132,158
OceanDNA-b15711,972,14.6,0.0,1.5e-06,0.00084,153,243,163,258,150,264,0.67,90,95,114
OceanDNA-b3909,235,16.6,0.0,3.5e-07,0.00022,151,225,159,241,143,249,0.67,74,82,106
OceanDNA-b1353,1053,11.3,0.1,2.3e-05,0.029,67,111,265,311,237,315,0.67,44,46,78
OceanDNA-b21344,633,22.8,0.0,2.3e-09,2.3e-06,109,261,76,243,58,255,0.67,152,167,197
OceanDNA-b6783,384,11.6,0.0,6.2e-06,0.0028,94,182,22,105,9,116,0.67,88,83,107
OceanDNA-b32050,2125,-2.8,0.0,0.14,300.0,198,219,201,222,176,250,0.67,21,21,74
OceanDNA-b40237,535,-3.5,0.0,0.24,180.0,163,188,16,41,13,56,0.67,25,25,43
OceanDNA-b23143,876,-3.9,0.0,0.61,840.0,108,120,173,185,167,191,0.66,12,12,24
OceanDNA-b34923,521,0.8,0.0,0.012,9.0,152,172,146,166,62,180,0.66,20,20,118
OceanDNA-b26380,46,-2.7,0.0,0.13,100.0,197,223,248,274,230,286,0.66,26,26,56
OceanDNA-b31513,460,12.2,0.0,3.9e-06,0.0022,106,211,123,238,106,252,0.66,105,115,146
OceanDNA-b15879,586,22.0,0.0,7.9e-09,7e-06,83,198,48,172,29,184,0.66,115,124,155
OceanDNA-b16139,352,4.8,0.0,0.0014,0.55,193,277,411,507,393,519,0.66,84,96,126
OceanDNA-b22127,244,-2.1,0.0,0.091,150.0,16,46,657,688,648,693,0.66,30,31,45
OceanDNA-b9835,190,-1.9,0.0,0.076,22.0,192,243,167,214,163,237,0.66,51,47,74
OceanDNA-b1765,1396,15.8,1.0,3.1e-07,0.00072,82,215,171,310,166,324,0.66,133,139,158
OceanDNA-b27615,747,-3.7,0.0,0.28,1200.0,200,229,153,181,144,188,0.66,29,28,44
OceanDNA-b31573,834,11.4,0.0,1.3e-05,0.012,149,185,194,230,107,238,0.66,36,36,131
OceanDNA-b32684,1044,10.4,0.2,1.3e-05,0.021,99,186,39,122,27,128,0.66,87,83,101
OceanDNA-b23603,226,-2.2,0.0,0.096,220.0,188,246,293,347,284,367,0.66,58,54,83
OceanDNA-b26501,866,-3.7,0.0,0.26,410.0,194,216,297,320,294,332,0.66,22,23,38
OceanDNA-b40641,871,11.2,0.0,3.2e-05,0.011,141,215,101,181,69,193,0.66,74,80,124
OceanDNA-b37094,887,-2.9,0.0,0.16,150.0,154,190,567,606,562,626,0.66,36,39,64
OceanDNA-b41587,636,14.2,0.0,1.9e-06,0.00062,124,198,211,290,180,298,0.66,74,79,118
OceanDNA-b38369,851,9.6,0.0,7.1e-05,0.042,94,188,76,175,65,189,0.66,94,99,124
OceanDNA-b22478,202,-0.6,0.1,0.096,75.0,3,64,27,87,25,92,0.66,61,60,67
OceanDNA-b13195,128,11.8,0.0,5.2e-06,0.0029,146,185,103,141,32,143,0.66,39,38,111
OceanDNA-b31694,127,-2.2,0.0,0.092,130.0,87,129,32,78,21,82,0.66,42,46,61
OceanDNA-b36858,388,23.5,0.0,1.4e-09,1e-06,153,243,196,290,168,304,0.66,90,94,136
OceanDNA-b45582,707,7.5,0.2,0.0001,0.24,90,177,135,223,110,242,0.66,87,88,132
OceanDNA-b3372,1713,19.2,0.1,5.8e-08,9.5e-05,79,185,175,291,159,303,0.66,106,116,144
OceanDNA-b11613,391,-3.4,0.0,0.22,180.0,151,175,211,237,204,249,0.66,24,26,45
OceanDNA-b38907,339,-3.6,0.1,0.25,240.0,13,47,690,727,686,737,0.66,34,37,51
OceanDNA-b30640,51,-2.4,0.0,0.34,140.0,195,235,213,252,200,266,0.66,40,39,66
OceanDNA-b15551,376,-1.3,0.0,0.1,110.0,83,118,83,114,78,118,0.66,35,31,40
OceanDNA-b38062,924,0.1,0.0,0.019,18.0,141,189,85,133,44,151,0.66,48,48,107
OceanDNA-b18470,294,15.2,0.0,9.5e-07,0.00016,135,185,126,170,35,173,0.66,50,44,138
OceanDNA-b10398,161,1.9,0.0,0.0054,1.3,110,186,38,120,34,136,0.66,76,82,102
OceanDNA-b5452,195,-2.7,0.0,0.13,60.0,221,256,431,468,407,469,0.66,35,37,62
OceanDNA-b16098,320,13.8,0.0,2.6e-06,0.001,77,177,243,359,241,367,0.66,100,116,126
OceanDNA-b26842,552,-1.2,0.1,0.095,110.0,250,275,417,442,405,459,0.66,25,25,54
OceanDNA-b31012,111,-2.7,0.0,0.13,71.0,224,246,244,268,240,281,0.66,22,24,41
OceanDNA-b24066,1419,11.9,0.0,4.7e-06,0.016,86,186,161,263,143,269,0.66,100,102,126
OceanDNA-b40920,956,1.0,0.0,0.02,12.0,197,261,217,277,202,279,0.66,64,60,77
OceanDNA-b32682,108,29.6,0.2,2e-11,3.9e-08,76,244,86,299,66,342,0.66,168,213,276
OceanDNA-b37601,1414,14.3,0.2,9.1e-07,0.0014,89,181,115,218,99,245,0.66,92,103,146
OceanDNA-b40175,436,11.2,0.1,8.1e-06,0.0076,82,187,24,140,10,149,0.66,105,116,139
OceanDNA-b36401,140,16.4,0.0,6e-07,0.00023,145,203,97,158,4,174,0.66,58,61,170
OceanDNA-b38157,292,-1.8,0.0,0.22,51.0,146,190,560,607,550,620,0.66,44,47,70
OceanDNA-b1347,1187,31.8,0.9,8.4e-12,6.1e-09,86,221,123,287,116,312,0.66,135,164,196
OceanDNA-b1820,355,18.7,0.4,8.1e-08,8.6e-05,106,243,176,342,151,347,0.66,137,166,196
OceanDNA-b26917,1026,8.9,0.1,8e-05,0.063,77,176,52,153,29,170,0.66,99,101,141
OceanDNA-b34299,271,-3.7,0.0,1.1,570.0,109,125,73,89,55,95,0.66,16,16,40
OceanDNA-b17223,1015,-3.6,0.0,0.78,700.0,40,80,56,98,50,100,0.66,40,42,50
OceanDNA-b5452,195,14.4,0.0,8.5e-07,0.00039,74,188,178,302,137,317,0.66,114,124,180
OceanDNA-b12692,254,7.9,0.0,7.9e-05,0.045,133,184,97,149,22,161,0.66,51,52,139
OceanDNA-b16111,443,13.6,0.0,1.5e-06,0.0015,91,245,55,230,24,241,0.66,154,175,217
OceanDNA-b35437,210,16.5,0.0,1.9e-07,4.9e-05,84,243,36,209,9,225,0.66,159,173,216
OceanDNA-b35318,70,19.2,0.0,2.9e-08,2.9e-05,90,187,37,149,23,153,0.66,97,112,130
OceanDNA-b20562,61,7.8,0.0,8.4e-05,0.025,155,177,97,119,23,124,0.66,22,22,101
OceanDNA-b37264,824,-2.1,0.0,0.089,120.0,221,263,261,300,232,306,0.66,42,39,74
OceanDNA-b26870,727,16.9,0.4,1.5e-07,0.00045,84,172,138,237,133,243,0.66,88,99,110
OceanDNA-b5245,47,12.3,0.0,3.5e-06,0.0014,107,191,547,641,520,655,0.66,84,94,135
OceanDNA-b16187,169,9.5,0.0,2.6e-05,0.024,77,180,239,360,205,365,0.66,103,121,160
OceanDNA-b8408,166,0.5,0.0,0.014,2.9,149,189,517,557,469,566,0.66,40,40,97
OceanDNA-b3301,2382,11.6,0.1,1.2e-05,0.017,109,185,294,378,247,393,0.66,76,84,146
OceanDNA-b33411,617,12.1,0.0,8.5e-06,0.0056,98,169,97,166,86,185,0.65,71,69,99
OceanDNA-b41307,1384,4.8,0.9,0.00071,2.9,159,172,149,162,82,179,0.65,13,13,97
OceanDNA-b25026,751,13.4,0.1,1.6e-06,0.0014,102,207,92,200,78,209,0.65,105,108,131
OceanDNA-b23468,2679,6.6,0.0,0.0004,0.55,103,180,430,513,420,519,0.65,77,83,99
OceanDNA-b31120,118,-3.4,0.0,0.66,240.0,109,136,74,102,56,113,0.65,27,28,57
OceanDNA-b45584,658,-2.5,0.0,0.24,170.0,216,247,227,254,208,263,0.65,31,27,55
OceanDNA-b7440,29,-4.1,0.0,0.35,120.0,40,52,302,314,297,335,0.65,12,12,38
OceanDNA-b44609,332,6.3,0.0,0.00051,0.46,198,248,620,670,616,689,0.65,50,50,73
OceanDNA-b17572,742,7.2,0.0,0.00013,0.13,185,265,77,157,65,161,0.65,80,80,96
OceanDNA-b4064,777,14.7,0.1,6.7e-07,0.0007,147,246,138,242,42,262,0.65,99,104,220
OceanDNA-b38547,302,12.1,0.0,4.3e-06,0.0028,139,198,63,126,23,147,0.65,59,63,124
OceanDNA-b21048,591,17.6,0.2,1.7e-07,0.00015,99,245,108,254,86,259,0.65,146,146,173
OceanDNA-b39492,519,18.7,0.0,4.2e-08,3.3e-05,141,184,127,173,113,221,0.65,43,46,108
OceanDNA-b32834,306,1.2,0.0,0.018,7.3,151,229,156,234,138,253,0.65,78,78,115
OceanDNA-b43,3904,12.7,0.0,5.4e-06,0.018,151,211,62,126,44,164,0.65,60,64,120
OceanDNA-b17743,3198,12.3,0.0,1.1e-05,0.014,109,189,136,227,82,252,0.65,80,91,170
OceanDNA-b34087,371,3.7,0.0,0.0015,0.73,136,184,86,132,28,142,0.65,48,46,114
OceanDNA-b1776,2429,-1.2,0.5,0.098,180.0,10,60,52,102,23,110,0.65,50,50,87
OceanDNA-b34653,194,7.9,0.0,8.3e-05,0.064,147,182,479,514,419,522,0.65,35,35,103
OceanDNA-b34860,267,0.7,0.0,0.013,8.9,107,184,482,566,476,582,0.65,77,84,106
OceanDNA-b3628,552,9.2,0.0,3.2e-05,0.035,156,205,178,228,101,239,0.65,49,50,138
OceanDNA-b30641,995,13.1,0.1,4.1e-06,0.0022,105,195,93,186,49,191,0.65,90,93,142
OceanDNA-b24633,138,11.4,0.0,6.9e-06,0.0035,107,192,112,198,72,251,0.65,85,86,179
OceanDNA-b46255,1416,0.8,0.0,0.035,39.0,233,263,217,247,179,249,0.65,30,30,70
OceanDNA-b8260,48,-2.1,0.0,0.17,23.0,197,225,304,331,286,359,0.65,28,27,73
OceanDNA-b37508,143,8.9,0.5,3.8e-05,0.076,84,186,44,143,17,150,0.65,102,99,133
OceanDNA-b16139,352,6.4,0.0,0.00046,0.18,131,178,307,353,232,359,0.65,47,46,127
OceanDNA-b4512,63,12.3,0.0,3.5e-06,0.0024,98,191,522,624,499,636,0.65,93,102,137
OceanDNA-b31076,1192,5.0,0.0,0.0019,1.9,193,249,342,395,311,409,0.65,56,53,98
OceanDNA-b23551,407,12.0,0.0,8.9e-06,0.0067,161,207,132,182,125,208,0.65,46,50,83
OceanDNA-b11392,106,10.9,0.0,9.6e-06,0.0048,79,188,24,150,20,163,0.65,109,126,143
OceanDNA-b6425,553,12.9,0.0,2.5e-06,0.002,131,198,114,186,84,189,0.65,67,72,105
OceanDNA-b9687,373,2.9,0.0,0.0051,2.3,161,197,117,157,32,167,0.65,36,40,135
OceanDNA-b4251,445,15.1,0.0,5.1e-07,0.00058,110,188,144,222,92,235,0.65,78,78,143
OceanDNA-b17056,36,7.2,0.0,0.00013,0.037,88,144,38,98,31,112,0.65,56,60,81
OceanDNA-b37345,174,-2.3,0.0,0.31,140.0,77,121,51,99,20,105,0.65,44,48,85
OceanDNA-b35243,734,5.3,0.0,0.00051,0.49,191,216,287,312,259,355,0.65,25,25,96
OceanDNA-b22858,1665,-4.3,0.5,0.85,1400.0,126,159,126,156,121,158,0.65,33,30,37
OceanDNA-b45703,674,20.1,0.0,1.5e-08,1.1e-05,183,244,219,280,175,302,0.65,61,61,127
OceanDNA-b8547,29,1.4,0.0,0.0079,1.7,142,188,509,556,469,566,0.65,46,47,97
OceanDNA-b41512,504,9.6,0.2,2.4e-05,0.048,86,120,54,88,41,220,0.65,34,34,179
OceanDNA-b36441,2119,12.4,0.0,6.9e-06,0.0096,137,219,156,237,148,277,0.65,82,81,129
OceanDNA-b38979,688,-3.4,0.1,0.22,490.0,11,32,73,95,69,103,0.64,21,22,34
OceanDNA-b5446,232,-3.1,0.0,0.18,79.0,205,256,416,468,407,469,0.64,51,52,62
OceanDNA-b13244,222,10.4,0.0,1.4e-05,0.02,78,190,25,149,10,176,0.64,112,124,166
OceanDNA-b21004,1385,7.1,0.1,0.00043,0.28,147,181,232,266,154,280,0.64,34,34,126
OceanDNA-b23825,1195,11.7,0.2,1.1e-05,0.0088,49,122,45,117,41,202,0.64,73,72,161
OceanDNA-b23150,2605,13.9,0.1,1.2e-06,0.0032,68,174,68,175,51,201,0.64,106,107,150
OceanDNA-b44582,699,18.5,0.1,4.6e-08,0.00011,99,235,126,271,22,307,0.64,136,145,285
OceanDNA-b17564,520,-2.0,0.0,0.17,170.0,50,100,55,110,48,131,0.64,50,55,83
OceanDNA-b16098,490,9.6,0.0,4.9e-05,0.019,89,178,77,185,60,192,0.64,89,108,132
OceanDNA-b45854,2076,11.5,0.0,1.9e-05,0.013,110,189,9,88,2,106,0.64,79,79,104
OceanDNA-b33298,1568,8.4,0.4,5.5e-05,0.11,132,226,96,193,72,200,0.64,94,97,128
OceanDNA-b27491,217,-1.7,0.0,0.065,18.0,198,230,301,332,295,361,0.64,32,31,66
OceanDNA-b31152,265,8.0,0.0,0.00015,0.062,136,189,97,150,11,168,0.64,53,53,157
OceanDNA-b16215,916,-1.3,0.0,0.1,59.0,197,231,124,157,115,191,0.64,34,33,76
OceanDNA-b26842,552,16.9,0.4,2.9e-07,0.00032,83,172,171,271,167,277,0.64,89,100,110
OceanDNA-b16112,176,13.9,0.0,1.2e-06,0.00057,135,180,65,104,51,184,0.64,45,39,133
OceanDNA-b23603,226,11.2,0.0,8.1e-06,0.019,161,206,161,210,151,237,0.64,45,49,86
OceanDNA-b10294,339,-2.5,0.0,0.23,99.0,21,51,212,242,192,253,0.64,30,30,61
OceanDNA-b23055,42,37.0,0.0,2.2e-13,8.1e-11,52,244,54,272,47,280,0.64,192,218,233
OceanDNA-b37345,318,29.7,0.0,5.6e-11,2.6e-08,89,271,17,227,9,243,0.64,182,210,234
OceanDNA-b12554,71,39.3,0.0,2.1e-14,7.7e-12,91,238,87,240,39,259,0.64,147,153,220
OceanDNA-b262,3012,22.9,0.0,2.2e-09,8e-06,152,242,176,268,154,287,0.64,90,92,133
OceanDNA-b21028,518,13.5,0.0,3e-06,0.004,89,243,99,280,93,287,0.64,154,181,194
OceanDNA-b32055,868,-2.9,0.0,0.16,320.0,107,118,127,138,101,148,0.64,11,11,47
OceanDNA-b45442,215,9.4,0.0,5.7e-05,0.043,149,199,95,145,20,151,0.64,50,50,131
OceanDNA-b6211,233,-1.1,0.0,0.044,17.0,192,223,213,243,210,290,0.64,31,30,80
OceanDNA-b15459,1164,8.1,0.0,7e-05,0.085,77,187,26,135,1,159,0.64,110,109,158
OceanDNA-b13174,41,15.6,0.0,3.6e-07,0.00021,133,186,118,165,25,240,0.64,53,47,215
OceanDNA-b23996,1022,-0.3,0.0,0.05,29.0,144,184,21,62,15,73,0.64,40,41,58
OceanDNA-b2828,3215,14.0,0.0,3.3e-06,0.0039,161,244,126,210,120,215,0.64,83,84,95
OceanDNA-b22296,1910,-0.5,0.0,0.028,93.0,196,219,288,311,283,352,0.64,23,23,69
OceanDNA-b3242,329,13.6,0.1,1.5e-06,0.0012,62,187,65,205,5,232,0.64,125,140,227
OceanDNA-b17770,189,11.3,0.1,7.4e-06,0.0022,193,248,221,273,194,290,0.64,55,52,96
OceanDNA-b6750,437,7.7,0.0,0.00027,0.067,109,192,2,88,1,96,0.64,83,86,95
OceanDNA-b2828,2980,-1.3,0.0,0.15,180.0,208,266,223,279,207,281,0.64,58,56,74
OceanDNA-b37508,143,3.0,0.0,0.0026,5.0,197,228,227,257,157,283,0.64,31,30,126
OceanDNA-b7352,307,-2.3,0.0,0.1,35.0,202,214,229,241,218,267,0.64,12,12,49
OceanDNA-b16107,394,15.2,0.1,4.6e-07,0.00032,88,176,247,355,234,363,0.63,88,108,129
OceanDNA-b47092,283,2.6,0.1,0.0068,6.4,150,175,80,105,6,119,0.63,25,25,113
OceanDNA-b46205,397,3.6,0.1,0.0016,2.5,138,178,184,224,176,310,0.63,40,40,134
OceanDNA-b34782,645,2.4,0.0,0.0038,2.5,37,88,81,135,63,147,0.63,51,54,84
OceanDNA-b22518,396,8.2,0.2,0.00013,0.24,106,189,198,297,186,305,0.63,83,99,119
OceanDNA-b36083,1746,9.4,0.6,5.4e-05,0.053,98,184,51,135,26,143,0.63,86,84,117
OceanDNA-b44627,225,8.3,0.1,0.00012,0.054,196,221,199,223,133,243,0.63,25,24,110
OceanDNA-b17030,137,8.8,0.0,4.3e-05,0.017,129,197,74,144,17,149,0.63,68,70,132
OceanDNA-b22022,2999,-1.9,0.0,0.15,260.0,28,59,81,112,46,133,0.63,31,31,87
OceanDNA-b45271,128,0.2,0.0,0.034,8.4,197,229,316,347,308,399,0.63,32,31,91
OceanDNA-b22385,2068,-3.7,0.0,0.56,1100.0,161,194,105,139,103,144,0.63,33,34,41
OceanDNA-b15541,923,14.0,0.0,3.4e-06,0.0022,139,187,104,146,16,162,0.63,48,42,146
OceanDNA-b21790,8,-0.0,0.0,0.021,5.5,200,253,672,725,664,739,0.63,53,53,75
OceanDNA-b425,789,18.5,0.1,4.6e-08,4.1e-05,91,218,113,265,107,300,0.63,127,152,193
OceanDNA-b15190,1628,-1.5,0.0,0.057,130.0,104,211,212,232,180,250,0.63,107,20,70
OceanDNA-b34471,261,-1.4,0.0,0.056,49.0,151,185,582,616,566,628,0.63,34,34,62
OceanDNA-b16662,303,-1.8,0.0,0.072,71.0,195,264,425,500,395,510,0.63,69,75,115
OceanDNA-b46894,843,-1.1,0.0,0.086,54.0,221,263,213,252,181,254,0.63,42,39,73
OceanDNA-b11352,456,6.0,0.0,0.0003,0.19,130,184,88,140,30,159,0.63,54,52,129
OceanDNA-b26567,96,10.6,0.0,1.2e-05,0.012,87,179,46,142,36,156,0.63,92,96,120
OceanDNA-b32141,2161,2.1,0.1,0.0093,14.0,168,248,252,332,246,348,0.63,80,80,102
OceanDNA-b17609,3614,-2.6,0.0,0.13,600.0,24,47,43,66,33,82,0.63,23,23,49
OceanDNA-b23525,1023,6.4,1.0,0.00022,0.45,84,187,40,145,12,159,0.63,103,105,147
OceanDNA-b30138,3515,13.0,0.1,2.2e-06,0.008,141,220,244,322,168,351,0.63,79,78,183
OceanDNA-b2923,1425,-0.1,0.0,0.043,41.0,178,258,181,262,173,268,0.63,80,81,95
OceanDNA-b45827,1430,11.6,0.0,6e-06,0.0097,110,185,206,287,198,296,0.63,75,81,98
OceanDNA-b27533,2244,-3.5,0.0,0.23,610.0,195,227,259,291,253,306,0.63,32,32,53
OceanDNA-b30168,970,15.9,0.0,5.8e-07,0.00044,109,191,144,224,120,253,0.63,82,80,133
OceanDNA-b1765,1396,-0.8,0.2,0.036,82.0,16,49,58,91,22,111,0.63,33,33,89
OceanDNA-b23551,393,2.0,0.0,0.0098,7.4,199,244,164,209,158,229,0.62,45,45,71
OceanDNA-b15853,58,9.9,0.0,5.8e-05,0.036,149,218,149,221,130,273,0.62,69,72,143
OceanDNA-b22801,848,9.7,0.1,4.5e-05,0.057,141,190,218,272,153,284,0.62,49,54,131
OceanDNA-b1435,497,-2.6,0.0,0.37,100.0,198,245,239,282,212,299,0.62,47,43,87
OceanDNA-b45289,1404,-1.9,0.0,0.24,200.0,197,263,308,374,301,379,0.62,66,66,78
OceanDNA-b40777,480,14.2,2.5,2e-06,0.0011,16,220,6,244,1,266,0.62,204,238,265
OceanDNA-b31070,1234,9.0,0.3,7.2e-05,0.11,85,187,39,155,14,201,0.62,102,116,187
OceanDNA-b13264,1312,8.7,1.9,9.3e-05,0.072,75,168,45,153,20,158,0.62,93,108,138
OceanDNA-b32851,680,1.5,0.0,0.0072,5.6,137,214,143,220,134,243,0.62,77,77,109
OceanDNA-b33424,401,11.1,0.1,8.6e-06,0.0086,88,180,38,126,24,136,0.62,92,88,112
OceanDNA-b9724,486,6.5,0.0,0.00021,0.1,153,239,90,190,73,211,0.62,86,100,138
OceanDNA-b26065,209,-3.3,0.0,0.2,72.0,77,122,43,93,41,103,0.62,45,50,62
OceanDNA-b8544,124,12.6,0.0,2.9e-06,0.00054,78,175,54,159,51,170,0.62,97,105,119
OceanDNA-b30166,781,-3.4,0.0,0.22,380.0,7,33,51,77,48,80,0.62,26,26,32
OceanDNA-b440,696,6.2,0.0,0.00053,0.64,224,261,280,322,252,329,0.62,37,42,77
OceanDNA-b13087,1025,-1.2,0.0,0.047,83.0,198,244,320,363,314,389,0.62,46,43,75
OceanDNA-b42513,128,7.8,0.0,8.8e-05,0.023,198,238,262,301,254,315,0.62,40,39,61
OceanDNA-b40551,104,11.2,0.1,7.8e-06,0.0056,91,183,41,146,36,155,0.62,92,105,119
OceanDNA-b3909,233,15.2,0.0,9.6e-07,0.0006,141,222,108,195,103,205,0.62,81,87,102
OceanDNA-b26197,431,14.2,0.0,9.9e-07,0.0007,90,188,74,176,57,181,0.62,98,102,124
OceanDNA-b35278,377,10.1,0.1,3.4e-05,0.014,68,189,17,153,6,162,0.62,121,136,156
OceanDNA-b45383,7997,6.8,0.0,0.00034,1.5,152,211,263,330,191,343,0.62,59,67,152
OceanDNA-b506,1674,13.6,0.5,4.4e-06,0.0028,105,243,108,280,85,289,0.62,138,172,204
OceanDNA-a3195,798,13.2,0.0,2e-06,0.0023,24,124,49,158,30,219,0.62,100,109,189
OceanDNA-b13590,1844,3.2,0.1,0.0086,6.2,155,189,442,476,393,512,0.62,34,34,119
OceanDNA-b24286,2219,6.5,0.0,0.00021,0.71,140,215,140,232,121,269,0.62,75,92,148
OceanDNA-b4147,1093,11.1,0.1,1.7e-05,0.017,75,170,273,387,271,393,0.61,95,114,122
OceanDNA-b466,1643,-1.4,1.3,0.16,160.0,12,50,24,65,16,76,0.61,38,41,60
OceanDNA-b22997,222,-3.4,0.0,0.68,230.0,13,39,25,51,14,67,0.61,26,26,53
OceanDNA-b32709,628,9.8,0.0,4.1e-05,0.035,93,178,178,266,168,285,0.61,85,88,117
OceanDNA-b1347,737,-0.7,0.1,0.064,47.0,18,62,85,127,67,140,0.61,44,42,73
OceanDNA-b40252,239,18.6,0.3,4.4e-08,4e-05,88,190,36,151,17,183,0.61,102,115,166
OceanDNA-b114,76,-0.9,0.0,0.039,18.0,196,221,469,493,458,519,0.61,25,24,61
OceanDNA-b15938,254,-1.3,0.0,0.051,15.0,197,219,221,240,206,270,0.61,22,19,64
OceanDNA-b41608,419,11.9,0.0,4.7e-06,0.0027,148,212,123,191,26,204,0.61,64,68,178
OceanDNA-b36481,1450,12.6,0.0,3e-06,0.0079,74,215,67,223,56,255,0.61,141,156,199
OceanDNA-b24654,471,-3.2,0.0,0.2,140.0,196,247,223,276,221,280,0.61,51,53,59
OceanDNA-b3684,19,4.3,0.0,0.001,1.3,154,226,94,176,82,188,0.61,72,82,106
OceanDNA-b13544,146,1.2,0.0,0.0087,10.0,181,243,195,257,192,280,0.61,62,62,88
OceanDNA-b34301,471,7.0,0.0,0.00015,0.11,140,190,242,295,197,307,0.61,50,53,110
OceanDNA-b1358,1852,-3.2,0.0,0.2,580.0,198,214,206,222,200,258,0.61,16,16,58
OceanDNA-b36934,678,-0.5,0.0,0.029,29.0,191,218,346,373,325,401,0.61,27,27,76
OceanDNA-b21873,149,10.8,0.0,1e-05,0.002,154,180,100,126,18,144,0.61,26,26,126
OceanDNA-b4028,349,10.7,0.0,2.3e-05,0.0096,151,183,115,147,102,249,0.6,32,32,147
OceanDNA-b21048,127,22.1,0.2,7.8e-09,6.9e-06,91,227,111,281,105,307,0.6,136,170,202
OceanDNA-b23556,470,-2.7,0.1,0.28,320.0,13,41,72,102,64,107,0.6,28,30,43
OceanDNA-b10567,54,8.7,0.0,4.6e-05,0.014,138,187,101,152,26,159,0.6,49,51,133
OceanDNA-b3318,1749,-5.1,1.2,0.72,2800.0,156,177,45,66,37,71,0.6,21,21,34
OceanDNA-b960,417,-2.7,1.0,0.13,280.0,9,42,152,185,130,190,0.6,33,33,60
OceanDNA-b35240,640,6.4,0.0,0.00045,0.24,176,245,255,338,251,348,0.6,69,83,97
OceanDNA-b22320,1014,11.2,0.0,7.9e-06,0.01,109,194,554,648,541,656,0.6,85,94,115
OceanDNA-b22394,801,6.7,0.0,0.00036,0.35,126,171,435,484,407,489,0.6,45,49,82
OceanDNA-b16209,388,14.3,0.0,1.8e-06,0.0011,88,123,284,319,270,404,0.6,35,35,134
OceanDNA-b3419,139,11.7,0.0,5.4e-06,0.0073,129,176,84,135,48,142,0.6,47,51,94
OceanDNA-b3385,1744,11.5,0.2,1.3e-05,0.022,89,187,35,131,27,137,0.6,98,96,110
OceanDNA-b12076,229,13.1,0.6,2.1e-06,0.00085,66,185,28,160,17,166,0.59,119,132,149
OceanDNA-b36430,1104,-1.8,0.0,0.071,150.0,228,245,280,297,234,318,0.59,17,17,84
OceanDNA-b6561,240,7.8,0.0,0.00025,0.11,80,196,28,149,3,156,0.59,116,121,153
OceanDNA-b37342,417,-3.3,0.0,0.2,260.0,92,123,94,128,60,137,0.59,31,34,77
OceanDNA-b33521,2359,-3.2,0.0,0.19,540.0,144,174,29,64,19,75,0.58,30,35,56
OceanDNA-b22397,2136,-2.0,0.0,0.34,220.0,117,149,49,78,39,94,0.58,32,29,55
OceanDNA-b12699,83,7.1,0.0,0.00014,0.056,118,181,46,107,11,116,0.58,63,61,105
OceanDNA-b40755,73,-1.9,0.0,0.075,48.0,20,65,39,81,25,86,0.58,45,42,61
OceanDNA-b37442,757,-2.5,0.0,0.24,120.0,198,213,204,219,192,255,0.58,15,15,63
OceanDNA-b32144,436,-2.1,0.0,0.086,240.0,202,222,232,252,226,273,0.58,20,20,47
OceanDNA-b22922,367,-3.2,0.0,0.38,320.0,56,114,127,143,117,151,0.58,58,16,34
OceanDNA-b9654,484,4.2,0.0,0.0022,0.62,159,225,102,178,80,215,0.58,66,76,135
OceanDNA-b20906,284,-3.3,0.0,0.21,880.0,21,62,14,56,7,63,0.57,41,42,56
OceanDNA-b31526,385,-0.8,0.0,0.11,37.0,143,169,225,252,152,269,0.57,26,27,117
OceanDNA-b41583,245,11.9,0.3,4.9e-06,0.0031,125,186,140,195,37,219,0.57,61,55,182
OceanDNA-b24003,608,3.3,0.0,0.004,3.0,100,181,438,525,423,536,0.57,81,87,113
OceanDNA-b46919,1190,-0.8,0.0,0.035,56.0,136,173,563,602,508,620,0.57,37,39,112
OceanDNA-b36473,1282,-2.0,0.0,0.085,270.0,190,208,197,215,146,240,0.57,18,18,94
OceanDNA-b16229,53,4.5,0.1,0.0027,1.2,89,118,273,302,256,386,0.57,29,29,130
OceanDNA-b6504,238,4.7,0.0,0.00073,0.37,156,182,92,118,74,201,0.57,26,26,127
OceanDNA-b16480,1016,0.7,0.0,0.013,14.0,92,119,157,184,152,257,0.57,27,27,105
OceanDNA-b38093,297,1.6,0.0,0.0067,5.9,149,182,59,92,5,113,0.56,33,33,108
OceanDNA-b5161,252,11.6,0.0,5.8e-06,0.0016,135,182,105,150,26,163,0.56,47,45,137
OceanDNA-b22296,1910,6.7,0.1,0.00019,0.63,16,202,28,213,15,222,0.56,186,185,207
OceanDNA-b45445,755,-3.0,0.0,0.17,300.0,187,215,4,32,3,45,0.56,28,28,42
OceanDNA-b24091,658,-3.7,0.1,0.54,270.0,9,34,7,32,4,42,0.56,25,25,38
OceanDNA-b23680,180,-2.9,0.0,0.16,280.0,189,247,234,288,228,309,0.55,58,54,81
OceanDNA-b12639,372,11.4,0.0,6.7e-06,0.0041,139,185,109,154,23,160,0.55,46,45,137
OceanDNA-b11730,547,-2.3,0.0,0.1,71.0,110,131,152,175,121,221,0.55,21,23,100
OceanDNA-b23811,325,-2.9,0.0,0.16,250.0,189,247,234,288,228,309,0.55,58,54,81
OceanDNA-b6503,557,2.7,0.0,0.0061,2.0,158,177,97,116,82,203,0.55,19,19,121
OceanDNA-b22478,1038,-3.8,0.0,0.89,700.0,215,270,235,285,228,291,0.55,55,50,63
OceanDNA-b16719,140,10.6,0.1,1.2e-05,0.028,89,217,272,423,269,428,0.55,128,151,159
OceanDNA-b22817,1889,-3.9,0.1,0.64,1300.0,10,29,8,27,4,37,0.54,19,19,33
OceanDNA-b9635,310,3.7,0.1,0.0015,0.71,148,225,87,174,77,211,0.54,77,87,134
OceanDNA-b37855,698,-2.0,0.0,0.084,62.0,157,174,125,140,88,183,0.54,17,15,95
OceanDNA-b37433,682,1.3,0.0,0.008,9.7,196,216,265,285,178,316,0.54,20,20,138
OceanDNA-b28826,1069,-0.4,0.0,0.028,33.0,199,249,215,261,210,273,0.54,50,46,63
OceanDNA-b1751,2372,-1.8,0.0,0.072,200.0,31,56,163,189,149,230,0.54,25,26,81
OceanDNA-b47053,235,-2.2,0.0,0.098,64.0,197,219,183,206,179,245,0.53,22,23,66
OceanDNA-b23996,682,-2.0,0.0,0.16,95.0,107,171,488,558,456,574,0.53,64,70,118
OceanDNA-b1232,562,-3.0,1.4,0.17,340.0,41,55,37,51,5,86,0.52,14,14,81
OceanDNA-a842,279,-2.8,0.0,0.29,53.0,227,246,240,259,208,278,0.52,19,19,70
OceanDNA-b22798,1185,9.1,0.2,3.5e-05,0.14,133,179,158,207,77,306,0.52,46,49,229
OceanDNA-b27549,1961,-0.7,0.0,0.068,73.0,161,184,70,93,16,99,0.51,23,23,83
OceanDNA-b42995,28,-1.6,0.0,0.063,16.0,148,148,45,45,25,72,0.51,0,0,47
OceanDNA-b23175,2997,-3.4,0.6,0.44,1600.0,17,35,77,95,60,121,0.51,18,18,61
OceanDNA-b22991,1117,-4.0,0.4,0.98,1500.0,10,49,165,202,159,218,0.44,39,37,59
OceanDNA-b3385,1744,-3.0,0.0,0.33,570.0,227,235,224,232,194,263,0.43,8,8,69
OceanDNA-b39122,1487,-3.5,0.1,0.24,540.0,9,25,13,29,4,46,0.42,16,16,42
